Wwb, Wwb, Wwb, Wwb, Wwb, Wwb, Wwb, Wwb, Wwb, Wwb, Wwb, Wwb, Wwb, Wwb, Wwb, Wwb, Wwb, Wwb, Wwb, Wwb, Wwb, Wwb, Wwb, Wwb, Wwb, Wwb, Wwb, Wwb, Wwb, Wwb, Wwb, Wwb
Wwb, Wwb, Wwb, Wwb, Wwb, Wwb, Wwb, Wwb, Wwb, Wwb, Wwb, Wwb, Wwb, Wwb, Wwb, Wwb, Wwb, Wwb, Wwb, Wwb, Wwb, Wwb, Wwb, Wwb, Wwb, Wwb, Wwb, Wwb, Wwb, Wwb, Wwb, Wwb
Wwb, Wwb, Wwb, Wwb, Wwb, Wwb, Wwb, Wwb, Wwb, Wwb, Wwb, Wwb, Wwb, Wwb, Wwb, Wwb, Wwb, Wwb, Wwb, Wwb, Wwb, Wwb, Wwb, Wwb, Wwb, Wwb, Wwb, Wwb, Wwb, Wwb, Wwb, Wwb
Wwb, Wwb, Wwb, Wwb, Wwb, Wwb, Wwb, Wwb, Wwb, Wwb, Wwb, Wwb, Wwb, Wwb, Wwb, Wwb, Wwb, Wwb, Wwb, Wwb, Wwb, Wwb, Wwb, Wwb, Wwb, Wwb, Wwb, Wwb, Wwb, Wwb, Wwb, Wwb
Wwb, Wwb, Wwb, Wwb, Wwb, Wwb, Wwb, Wwb, Wwb, Wwb, Wwb, Wwb, Wwb, Wwb, Wwb, Wwb, Wwb, Wwb, Wwb, Wwb, Wwb, Wwb, Wwb, Wwb, Wwb, Wwb, Wwb, Wwb, Wwb, Wwb, Wwb, Wwb
Wwb, Wwb, Wwb, Wwb, Wwb, Wwb, Wwb, Wwb, Wwb, Wwb, Wwb, Wwb, Wwb, Wwb, Wwb, Wwb, Wwb, Wwb, Wwb, Wwb, Wwb, Wwb, Wwb, Wwb, Wwb, Wwb, Wwb, Wwb, Wwb, Wwb, Wwb, Wwb
Wwb, Wwb, Wwb, Wwb, Wwb, Wwb, Wwb, Wwb, Wwb, Wwb, Wwb, Wwb, Xos, Xos, Wwb, Wwb, Wwb, Xos, Xos, Wwb, Wwb, Wwb, Wwb, Wwb, Wwb, Wwb, Wwb, Wwb, Wwb, Wwb, Wwb, Wwb
Wwb, Wwb, Wwb, Wwb, Wwb, Wwb, Wwb, Wwb, Wwb, Wwb, Xos, Xos, Xos^Efs, Xos^Efs, Wwb, Wwb, Wwb, Xos^Efs, Xos^Efs, Xos, Xos, Wwb, Wwb, Wwb, Wwb, Wwb, Wwb, Wwb, Wwb, Wwb, Wwb, Wwb
Wwb, Wwb, Wwb, Wwb, Wwb, Wwb, Wwb, Wwb, Wwb, Xos, Xos^Efs, Xos, Wwb, Wwb, Wwb, Wwb, Wwb, Wwb, Wwb, Xos, Xos^Efs, Xos, Wwb, Wwb, Wwb, Wwb, Wwb, Wwb, Wwb, Wwb, Wwb, Wwb
Wwb, Wwb, Wwb, Wwb, Wwb, Wwb, Wwb, Wwb, Wwb, Wwb, Wwb, Wwb, Wwb, Wwb, Urb, Xos, Urb, Wwb, Wwb, Wwb, Wwb, Wwb, Wwb, Wwb, Wwb, Wwb, Wwb, Wwb, Wwb, Wwb, Wwb, Wwb
Wwb, Wwb, Wwb, Wwb, Wwb, Wwb, Wwb, Wwb, Xos, Wwb, Wwb, Wwb, Xos, Urb, Urb, Urb, Urb, Urb, Xos, Wwb, Wwb, Wwb, Xos, Wwb, Wwb, Wwb, Wwb, Wwb, Wwb, Wwb, Wwb, Wwb
Wwb, Wwb, Wwb, Wwb, Wwb, Wwb, Wwb, Wwb, Xos, Xos, Wwb, Wwb, Urb, Urb, Wwb, Wwb, Wwb, Urb, Urb, Wwb, Wwb, Xos, Xos, Wwb, Wwb, Wwb, Wwb, Wwb, Wwb, Wwb, Wwb, Wwb
Wwb, Wwb, Wwb, Wwb, Wwb, Wwb, Wwb, Wwb, Xos, Xos, Wwb, Wwb, Urb, Urb, Wwb, Wwb, Wwb, Urb, Urb, Wwb, Wwb, Xos, Xos, Wwb, Wwb, Wwb, Wwb, Wwb, Wwb, Wwb, Wwb, Wwb
Wwb, Wwb, Wwb, Wwb, Wwb, Wwb, Wwb, Wwb, Xos^Efs, Xos, Urb, Urb, Xos, Urb, Urb, Wwb, Urb, Urb, Xos, Wwb, Wwb, Xos, Xos^Efs, Wwb, Wwb, Wwb, Wwb, Wwb, Wwb, Wwb, Wwb, Wwb
Wwb, Wwb, Wwb, Wwb, Cud, Wwb, Wwb, Wwb, Urb, Urb, Urb, Urb, Urb, Urb, Urb, Urb, Urb, Urb, Wwb, Wwb, Wwb, Wwb, Wwb, Wwb, Wwb, Wwb, Wwb, Wwb, Wwb, Wwb, Wwb, Wwb
Wwb, Wwb, Cud, Cud, Cud, Cud, Urb, Urb, Urb, Urb, Urb, Urb, Wwb, Wwb, Wwb, Xos, Wwb, Wwb, Wwb, Wwb, Xos, Wwb, Wwb, Wwb, Wwb, Wwb, Wwb, Wwb, Wwb, Wwb, Wwb, Wwb
Cud, Cud, Cud, Cud, Urb, Urb, Urb, Urb, Urb, Urb, Xos^Efs, Xos, Xos, Wwb, Wwb, Wwb, Wwb, Wwb, Xos, Xos, Xos^Efs, Xos^Efs, Wwb, Wwb, Wwb, Wwb, Wwb, Wwb, Wwb, Wwb, Wwb, Wwb
Cud, Cud, Urb, Urb, Urb, Urb, Urb, Urb, Wwb, Wwb, Wwb, Xos^Efs, Xos, Xos, Wwb, Wwb, Wwb, Xos, Xos, Xos, Wwb, Wwb, Wwb, Wwb, Wwb, Wwb, Wwb, Wwb, Wwb, Wwb, Wwb, Wwb
Urb, Urb, Urb, Urb, Urb, Urb, Cud, Cud, Cud, Wwb, Wwb, Wwb, Wwb, Xos^Efs, Wwb, Wwb, Wwb, Xos^Efs, Wwb, Wwb, Wwb, Wwb, Wwb, Wwb, Wwb, Wwb, Wwb, Wwb, Wwb, Wwb, Wwb, Wwb
Urb, Urb, Urb, Urb, Cud, Cud, Cud, Cud, Wwb, Wwb, Wwb, Wwb, Wwb, Wwb, Wwb, Wwb, Wwb, Wwb, Wwb, Wwb, Wwb, Wwb, Wwb, Wwb, Wwb, Wwb, Wwb, Wwb, Wwb, Wwb, Wwb, Wwb
Urb, Urb, Cud, Cud, Cud, Cud, Wwb, Wwb, Wwb, Wwb, Wwb, Wwb, Wwb, Wwb, Wwb, Wwb, Wwb, Wwb, Wwb, Wwb, Wwb, Wwb, Wwb, Wwb, Wwb, Wwb, Wwb, Wwb, Wwb, Wwb, Wwb, Wwb
Cud, Cud, Cud, Cud, Wwb, Wwb, Wwb, Wwb, Wwb, Wwb, Wwb, Wwb, Wwb, Wwb, Wwb, Wwb, Wwb, Wwb, Wwb, Wwb, Wwb, Wwb, Wwb, Wwb, Wwb, Wwb, Wwb, Wwb, Wwb, Wwb, Wwb, Wwb
Cud, Cud, Wwb, Wwb, Wwb, Wwb, Wwb, Wwb, Wwb, Wwb, Wwb, Wwb, Wwb, Wwb, Wwb, Wwb, Wwb, Wwb, Wwb, Wwb, Wwb, Wwb, Wwb, Wwb, Wwb, Wwb, Wwb, Wwb, Wwb, Wwb, Wwb, Wwb
Wwb, Wwb, Wwb, Wwb, Wwb, Wwb, Wwb, Wwb, Wwb, Wwb, Wwb, Wwb, Wwb, Wwb, Wwb, Wwb, Wwb, Wwb, Wwb, Wwb, Wwb, Wwb, Wwb, Wwb, Wwb, Wwb, Wwb, Wwb, Wwb, Wwb, Wwb, Wwb
Wwb, Wwb, Wwb, Wwb, Wwb, Wwb, Wwb, Wwb, Wwb, Wwb, Wwb, Wwb, Wwb, Wwb, Wwb, Wwb, Wwb, Wwb, Wwb, Wwb, Wwb, Wwb, Wwb, Wwb, Wwb, Wwb, Wwb, Wwb, Wwb, Wwb, Wwb, Wwb
Wwb, Wwb, Wwb, Wwb, Wwb, Wwb, Wwb, Wwb, Wwb, Wwb, Wwb, Wwb, Wwb, Wwb, Wwb, Wwb, Wwb, Wwb, Wwb, Wwb, Wwb, Wwb, Wwb, Wwb, Wwb, Wwb, Wwb, Wwb, Wwb, Wwb, Wwb, Wwb
