border_size=1
usage=map

Wwb         , Wwb         , Wwb         , Wwb         , Wwb         , Wwb         , Wwb         , Wwb         , Wwb         , Wwb         , Wwb         , Wwb         , Wwb         , Wwb         , Wwb         , Wwb         , Wwb         , Wwb         , Wwb         , Wwb         , Wwb         , Wwb         , Wwb         , Wwb         , Wwb         , Wwb         , Wwb         , Wwb         , Wwb         , Wwb         , Wwb         , Wwb         
Wwb         , Wwb         , Wwb         , Wwb         , Wwb         , Wwb         , Wwb         , Wwb         , Wwb         , Wwb         , Wwb         , Wwb         , Wwb         , Wwb         , Wwb         , Wwb         , Wwb         , Wwb         , Wwb         , Wwb         , Wwb         , Wwb         , Wwb         , Wwb         , Wwb         , Wwb         , Wwb         , Wwb         , Wwb         , Wwb         , Wwb         , Wwb         
Wwb         , Wwb         , Wwb         , Wwb         , Wwb         , Wwb         , Wwb         , Wwb         , Wwb         , Wwb         , Wwb         , Wwb         , Wwb         , Wwb         , Wwb         , Wwb         , Wwb         , Wwb         , Wwb         , Wwb         , Wwb         , Wwb         , Wwb         , Wwb         , Wwb         , Wwb         , Wwb         , Wwb         , Wwb         , Wwb         , Wwb         , Wwb         
Wwb         , Wwb         , Wwb         , Wwb         , Wwb         , Wwb         , Wwb         , Wwb         , Wwb         , Wwb         , Wwb         , Wwb         , Wwb         , Wwb         , Wwb         , Wwb         , Wwb         , Wwb         , Wwb         , Wwb         , Wwb         , Wwb         , Wwb         , Wwb         , Wwb         , Wwb         , Wwb         , Wwb         , Wwb         , Wwb         , Wwb         , Wwb         
Wwb         , Wwb         , Wwb         , Wwb         , Wwb         , Wwb         , Wwb         , Wwb         , Wwb         , Wwb         , Wwb         , Wwb         , Wwb         , Wwb         , Wwb         , Wwb         , Wwb         , Wwb         , Wwb         , Wwb         , Wwb         , Wwb         , Wwb         , Wwb         , Wwb         , Wwb         , Wwb         , Wwb         , Wwb         , Wwb         , Wwb         , Wwb         
Wwb         , Wwb         , Wwb         , Wwb         , Wwb         , Wwb         , Wwb         , Wwb         , Wwb         , Wwb         , Wwb         , Wwb         , Wwb         , Wwb         , Wwb         , Wwb         , Wwb         , Wwb         , Wwb         , Wwb         , Wwb         , Wwb         , Wwb         , Wwb         , Wwb         , Wwb         , Wwb         , Wwb         , Wwb         , Wwb         , Wwb         , Wwb         
Wwb         , Wwb         , Wwb         , Wwb         , Wwb         , Wwb         , Wwb         , Wwb         , Wwb         , Wwb         , Wwb         , Wwb         , Xos         , Xos         , Wwb         , Wwb         , Wwb         , Xos         , Xos         , Wwb         , Wwb         , Wwb         , Wwb         , Wwb         , Wwb         , Wwb         , Wwb         , Wwb         , Wwb         , Wwb         , Wwb         , Wwb         
Wwb         , Wwb         , Wwb         , Wwb         , Wwb         , Wwb         , Wwb         , Wwb         , Wwb         , Wwb         , Xos         , Xos         , Xol         , Xol         , Wwb         , Wwb         , Wwb         , Xol         , Xol         , Xos         , Xos         , Wwb         , Wwb         , Wwb         , Wwb         , Wwb         , Wwb         , Wwb         , Wwb         , Wwb         , Wwb         , Wwb         
Wwb         , Wwb         , Wwb         , Wwb         , Wwb         , Wwb         , Wwb         , Wwb         , Wwb         , Xos         , Xol         , Xol         , Wwb         , Wwb         , Wwb         , Wwb         , Wwb         , Wwb         , Wwb         , Xol         , Xol         , Xos         , Wwb         , Wwb         , Wwb         , Wwb         , Wwb         , Wwb         , Wwb         , Wwb         , Wwb         , Wwb         
Wwb         , Wwb         , Wwb         , Wwb         , Wwb         , Wwb         , Wwb         , Wwb         , Wwb         , Wwb         , Wwb         , Wwb         , Wwb         , Wwb         , Urb         , Xos         , Urb         , Wwb         , Wwb         , Wwb         , Wwb         , Wwb         , Wwb         , Wwb         , Wwb         , Wwb         , Wwb         , Wwb         , Wwb         , Wwb         , Wwb         , Wwb         
Wwb         , Wwb         , Wwb         , Wwb         , Wwb         , Wwb         , Wwb         , Wwb         , Xos         , Wwb         , Wwb         , Wwb         , Xos         , Urb         , Urb         , Urb         , Urb         , Urb         , Xos         , Wwb         , Wwb         , Wwb         , Xos         , Wwb         , Wwb         , Wwb         , Wwb         , Wwb         , Wwb         , Wwb         , Wwb         , Wwb         
Wwb         , Wwb         , Wwb         , Wwb         , Wwb         , Wwb         , Wwb         , Wwb         , Xos         , Xol         , Wwb         , Wwb         , Urb         , Urb         , Wwb         , Wwb         , Wwb         , Urb         , Urb         , Wwb         , Wwb         , Xol         , Xos         , Wwb         , Wwb         , Wwb         , Wwb         , Wwb         , Wwb         , Wwb         , Wwb         , Wwb         
Wwb         , Wwb         , Wwb         , Wwb         , Wwb         , Wwb         , Wwb         , Wwb         , Xos         , Xol         , Wwb         , Wwb         , Urb         , Urb         , Wwb         , Wwb         , Wwb         , Urb         , Urb         , Wwb         , Wwb         , Xol         , Xos         , Wwb         , Wwb         , Wwb         , Wwb         , Wwb         , Wwb         , Wwb         , Wwb         , Wwb         
Wwb         , Wwb         , Wwb         , Wwb         , Wwb         , Wwb         , Wwb         , Wwb         , Xos         , Xol         , Urb         , Urb         , Xos         , Urb         , Urb         , Wwb         , Urb         , Urb         , Xos         , Wwb         , Wwb         , Xol         , Xos         , Wwb         , Wwb         , Wwb         , Wwb         , Wwb         , Wwb         , Wwb         , Wwb         , Wwb         
Wwb         , Wwb         , Wwb         , Wwb         , Cud         , Wwb         , Wwb         , Wwb         , Urb         , Urb         , Urb         , Urb         , Urb         , Urb         , Urb         , Urb         , Urb         , Urb         , Wwb         , Wwb         , Wwb         , Wwb         , Wwb         , Wwb         , Wwb         , Wwb         , Wwb         , Wwb         , Wwb         , Wwb         , Wwb         , Wwb         
Wwb         , Wwb         , Cud         , Cud         , Cud         , Cud         , Urb         , Urb         , Urb         , Urb         , Urb         , Urb         , Wwb         , Wwb         , Wwb         , Xos         , Wwb         , Wwb         , Wwb         , Wwb         , Xol         , Wwb         , Wwb         , Wwb         , Wwb         , Wwb         , Wwb         , Wwb         , Wwb         , Wwb         , Wwb         , Wwb         
Cud         , Cud         , Cud         , Cud         , Urb         , Urb         , Urb         , Urb         , Urb         , Urb         , Xos         , Xol         , Xol         , Wwb         , Wwb         , Wwb         , Wwb         , Wwb         , Xol         , Xol         , Xos         , Xos         , Wwb         , Wwb         , Wwb         , Wwb         , Wwb         , Wwb         , Wwb         , Wwb         , Wwb         , Wwb         
Cud         , Cud         , Urb         , Urb         , Urb         , Urb         , Urb         , Urb         , Wwb         , Wwb         , Wwb         , Xos         , Xos         , Xol         , Wwb         , Wwb         , Wwb         , Xol         , Xos         , Xos         , Wwb         , Wwb         , Wwb         , Wwb         , Wwb         , Wwb         , Wwb         , Wwb         , Wwb         , Wwb         , Wwb         , Wwb         
Urb         , Urb         , Urb         , Urb         , Urb         , Urb         , Cud         , Cud         , Cud         , Wwb         , Wwb         , Wwb         , Wwb         , Xos         , Wwb         , Wwb         , Wwb         , Xos         , Wwb         , Wwb         , Wwb         , Wwb         , Wwb         , Wwb         , Wwb         , Wwb         , Wwb         , Wwb         , Wwb         , Wwb         , Wwb         , Wwb         
Urb         , Urb         , Urb         , Urb         , Cud         , Cud         , Cud         , Cud         , Wwb         , Wwb         , Wwb         , Wwb         , Wwb         , Wwb         , Wwb         , Wwb         , Wwb         , Wwb         , Wwb         , Wwb         , Wwb         , Wwb         , Wwb         , Wwb         , Wwb         , Wwb         , Wwb         , Wwb         , Wwb         , Wwb         , Wwb         , Wwb         
Urb         , Urb         , Cud         , Cud         , Cud         , Cud         , Wwb         , Wwb         , Wwb         , Wwb         , Wwb         , Wwb         , Wwb         , Wwb         , Wwb         , Wwb         , Wwb         , Wwb         , Wwb         , Wwb         , Wwb         , Wwb         , Wwb         , Wwb         , Wwb         , Wwb         , Wwb         , Wwb         , Wwb         , Wwb         , Wwb         , Wwb         
Cud         , Cud         , Cud         , Cud         , Wwb         , Wwb         , Wwb         , Wwb         , Wwb         , Wwb         , Wwb         , Wwb         , Wwb         , Wwb         , Wwb         , Wwb         , Wwb         , Wwb         , Wwb         , Wwb         , Wwb         , Wwb         , Wwb         , Wwb         , Wwb         , Wwb         , Wwb         , Wwb         , Wwb         , Wwb         , Wwb         , Wwb         
Cud         , Cud         , Wwb         , Wwb         , Wwb         , Wwb         , Wwb         , Wwb         , Wwb         , Wwb         , Wwb         , Wwb         , Wwb         , Wwb         , Wwb         , Wwb         , Wwb         , Wwb         , Wwb         , Wwb         , Wwb         , Wwb         , Wwb         , Wwb         , Wwb         , Wwb         , Wwb         , Wwb         , Wwb         , Wwb         , Wwb         , Wwb         
Wwb         , Wwb         , Wwb         , Wwb         , Wwb         , Wwb         , Wwb         , Wwb         , Wwb         , Wwb         , Wwb         , Wwb         , Wwb         , Wwb         , Wwb         , Wwb         , Wwb         , Wwb         , Wwb         , Wwb         , Wwb         , Wwb         , Wwb         , Wwb         , Wwb         , Wwb         , Wwb         , Wwb         , Wwb         , Wwb         , Wwb         , Wwb         
Wwb         , Wwb         , Wwb         , Wwb         , Wwb         , Wwb         , Wwb         , Wwb         , Wwb         , Wwb         , Wwb         , Wwb         , Wwb         , Wwb         , Wwb         , Wwb         , Wwb         , Wwb         , Wwb         , Wwb         , Wwb         , Wwb         , Wwb         , Wwb         , Wwb         , Wwb         , Wwb         , Wwb         , Wwb         , Wwb         , Wwb         , Wwb         
Wwb         , Wwb         , Wwb         , Wwb         , Wwb         , Wwb         , Wwb         , Wwb         , Wwb         , Wwb         , Wwb         , Wwb         , Wwb         , Wwb         , Wwb         , Wwb         , Wwb         , Wwb         , Wwb         , Wwb         , Wwb         , Wwb         , Wwb         , Wwb         , Wwb         , Wwb         , Wwb         , Wwb         , Wwb         , Wwb         , Wwb         , Wwb         
