Gs, Gs, Rp, Gg, Gg, Gg, Gll^Fp, Gd^Fmw, Gs^Fds, Gll^Fp, Gll^Fp, Gs^Fms, Gll^Fp, Gll^Fp, Gs^Fds, Gll^Fp, Hh^Fp, Hh, Hh^Fp, Hh^Fp, Hh^Fp, Hh, Hh^Fp, Hh^Fp, Hh^Fmw, Hh, Hhd, Hhd^Fmw, Hhd, Hhd, Md, Md, Md, Md^Xm, Md^Xm, Md^Xm, Md, Md, Md, Md, Md^Xm, Md, Md, Qlf, Qlf, Md, Md^Xm, Md^Xm, Md^Xm, Md^Xm
Gs, Gg, Rp, Rp, Gs^Es, Gg, Gll^Fp, Gll^Fp, Gg^Fet, Gs^Fds, Gs^Fds, Gs^Fms, Gll^Fms, Gs^Fds, Gs^Fds, Gll^Fp, Gll^Fdw, Gs, Hh^Fp, Gll^Fp, Gs, Hh, Hh^Fdw, Hh^Fp, Hh^Fmw, Hhd^Fmw, Hhd, Hhd^Fdw, Gs, Hhd, Hhd^Fdw, Md, Md, Md^Xm, Md^Xm, Md^Xm, Md, Md, Md, Md^Xm, Md, Md, Md, Qlf, Md, Md, Md^Xm, Md^Xm, Qlf, Md
Gg, Gg, Gg^Efm, Rp, Re, Gg, Gg, Gg, Gll^Fp, Gs^Fds, Gs^Fms, Gll^Fms, Gll^Em, Gll^Fp, Gll^Fp, Gs^Fds, Gd^Fmw, Hh, Hh, Gs, Gs, Hh, Hh^Fp, Hh^Fmw, Hh, Hh^Fdw, Hhd^Fdw, Gs^&F, Gs, Gs^Fdw, Hhd^Fdw, Hhd, Md, Md, Md^Xm, Md, Qlf, Qlf, Md, Md, Qlf, Md, Md, Md, Md, Md^Xm, Md, Md, Qlf, Md
Gs, Gs, Gg^Efm, Gg, Gs^Es, Rp, Re, Gg^Efm, Gg^Em, Gs^Fms, Gd^Fmw, Gs, Re, Gll^Fp, Gs, Gll^Fmw, Gg, Hh, Gs, Gg, Hh, Hh, Gs, Hh^Fdw, Gs, Hh, Hhd^Fdw, Gs, Hhd^Fdw, Md, Hhd, Hhd, Md, Md^Xm, Md^Vhhr, Hhd, Qlf, Md, Md, Qlf, 4 Khr, Qlf, Md, Md, Md, Md^Xm, Hhd, Md, Md, Qlf
Hh, Gg, Gs, Gg, Gg, Gg, Rp, Rp, Gg, Gg^Em, Gg, Re, Gg, Gg^Vhr, Gs, Gs, Gg^Eff, Hh, Gs, Gg, Gg, Gs, Hh, Hh^Fdw, Hhd^&F, Gs, Gs, Gs, Hhd^Fdw, Md, Md, Hhd, Md, Md, Md, Hhd^Fdw, Hhd, Md, Hhd, Chr, Chr, Qlf, Md, Hhd, Md, Hhd, Hhd, Hhd, Md^Xm, Md
Hh, Gs, Hh^Fp, Gs, Gg, Gg, Gg^Es, Rp, Rp, Gs, Re, Re, Cer, Re, Re, Gg, Gg^Efm, Gs^Eff, Re, Gs, Gs, Gg, Hh, Hhd^Fdw, Hhd^Fdw, Gs, Gs, Hhd^Fdw, Re^&F, Hhd, Hhd^Fdw, Md, Md, Chr, Md, Hhd, Hhd, Md, Re^Es, Re, Hhd, Qlf, Qlf, Hhd^Fdw, Md, Md^Xm, Md^Xm, Md, Md, Md
Hh, Hh, Hh^Fms, Gg, Gs, Gg, Gg, Gg^Vhr, Gs, Re, Re, Cer, 3 Ket, Cer, Re^Es, Gs, Gg, Gs, Re^Es, Gs, Gs, Gs, Gs, Hh, Gs, Gs, Gs, Re^Fdw, Re, Hhd^Fdw, Re^Fdw, Gd, Hhd^&F, Hhd, Re^Fdw, Re^Fdw, Re, Re, Chr, Md, Md, Qlf, Hhd^Fdw, Qlf, Md, Md, Md, Md^Xm, Qlf, Md
Hh, Hh, Hh, Hh, Hh, Gs, Gg^Efm, Re, Gg, Gs^Efm, Re, Cer, Cer, Cer, Re, Re, Gg^Vhr, Gs, Gs, Gg, Gs, Gs, Hh, Hh, Gs, Gs, Gs, Gs, Re, Gd^Fdw, Re, Re^Es, Gs, Gd^Fetd, Re^Fdw, Re^&F, Gs^Es, Hhd^Fdw, Hhd, Md, Md^Xm, Hhd^Fdw, Hhd^&F, Md, Md^Xm, Md^Xm, Chr, Md, Qlf, Md
Hh, Hh^Fp, Hh^Fms, Hh^Fp, Hh^Fp, Hh, Hh, Re, Gs, Gg, Re, Re, Re, Gs, Rp, Gg, Gs^Eff, Gs^Eff, Gs^Fds, Gll^Fp, Gs, Gs, Gs, Gs, Gs, Gg, Gs, Hhd, Gd, Gd, Gd, Re^Vhr, Gs, Re, Re, Gs, Hhd, Md, Md^Xm, Md, Md, Md, Hhd^Fdw, Md, Md^Xm, Md, Hhd, Qlf, Qlf, Md
Hh, Hh^Fds, Hh, Hh^Fms, Hh, Gs, Hh, Gg, Gg, Gs, Gg, Gs^Vhr, Re, Gg, Re, Re, Gs, Gs, Gll^Fp, Gs^Fms, Gll^Fp, Gg, Gs, Gs, Gd^Fdw, Gd^Fdw, Gs, Gs, Gd, Re, Re, Re, Re^Dr, Gs, Re, Hhd, Hhd^Fdw, Md, Md, Md, Md, Hhd^Fdw, Hhd, Md^Xm, Md^Xm, Hhd, Hhd, Qlf, Md, Md
Hh^Fp, Hh^Fp, Hh, Hh^Fds, Hh, Gg, Gg, Gg, Gs, Hh, Gs, Gg, Gs^Eff, Gs^Eff, Re, Re^Es, Rp, Gs, Gs, Gs^Fms, Gg, Gg, Gs, Gs^Fdw, Gd^Fdw, Gs^&F, Re, Gd, Hhd, Gs, Hhd^Fdw, Re, Re^Es, Re^Es, Gs, Hhd, Md, Chr, Md, Md, Hhd, Hhd, Hhd, Md, Md, Md, Qlf, Qlf, Md, Md^Xm
Hh^Fp, Hh, Gg, Gg, Gs, Gg, Gs, Gs, Hh, Hh^Fp, Gg, Gg, Gg, Gs^Em, Gg, Gs, Gs, Re, Rp^Edb, Gs, Gg, Gg, Gg, Gs^Fdw, Gs, Gs, Re, Hhd, Hhd, Hhd, Hhd, Re, Gd, Gd, Hhd, Gd, Hhd, Md^&F, Hhd^Fdw, Md, Md, Md, Hhd, Qlf, Qlf, Md, Qlf, Qlf, Hhd, Md
Hh, Gg, Gg, Gg, Hh, Hh, Hh, Gs, Gs, Gs, Gs, Gg, Hh^Fp, Gll^Fp, Hh, Gg, Re^Es, Gs^Edb, Re^Edb, Gs^Edb, Gs, Gg^Es, Gs^Edt, Gg^Edt, Re, Gs, Gd, Gd, Hhd^Fdw, Hhd, Gd, Re^Es, Gd, Gd^Fdw, Hhd, Gd, Gd, Hhd^Fdw, Hhd, Hhd, Md, Md, Md, Hhd, Qlf, Md, Hhd, Qlf, Md, Hhd
Hh, Hh, Hh, Gs, Hh, Hh^Fp, Hh, Hh, Gs, Gg, Gs, Hh, Hh^Fp, Hh, Gs, Gg, Gs, Gd^Edb, Gs^Edb, Re^Edb, Gs^Edb, Re, Gd^Edb, Gs, Re, Gs^Edb, Gd, Gd, Gs, Gd^&F, Gd, Gs, Hhd^Fdw, Hhd, Md, Hhd^Fdw, Hhd, Hhd, Md, Hhd, Md, Md, Md, Hhd, Hhd, Hhd, Md, Mv, Md, Md^Xm
Gs, Gg, Gs, Gs, Hh, Hh, Hh^Fp, Hhd^Fmw, Hhd^Fdw, Gs^&F, Hhd, Hhd^Fmw, Hhd^Fdw, Gs, Re, Gd, Re^Es, Gs^Edb, Gd^Edb, Gd^Edb, Gs, Gs^Edb, Re^Edb, Gs^Edb, Gd^Edb, Gs, Gs^Edb, Gd, Gs, Gd, Hhd, Gd, Hhd^&F, Md, Hhd, Hhd, Md, Hhd, Md, Qlf, Qlf, Qlf, Md, Hhd, Md, Md, Md, Md, Md, Md
Gs, Gs, Gs, Gs, Gs, Hh, Gs, Hhd, Hhd, Hhd, Gd, Hhd^Fdw, Gs^&F, Gs, Re, Qxe, Re, Qxe, Qxe, Re^Es, Re, Gs, Gs^Edb, Gd^Es, Re, Re, Gs^Edb, Gs^Edb, Gd, Hhd, Gd^Fdw, Hhd^Fdw, Gd, Hhd, Md, Hhd, Md, Md, Qlf, Qlf, Md, Qlf, Md, Md, Qlf, Qlf, Qlf, Qlf, Qlf, Md
Gs^Fdw, Gs^Fdw, Gs^Fdw, Gd^Fdw, Gd^&F, Gs, Gd, Gs, Gs, Gd, Qxe, Re, Re^Es, Re^Vhr, Re, Gd, Gd^Edb, Re^Edb, Gd^Edb, Re^Es, Re^Dr, Gs, Gd, Gd, Gs^&F, Re^Es, Gs^Edb, Gs^Edb, Gd, Gd^Fdw, Gs, Gd, Gd^Fdw, Hhd, Md, Md, Md, Md, Md, Md^Xm, Md, Qlf, Md, Md, Qlf, Md, Md^Xm, Qlf, Qlf, Md
Gll^Fp, Gs^Fms, Gs^Fms, Gd^Fdw, Gd, Gd^Fdw, Gd, Gd, Gs^Es, Qxe, Gd, Re^Es, Gd^Edb, Re^Edb, Cer, Re, Gd^Edb, Gd^Edb, Gd^Es, Gd, Re^Es, Gd^Vhr, Gd, Gs, Re^Fdw, Gd, Gs, Re^Edb, Gs, Gd^Fdw, Gd^&F, Gd, Hhd, Hhd, Md, Qlf, Qlf, Md, Md^Xm, Md^Xm, Qlf, Qlf, Qlf, Qlf, Md, Md, Md^Xm, Md, Qlf, Qlf
Gs^Fds, Gs^Fds, Gd^Fmw, Gd^Fdw, Gd, Re, Gd^&F, Gs^Es, Gs^Dr, Re, Gs^Edt, Gd^Edt, Re^Edb, Re^Edb, 5 Ker, Cer, Gd^Edb, Gd^Edb, Gd^Edb, Re, Qxe, Re, Gd, Gd^Es, Re, Re, Re, Re^Es, Hhd, Gd, Hhd, Hhd^Fdw, Hhd, Md^Vhhr, Md, Md, Qlf, Md, Md^Xm, Md^Xm, Md, Qlf, Qlf, Md, Md^Xm, Md^Xm, Md^Xm, Md^Xm, Xue, Xue
Gs^Fds, Gll^Fp, Gd^Fmw, Gd^Fmw, Gd^Fdw, Gd^Fdw, Gd, Gd, Gs^Es, Gd^Es, Gs^Edb, Gs^Edt, Gd, Cer, Cer, Re, Re^Es, Re^Dr, Re^Es, Re^Es, Re, Qxe, Gd^Es, Re^Es, Re, Re^Es, Hhd, Re, Chr, Gs, Re^Fdw, Gd^Fdw, Hhd^Fdw, Md^&F, Md, Qlf, Qlf, Md, Xue, Md^Xm, Md, Qlf, Qlf, Xue, Xue, Xue, Xue, Xue, Xue, Xue
Gll^Fp, Gs^Fms, Gs^Fms, Gd^Fdw, Gd^Fdw, Gd, Gd^Es, Qxe, Gs^Es, Gs, Re^Vhr, Gs, Gd^Es, Re, Gs^Edt, Re, Gs^Es, Re^Dr, Gd^Es, Gd^&F, Re^Fdw, Re, Gd^Es, Gs, Gd, Hhd, Chr, Re, Gd, Gs^&F, Re^Fetd, Re^Fdw, Hhd^Fdw, Md, Hhd, Md^Xm, Xue, Qlf, Qlf, Xue, Xue, Md, Xue, Qlf, Qlf, Xue, Xue, Xue, Xu, Xu
Gs^Fds, Gs^Fms, Gd^Fdw, Gd^Fdw, Gd^&F, Gd, Gd^Es, Qxe, Re, Gs, Gd^Es, Re, Re^Es, Gd, Gs^Edt, Re, Gs^Edb, Gd^Edb, Gs, Gd, Re, Re, Hhd, Gs, Gd, Gd, Gs^Edb, Gd, Gd^Es, Re^Vhcr, Hhd, Hhd, Hhd, Hhd, Xue, Md, Xue, Xue, Xue, Xue, Xue, Xue, Xue, Xue, Xue, Xue, Xue, Xu, Xu, Xu
Gs^Fds, Gs^Fms, Gd^Fmw, Gd, Gd^Fdw, Gd, Gd, Re, Gs^Es, Qxe, Gd, Re^Dr, Re^Fdw, Gs^Es, Gs^Edt, Re^Edt, Re, Gd, Gs, Gs^Es, Hhd, Gd^Es, Hhd, Hhd, Hhd, Chr, Gd, Re^Es, Rb^Dr, Gs, Gd, Chr, Re, Hhd, Xue, Xue, Xue, Xu, Xue, Xue, Uh, Xu, Xuc, Xue, Xue, Xue, Xue, Xue, Xue, Xu
Gs^Fds, Gll^Fp, Gs^Fms, Gd^Fdw, Gd^Fdw, Gd^Fdw, Gd, Gs, Gs, Qxe, Qxe, Re^Es, Gd, Gd^&F, Re, Gd^Edb, Re^Es, Re^Es, Gd^Edb, Gd, Gs, Hhd, Hhd, Hhd, Chr, Hhd, Hhd^Vhhr, Re^Es, Rb^Edt, Re^Edt, Re^Es, Rb^Es, Chr, Chr, Uhe, Xue, Xos, Xue, Ur^Tfi, Ur^Emf, Ur^Em, Uh, Uh, Xuc, Xuc, Xu, Xu, Xue, Xue, Xue
Gll^Fp, Gll^Fp, Gs^Fds, Gs^Fms, Gd^Fdw, Gd^Fdw, Gd^Fdw, Gd, Gs, Gd, Re^Es, Gd, Gd^Edb, Gs^Edb, Re, Gs, Gd, Re^Dr, Gd^Es, Re, Gs, Hhd, Md, Hhd, Hhd, Hhd, Rb^Es, Rb^Edt, Rb^Es, Re^Edt, Rb^Edb, Rb^Edb, Chr^Es, Chr, Rr^Dr, Uhe, Xos, Uue^Tfi, Tb^Tf, Xu, Uh, Rr, 1 Rr, Uh, Xu, Xu, Xu, Xue, Xue, Xue
Gll^Fp, Gs^Fds, Gs^Fds, Gll^Fp, Gd^Fmw, Gd^Fdw, Gd^Fdw, Gd^&F, Gd, Gd^Es, Re^Dr, Re^Es, Re^Edb, Re, Gd, Gd, Qxe, Re, Gd, Gd, Gs, Hhd, Md, Md^Xm, Md, Hhd, Rb^Edb, Re^Edb, Rb^Es, Rb^Vhcr, Rb^Edb, Rb^Edb, Chr, Khr, Rr^Es, Uhe, Xos^Efs, Uue^Emf, Uue, Xue, Xu, Rr, Uu, Uu^Em, Xu, Xu, Xu, Xu, Xu, Xu
Gs^Fms, Gs^Fds, Gll^Fp, Gd^Fmw, Gd^Fmw, Gd^Fdw, Gd^Fdw, Gd^Fdw, Re, Re, Re^Es, Re, Gd, Re, Gd, Gd, Gd^Es, Qxe, Gd, Gs, Hhd, Hhd, Md, Md^Xm, Qlf, Hhd, Re^Edb, Re^Edb, Chr, Rb^Edt, Re^Edb, Chr, Chr, Rr^Dr, Rr, Rr, Rr, Xos^Efs, Xos, Uu^Ii, Ur^Ii, Uu, Xu, Xu, Xu, Xu, Xu, Xu, Xu, Xu
Gs^Fms, Gll^Fp, Gll^Fdw, Gll^Fp, Gd^Fmw, Gd^Fmw, Re, Re^&F, Gd^Fdw, Re^Fdw, Re^Fdw, Gd, Re^Es, Qxe, Hhd, Hhd, Re^Es, Gd^Es, Gd, Re, Hhd, Md, Qlf, Md^Xm, Md^Xm, Qlf, Hhd, Re^Edb, Re, Re^Dr, Re, Re, Hhd, Uhe, Uhe, Uhe, Xos, Rr^Zz/, Rr, Ur, Xue, Uhe, Ql, Ql, Xu, Xu, Xu, Xu, Xu, Xu
Gs^Fms, Gll^Fp, Gll^Fds, Gll^Fp, Gd^Fmw, Gs^Fdw, Re, Gll^Fdw, Gd^Fmw, Gd^Fdw, Gd^Fdw, Gd^&F, Gd, Re, Gd^&F, Hhd, Re, Gd^Es, Gd, Hhd, Md, Md, Md, Hhd, Md^Xm, Md, Hhd, Hhd, Hhd, Re, Hhd^Vhhr, Re, Xue, Uhe, Xos, Xos, Xos, Xos, Tb^Tf, Rr, Uu, Uhe, Ql, Xu, Xu, Xu, Xu, Xu, Xu, Xu
Gll^Fp, Gs^Fds, Gll^Fms, Gll^Fp, Re, Re, Gll^Fms, Gll^Fp, Gd^Fmw, Gs^Fdw, Gd^Fdw, Gd^Fdw, Gd^Fdw, Re^Fdw, Re^Fdw, Gd, Re^Fdw, Gd, Gd, Hhd, Gs, Hhd, Md^Xm, Md^Xm, Md, Md, Qlf, Qlf, Hhd, Hhd, Hhd, Hhd, Xue, Xue, Xue, Xue, Xue, Xos, Xue, Uu^Em, Tb^Tf, Uue^Ii, Xu, Ql, Ql, Xu, Xu, Xu, Xu, Xu
Gs^Fms, Gll^Fp, Gll^Fms, Gll^Em, Re, Gs^Fms, Gs^Fms, Gll^Fmw, Gll^Fdw, Gll^Fdw, Gll^Fmw, Gll^Fdw, Gll^Fds, Gll^Fdw, Gd^Fdw, Gd^Fdw, Re^Fdw, Re^&F, Hhd, Gd, Hhd, Hhd, Md, Md^Xm, Md^Xm, Md, Md, Qlf, Qlf, Qlf, Qlf, Xue, Qlf, Qlf, Xue, Xue, Xue, Xue, Xue, Xu, Xue, Xu, Xu, Xu, Xu, Xu, Xu, Xu, Xu, Xu
Gs^Fms, Gll^Fp, Re, Re, Gll^Fp, Gs^Fds, Gll^Fp, Gll^Fp, Gs^Fms, Gll^Fms, Gll^Fp, Gs^Fms, Gll^Fp, Gs^Fms, Gs^Fms, Gd^Fdw, Gd^Fdw, Re, Re, Gd, Hhd, Hhd, Md, Md^Xm, Md^Xm, Md^Xm, Md, Md, Xue, Xue, Qlf, Qlf, Qlf, Qlf, Xue, Xue, Xu, Xue, Xue, Xue, Xue, Xue, Xue, Xu, Xu, Xu, Xu, Xu, Xu, Xu
