border_size=1
usage=map

Gd^Fdw, Gd^Fdw, Gll^Fdw, Gd, Gll^Fdw, Gll^Fdw, Re, Re, Gd^Fdw, Gs, Gs, Gs, Gs, Gd, Gd^Fdw, Gs, Gd^Fdw, Gs^Fdw, Gd^Fdw, Gd^Fdw, Rb^Fdw, Re^Fdw, Gll^Fdw, Re^Fdw, Gll^Fdw, Gg
Gd^Fdw, Gll^Fdw, Gd^Fdw, Gll^Fdw, Gd^Fdw, Re^Fdw, Re^Dr, Re^Fdw, Gd, Gd, Gd, Gs, Gd, Gd^Fdw, Gd, Gs, Gd^Es, Gd^Fdw, Gd^Fdw, Gll^Fdw, Rb^Fdw, Rb^Fdw, Rb^Fdw, Rb^Fdw, Rb^Fdw, Rb^Fdw
Gll^Fdw, Gll^Fdw, Re^Fdw, Re^Fdw, Gd^Fdw, Re, Re, Gll, Gd, Gd, Gd^Fdw, Gs^Fdw, Gd, Gd^Fdw, Gd, Gd, Gs, Gd^Fdw, Gd^Ve, Gll^Fdw, Gd^Fdw, Rb^Fdw, Rb^Fdw, Rb^Fdw, Rb^Fdw, Rb
Gll^Fdw, Gll^Fdw, Gll^Fdw, Re^Fdw, Re^Fdw, Re^Ve, Re, Gd^Es, Gd, Gs, Gd^Fdw, Gd, Gd, Gd, Gs^Fdw, Gs, Gd^Fdw, Gd, Gd^Fdw, Gll^Fdw, Gll^Fdw, Re^Fetd, Re^Fdw, Rb^Fdw, Rb^Fdw, Rb
Gll^Fdw, Gll^Fdw, Gll^Fdw, Re^Fdw, Re^Fdw, Gll^Fdw, Gs^Fdw, Gd, Gs, Gs^Fdw, Gd, Gd, Gd, Gs, Gs, Gs^Fdw, Gd^Fdw, Gs, Gd, Gll^Fdw, Gd^Fdw, Gd^Fdw, Gd^Fdw, Gll, Rb, Re
Gd, Gll^Fdw, Gll^Fdw, Re^Fdw, Gs^Fdw, Gd^Fdw, Gs^Fdw, Gs, Gs, Gs, Gs^Es, Gd, Gd^Fdw, Gd^Fdw, Gd^Fdw, Gd^Fdw, Gd^Fdw, Gd, Re^Dr, Gd, Gd, Gd, Gll^Fdw, Gll^Fdw, Rb^Fdw, Re^Fdw
Gs^Fetd, Gll^Fdw, Gd^Fdw, Gd^Fdw, Gd, Gd, Gd, Gs, Gs, Gs, Gd, Gs, Gs^Fdw, Gd^Fdw, Gd, Gs^Fdw, Gd^Fdw, Re^Fdw, Re^Fdw, Re, Gd, Gd^Fdw, Gd^Fdw, Rb^Fdw, Rb^Fdw, Re
Gs^Fdw, Gd^Fdw, Gd^Fdw, Gd^Fdw, Gd^Fdw, Gs, Gs, Gs, Gs^Es, Gs, Gs, Gs^Fdw, Gs^Fdw, Gd, Gs^Es, Gd, Gd^Fdw, Gs^Fdw, Re^Fdw, Re^Fdw, Re^Fdw, Gd^Fdw, Rb^Fdw, Rb^Fdw, Rb^Fdw, Re^Fdw
Gd, Gd^Fdw, Gll^Fdw, Gd, Gd, Gs^Fdw, Gs, Gs, Gs^Es, Gs, Gs, Gs^Fdw, Gs, Gs^Fdw, Gs^Es, Gs^Fdw, Gd^Fdw, Gd^Fdw, Re^Fdw, Gd^Fdw, Re^Dr, Re^Fdw, Rb^Fdw, Rb^Fdw, Rb^Fdw, Re
Gd^Fdw, Gd, Gll^Fdw, Gd^Fdw, Gd^Fdw, Gd, Gd, Gs^Es, Gd, Gd, Gs, Gs, Gs, Gs, Gs^Fdw, Gs, Gs^Fdw, Gd^Fdw, Gs, Gs, Gs, Re^Fdw, Re, Rb^Fdw, Rb^Fdw, Re^Fdw
Gs^Ve, Gll^Fdw, Re^Fdw, Re^Fdw, Gd^Fdw, Gs, Gs, Gs, Gs, Gs, 1 Gs, Gs, Gd, Gs, Gs, Gd, Gs, Gs, Gs, Gs, Gd, Gd, Gd^Fdw, Re^Fdw, Re^Fdw, Gll^Fdw
Re^Fdw, Re^Fdw, Gd^Fdw, Gd^Fdw, Gd, Gs, Gs, Re, Gs, Gs, Gd, Gs, Gs, Re, Gs, Gs, Gs^Es, Gs, Gs^Fdw, Gs^Fdw, Gd^Fdw, Gd, Gd^Fdw, Re^Fdw, Gll^Fdw, Gll^Fdw
Gll^Fdw, Re^Fdw, Gd^Fdw, Gs, Gs, Gd, Re, Re, Gs, Gs, Gd^Fdw, Gs, Gs^Fetd, Gs^Fdw, Gd, Gs, Gs, Gs, Gs, Gd^Fdw, Gd^Fdw, Gd^Fdw, Gd^Fdw, Re^Fdw, Gll^Fdw, Gs
Gll^Fdw, Gll^Fdw, Gd^Fdw, Gd^Fdw, Gs^Es, Gd^Es, Gd, Gd, Gs, Gd, Gd^Fdw, Gd, Gs, Gs^Es, Gd, Gd, Gs, Gs^Fdw, Gd^Fdw, Gd^Fdw, Gd, Gd^Fdw, Gs, Gll^Fdw, Gs, Gs
Gd^Fdw, Gd^Fdw, Re^Fdw, Gd^Es, Gs, Re, Gd, Gd^Fdw, Gd, Gs^Es, Re, Gs, Gs, Gd, Gs, Gs, Re^Es, Gd, Gs, Gd, Gd, Gs, Gs, Gs^Fdw, Gs, Gs
Re^Fdw, Gd^Fdw, Re, Re^Dr, Re, Re, Gs, Gd^Fdw, Gd, Gd, Gd, Gd, Gd^Fdw, Gd^Fdw, Re^Es, Gd^Es, Re^Dr, Re, Gd^Fdw, Gd, Gs, Gs, Gd, Gs, Gd^Fdw, Gs
Re^Fdw, Gd^Fdw, Gd^Fdw, Gd^Fdw, Gd^Fdw, Gd^Fdw, Gd^Fdw, Gd^Fdw, Gd^Fdw, Gd, Gd, Gd, Re^Fdw, Re^Fdw, Re^Fdw, Gd^Es, Re, Gd^Es, Gd^Fdw, Gd^Fdw, Gs^Fdw, Gs, Gd, Gs, Gd^Fdw, Gs^Fdw
Re^Fdw, Re^Fdw, Gd^Fdw, Re, Re^Fdw, Re^Fdw, Re^Fdw, Re^Fdw, Re^Fdw, Re^Fdw, Re^Fdw, Gd^Fdw, Re^Fdw, Re^Fdw, Re^Fdw, Re^Fdw, Re^Fdw, Gd^Fdw, Gll^Fdw, Gll^Fdw, Gd^Fdw, Gs^Ve, Gd^Fdw, Gd^Fdw, Rb^Fdw, Gs^Fdw
Re^Fdw, Re^Fdw, Gd^Fdw, Gd, Re, Gd^Fdw, Gd^Fdw, Re^Fdw, Gd^Fdw, Re^Fdw, Re^Fdw, Re^Fdw, Gd^Fdw, Gd^Fdw, Gd^Fdw, Gd^Fdw, Gll^Fdw, Gll, Gll^Fdw, Gd^Fdw, Gd^Fdw, Gd^Fdw, Gd^Fdw, Rb^Fdw, Rb^Fdw, Gd^Fdw
Re^Fdw, Re^Fdw, Gd^Fdw, Gd^Fdw, Re^Fdw, Gd^Fetd, Gd, Gd^Fdw, Gd^Fdw, Re^Fdw, Gll^Fdw, Gll^Fdw, Gd^Fdw, Gd, Gll, Gd^Fdw, Gll^Fdw, Gll, Gll^Fetd, Gll^Fdw, Gll^Fdw, Rb^Fdw, Rb^Fdw, Rb^Fdw, Rb^Fdw, Gll^Fdw
Gd^Fdw, Gd^Fdw, Gd, Re^Ve, Re^Fdw, Re^Fdw, Gd, Gd^Fdw, Gd^Fdw, Re^Fdw, Gll^Fdw, Gd^Fdw, Gd, Gd^Fdw, Gd, Gll^Fdw, Gd^Fdw, Gll^Fdw, Gll^Fdw, Gll^Fdw, Gll^Fdw, Gd^Fdw, Gd^Fdw, Rb^Fdw, Gd^Fdw, Gd^Fdw
Gd, Re^Fdw, Gd^Fdw, Gd^Fdw, Gd, Gd, Gd, Gd^Fdw, Gd^Fdw, Gd^Fdw, Gd^Fdw, Gd^Fdw, Gd, Gd^Fdw, Gs^Fdw, Gd^Fdw, Gd^Fdw, Gd^Fdw, Gd, Gll^Fdw, Gll, Gll, Gd, Gll^Fdw, Gll^Fdw, Gd^Fdw
