border_size=1
usage=map

Gs          , Gs          , Rp          , Gg          , Gg          , Gg          , Gll^Fp      , Gd^Fmw      , Gs^Fds      , Gll^Fp      , Gll^Fp      , Gs^Fms      , Gll^Fp      , Gll^Fp      , Gs^Fds      , Gll^Fp      , Hh^Fp       , Hh          , Hh^Fp       , Hh^Fp       , Hh^Fp       , Hh          , Hh^Fp       , Hh^Fp       , Hh^Fmw      , Hh          , Hhd         , Hhd^Fmw     , Hhd         , Hhd         , Md          , Md          , Md          , Md^Xm       , Md^Xm       , Md^Xm       , Md          , Md          , Md          , Md          , Md^Xm       , Md          , Md          , Qlf         , Qlf         , Md          , Md^Xm       , Md^Xm       , Md^Xm       , Md^Xm       
Gs          , Gg          , Rp          , Rp          , Gs^Vl       , Gg          , Gll^Fp      , Gll^Fp      , Gg^Fet      , Gs^Fds      , Gs^Fds      , Gs^Fms      , Gll^Fms     , Gs^Fds      , Gs^Fds      , Gll^Fp      , Gll^Fdw     , Gs          , Hh^Fp       , Gll^Fp      , Gs          , Hh          , Hh^Fdw      , Hh^Fp       , Hh^Fmw      , Hhd^Fmw     , Hhd         , Hhd^Fdw     , Gs          , Hhd         , Hhd^Fdw     , Md          , Md          , Md^Xm       , Md^Xm       , Md^Xm       , Md          , Md          , Md          , Md^Xm       , Md          , Md          , Md          , Qlf         , Md          , Md          , Md^Xm       , Md^Xm       , Qlf         , Md          
Gg          , Gg          , Gg^Efm      , Rp          , Re          , Gg          , Gg          , Gg          , Gll^Fp      , Gs^Fds      , Gs^Fms      , Gll^Fms     , Gll^Em      , Gll^Fp      , Gll^Fp      , Gs^Fds      , Gd^Fmw      , Hh          , Hh          , Gs          , Gs          , Hh          , Hh^Fp       , Hh^Fmw      , Hh          , Hh^Fdw      , Hhd^Fdw     , Gs          , Gs          , Gs^Fdw      , Hhd^Fdw     , Hhd         , Md          , Md          , Md^Xm       , Md          , Qlf         , Qlf         , Md          , Md          , Qlf         , Md          , Md          , Md          , Md          , Md^Xm       , Md          , Md          , Qlf         , Md          
Gs          , Gs          , Gg^Efm      , Gg          , Gs^Es       , Rp          , Re          , Gg^Efm      , Gg^Em       , Gs^Fms      , Gd^Fmw      , Gs          , Re          , Gll^Fp      , Gs          , Gll^Fmw     , Gg          , Hh          , Gs          , Gg          , Hh          , Hh          , Gs          , Hh^Fdw      , Gs          , Hh          , Hhd^Fdw     , Gs          , Hhd^Fdw     , Md          , Hhd         , Hhd         , Md          , Md^Xm       , Md          , Hhd         , Qlf         , Md          , Md          , Qlf         , 4 Khr       , Qlf         , Md          , Md          , Md          , Md^Xm       , Hhd         , Md          , Md          , Qlf         
Hh          , Gg          , Gs          , Gg          , Gg          , Gg          , Rp          , Rp          , Gg          , Gg^Em       , Gg          , Re          , Gg          , Gg^Vhr      , Gs          , Gs          , Gg^Eff      , Hh          , Gs          , Gg          , Gg          , Gs          , Hh          , Hh^Fdw      , Hhd         , Gs          , Gs          , Gs          , Hhd^Fdw     , Md          , Md          , Hhd         , Md          , Md          , Md          , Hhd^Fdw     , Hhd         , Md          , Chr         , Chr         , Chr         , Qlf         , Md          , Hhd         , Md          , Hhd         , Hhd         , Hhd         , Md^Xm       , Md          
Hh          , Gs          , Hh^Fp       , Gs          , Gg          , Gg          , Gg^Es       , Rp          , Rp          , Gs          , Re          , Ce          , Ce          , Re          , Re          , Gg          , Gg^Efm      , Gs^Eff      , Re          , Gs          , Gs          , Gg          , Hh          , Hhd^Fdw     , Hhd^Fdw     , Gs          , Gs          , Hhd^Fdw     , Re          , Hhd         , Hhd^Fdw     , Md          , Md          , Chr         , Md          , Hhd         , Hhd         , Md          , Re^Es       , Re          , Chr         , Qlf         , Qlf         , Hhd^Fdw     , Md          , Md^Xm       , Md^Xm       , Md          , Md          , Md          
Hh          , Hh          , Hh^Fms      , Gg          , Gs          , Gg          , Gg          , Gg^Vhr      , Gs          , Re          , Ce          , Ce          , 3 Ke        , Ce          , Re^Es       , Gs          , Gg          , Gs          , Re^Es       , Gs          , Gs          , Gs          , Gs          , Hh          , Gs          , Gs          , Gs          , Re^Fdw      , Re          , Hhd^Fdw     , Re^Fdw      , Gd          , Hhd         , Hhd         , Re^Fdw      , Re^Fdw      , Hhd         , Hhd         , Chr         , Md          , Md          , Qlf         , Hhd^Fdw     , Qlf         , Md          , Md          , Md          , Md^Xm       , Qlf         , Md          
Hh          , Hh          , Hh          , Hh          , Hh          , Gs          , Gg^Efm      , Re          , Gg          , Gs          , Re          , Ce          , Ce          , Ce          , Re          , Re          , Gg^Vhr      , Gs          , Gs          , Gg          , Gs          , Gs          , Hh          , Hh          , Gs          , Gs          , Gs          , Gs          , Re          , Gd^Fdw      , Re          , Re^Es       , Gs          , Gd^Fetd     , Re^Fdw      , Re^Es       , Gs^Es       , Hhd^Fdw     , Hhd         , Md          , Md^Xm       , Hhd^Fdw     , Hhd         , Md          , Md^Xm       , Md^Xm       , Chr         , Md          , Qlf         , Md          
Hh          , Hh^Fp       , Hh^Fms      , Hh^Fp       , Hh^Fp       , Hh          , Hh          , Re          , Gs          , Gg          , Re          , Re          , Re          , Gs          , Rp          , Gg          , Gs^Eff      , Gs^Eff      , Gs^Fds      , Gll^Fp      , Gs          , Gs          , Gs          , Gs          , Gs          , Gg          , Gs          , Hhd         , Gd          , Gd          , Gd          , Re^Vhr      , Gs          , Re          , Re          , Gs          , Hhd         , Md          , Md^Xm       , Md          , Md          , Md          , Hhd^Fdw     , Md          , Md^Xm       , Md          , Hhd         , Qlf         , Qlf         , Md          
Hh          , Hh^Fds      , Hh          , Hh^Fms      , Hh          , Gs          , Hh          , Gg          , Gg          , Gs          , Gg          , Gs^Vhr      , Re          , Gg          , Re          , Re          , Gs          , Gs          , Gll^Fp      , Gs^Fms      , Gll^Fp      , Gg          , Gs          , Gs          , Gd^Fdw      , Gd^Fdw      , Gs          , Gs          , Gd          , Re          , Hhd         , Gs          , Re^Dr       , Gs          , Hhd         , Hhd         , Hhd^Fdw     , Md          , Md          , Md          , Md          , Hhd^Fdw     , Hhd         , Md^Xm       , Md^Xm       , Hhd         , Hhd         , Qlf         , Md          , Md          
Hh^Fp       , Hh^Fp       , Hh          , Hh^Fds      , Hh          , Gg          , Gg          , Gg          , Gs          , Hh          , Gs          , Gg          , Gs^Eff      , Gs^Eff      , Re          , Re^Es       , Rp          , Gs          , Gs          , Gs^Fms      , Gg          , Gg          , Gs          , Gs^Fdw      , Gd^Fdw      , Gs          , Gs          , Gd          , Hh          , Gs          , Hhd^Fdw     , Hhd         , Re^Es       , Re^Es       , Gs          , Hhd         , Md          , Chr         , Md          , Md          , Hhd         , Hhd         , Hhd         , Md          , Md          , Md          , Qlf         , Qlf         , Md          , Md^Xm       
Hh^Fp       , Hh          , Gg          , Gg          , Gs          , Gg          , Gs          , Gs          , Hh          , Hh^Fp       , Gg          , Gg          , Gg          , Gs^Em       , Gg          , Gs          , Gs          , Re          , Rp          , Gs          , Gg          , Gg          , Gg          , Gs^Fdw      , Gs          , Gs          , Hh          , Hh          , Hh          , Hh          , Hhd         , Re          , Gd          , Gd          , Hhd         , Gd          , Hhd         , Md          , Hhd^Fdw     , Md          , Md          , Md^Vhhr     , Hhd         , Qlf         , Qlf         , Md          , Qlf         , Qlf         , Hhd         , Md          
Hh          , Gg          , Gg          , Gg          , Hh          , Hh          , Hh          , Gs          , Gs          , Gs          , Gs          , Gg          , Hh^Fp       , Gll^Fp      , Hh          , Gg          , Re^Es       , Gs          , Re          , Gs          , Gs          , Gg^Es       , Gs          , Gg          , Gs          , Gs          , Gd          , Gd          , Hhd^Fdw     , Hhd         , Gd          , Re^Es       , Gd          , Gd^Fdw      , Hhd         , Gd          , Gd          , Hhd^Fdw     , Hhd         , Hhd         , Md          , Md          , Md          , Hhd         , Qlf         , Md          , Hhd         , Qlf         , Md          , Hhd         
Hh          , Hh          , Hh          , Gs          , Hh          , Hh^Fp       , Hh          , Hh          , Gs          , Gg          , Gs          , Hh          , Hh^Fp       , Hh          , Gs          , Gg          , Gs          , Gd          , Gs          , Re          , Gs          , Gs          , Gd          , Gs          , Gs          , Gs          , Gd          , Gd          , Gs          , Gd          , Gd          , Gs          , Hhd^Fdw     , Hhd         , Md          , Hhd^Fdw     , Hhd         , Hhd         , Md          , Hhd         , Md          , Md          , Md          , Hhd         , Hhd         , Hhd         , Md          , Mv          , Md          , Md^Xm       
Gs          , Gg          , Gs          , Gs          , Hh          , Hh          , Hh^Fp       , Hhd^Fmw     , Hhd^Fdw     , Gs          , Hhd         , Hhd^Fmw     , Hhd^Fdw     , Gs          , Gs          , Gd          , Re^Es       , Gs          , Gd          , Gd          , Gs          , Gs          , Re          , Gs          , Gd          , Gs          , Gs          , Gd          , Gs          , Gd          , Hhd         , Gd          , Hhd         , Md          , Hhd         , Hhd         , Md          , Hhd         , Md          , Qlf         , Qlf         , Qlf         , Md          , Hhd         , Md          , Md          , Md          , Md          , Md          , Md          
Gs          , Gs          , Gs          , Gs          , Gs          , Hh          , Gs          , Hhd         , Hhd         , Hhd         , Gd          , Hhd^Fdw     , Gs          , Gs          , Gd          , Qxe         , Re          , Qxe         , Qxe         , Re^Es       , Re          , Gs          , Gs          , Gd^Es       , Re          , Re          , Gs          , Gs          , Hh^Vhh      , Hh          , Gd^Fdw      , Hhd^Fdw     , Gd          , Hhd         , Md          , Hhd         , Md          , Md          , Qlf         , Qlf         , Md          , Qlf         , Md          , Md          , Qlf         , Qlf         , Qlf         , Qlf         , Qlf         , Md          
Gs^Fdw      , Gs^Fdw      , Gs^Fdw      , Gd^Fdw      , Gd          , Gs          , Gd          , Gs          , Gs          , Gd          , Qxe         , Re          , Re^Es       , Gs          , Gd          , Gd          , Gd          , Gd          , Gd          , Re^Es       , Re^Dr       , Gs          , Gd          , Gd          , Gs          , Re^Es       , Gs          , Gs          , Gd          , Gd^Fdw      , Gs          , Gd          , Gd^Fdw      , Hhd         , Md          , Md          , Md          , Md          , Md          , Md^Xm       , Md          , Qlf         , Md          , Md          , Qlf         , Md          , Md^Xm       , Qlf         , Qlf         , Md          
Gll^Fp      , Gs^Fms      , Gs^Fms      , Gd^Fdw      , Gd          , Gd^Fdw      , Gd          , Gd          , Gs^Es       , Qxe         , Gd          , Re^Es       , Gd          , Gd          , Ce          , Re          , Gd          , Gd          , Gd^Es       , Gd          , Re^Es       , Gd^Vhr      , Gd          , Gs          , Re          , Gd          , Gs          , Re          , Gs          , Gd^Fdw      , Gd          , Gd          , Hhd         , Hhd         , Md          , Qlf         , Qlf         , Md          , Md^Xm       , Md^Xm       , Qlf         , Qlf         , Qlf         , Qlf         , Md          , Md          , Md^Xm       , Md          , Qlf         , Qlf         
Gs^Fds      , Gs^Fds      , Gd^Fmw      , Gd^Fdw      , Gd          , Re          , Gd          , Gs^Es       , Gs^Dr       , Re          , Gs          , Gd          , Re          , Ce          , 5 Ke        , Ce          , Gd          , Gd          , Gd          , Gd          , Qxe         , Gd          , Gd          , Gd^Es       , Re^Dr       , Re          , Re          , Re^Es       , Gs          , Gd          , Hhd         , Hhd^Fdw     , Hhd         , Md          , Md          , Md          , Qlf         , Md          , Md^Xm       , Md^Xm       , Md          , Qlf         , Qlf         , Md          , Md^Xm       , Md^Xm       , Md^Xm       , Md^Xm       , Xue         , Xue         
Gs^Fds      , Gll^Fp      , Gd^Fmw      , Gd^Fmw      , Gd^Fdw      , Gd^Fdw      , Gd          , Gd          , Gs^Es       , Gd^Es       , Gs          , Gs          , Gd          , Ce          , Ce          , Ce          , Re^Es       , Re^Dr       , Re^Es       , Gd^Es       , Re          , Qxe         , Gd^Es       , Re^Es       , Re          , Re^Es       , Gs          , Re          , Gd          , Gs          , Re^Fdw      , Gd^Fdw      , Hhd^Fdw     , Md          , Md          , Qlf         , Qlf         , Md          , Xue         , Md^Xm       , Md          , Qlf         , Qlf         , Xue         , Xue         , Xue         , Xue         , Xue         , Xue         , Xue         
Gll^Fp      , Gs^Fms      , Gs^Fms      , Gd^Fdw      , Gd^Fdw      , Gd          , Gd^Es       , Qxe         , Gs^Es       , Gs          , Re^Vhr      , Gs          , Gd^Es       , Re          , Gs          , Gd          , Gs^Es       , Re^Dr       , Gd^Es       , Gd          , Re          , Qxe         , Gd^Es       , Gs          , Hhd         , Gs          , Gs          , Re          , Gd          , Gs          , Re^Fetd     , Re^Fdw      , Hhd^Fdw     , Md          , Hhd         , Md^Xm       , Xue         , Qlf         , Qlf         , Xue         , Xue         , Md          , Xue         , Qlf         , Qlf         , Xue         , Xue         , Xue         , Xu          , Xu          
Gs^Fds      , Gs^Fms      , Gd^Fdw      , Gd^Fdw      , Gd          , Gd          , Gd^Es       , Qxe         , Qxe         , Gs          , Gd^Es       , Re          , Re^Es       , Gd          , Gs          , Re          , Gs          , Gd          , Gs          , Gd          , Qxe         , Re          , Gd^Es       , Gs          , Hhd         , Hh          , Gs          , Gd          , Gd^Es       , Re^Vhcr     , Hhd         , Hhd         , Chr         , Hhd         , Xue         , Md          , Xue         , Xue         , Xue         , Xue         , Xue         , Xue         , Xue         , Xue         , Xue         , Xue         , Xue         , Xu          , Xu          , Xu          
Gs^Fds      , Gs^Fms      , Gd^Fmw      , Gd          , Gd^Fdw      , Gd          , Gd          , Qxe         , Gs^Es       , Qxe         , Gd          , Re^Dr       , Re          , Gs^Es       , Gs          , Re          , Re          , Gd          , Gs          , Gs^Es       , Gd          , Gd^Es       , Gs          , Gd          , Hhd         , Hhd         , Gd          , Re^Es       , Re^Dr       , Gs          , Gd          , Gs^Es       , Hhd         , Hhd         , Xue         , Xue         , Xuce        , Xu          , Xue         , Xue         , Uh          , Xu          , Xu          , Xue         , Xue         , Xue         , Xue         , Xue         , Xue         , Xu          
Gs^Fds      , Gll^Fp      , Gs^Fms      , Gd^Fdw      , Gd^Fdw      , Gd^Fdw      , Gd          , Gs          , Gs          , Qxe         , Qxe         , Re^Es       , Gd          , Gd          , Qxe         , Gd          , Re^Es       , Re^Es       , Gd          , Gd          , Gs          , Gd          , Hhd         , Hhd         , Md          , Hhd         , Hhd^Vhhr    , Re^Es       , Re          , Chr         , Re^Es       , Re^Es       , Chr         , Hhd         , Uh          , Xue         , Xos         , Xue         , Ur^Ufi      , Ur^Emf      , Ur^Em       , Uh          , Uh          , Xu          , Xue         , Ql          , Ql          , Xue         , Xue         , Xue         
Gll^Fp      , Gll^Fp      , Gs^Fds      , Gs^Fms      , Gd^Fdw      , Gd^Fdw      , Gd^Fdw      , Gd          , Gs          , Gd          , Re^Es       , Gd          , Gd          , Gs^Es       , Qxe         , Gs          , Gd          , Re^Dr       , Gd^Es       , Qxe         , Gs          , Hhd         , Md          , Hhd         , Hhd         , Hhd         , Gd^Es       , Gd          , Re^Es       , Re          , Re^Es       , Re^Dr       , Chr^Es      , Ce^Es       , Rr^Dr       , Uh          , Xos         , Uue^Ufi     , Uue^Uf      , Xu          , Uh          , Rr          , 1 Rr        , Uh          , Xu          , Xu          , Ql          , Xue         , Xue         , Xue         
Gll^Fp      , Gs^Fds      , Gs^Fds      , Gll^Fp      , Gd^Fmw      , Gd^Fdw      , Gd^Fdw      , Gd          , Gd          , Gd^Es       , Re^Dr       , Re^Es       , Qxe         , Qxe         , Gd          , Gd          , Qxe         , Re          , Gd          , Gd          , Gs          , Hhd         , Md          , Md^Xm       , Md          , Hhd         , Re          , Chr         , Re^Es       , Re^Vhcr     , Gd          , Re^Es       , Chr         , Khr         , Rr^Es       , Uh          , Xol         , Uue^Emf     , Uue         , Xue         , Xu          , Rr          , Uu          , Uu^Em       , Xu          , Uh          , Ql          , Xu          , Xu          , Xu          
Gs^Fms      , Gs^Fds      , Gll^Fp      , Gd^Fmw      , Gd^Fmw      , Gd^Fdw      , Gd^Fdw      , Gd^Fdw      , Gd^Fdw      , Re          , Re^Es       , Gd          , Gd          , Qxe         , Gd          , Gd          , Gd^Es       , Qxe         , Gd          , Gs          , Hhd         , Hhd         , Md          , Md^Xm       , Qlf         , Hhd         , Hhd         , Hhd         , Md          , Gd          , Hhd         , Gd          , Chr         , Rr^Dr       , Rr          , Rr          , Rr          , Xol         , Xos         , Uu^Ii       , Ur^Ii       , Uu          , Xu          , Xu          , Uh          , Uh          , Uu          , Xu          , Xu          , Xu          
Gs^Fms      , Gll^Fp      , Gll^Fdw     , Gll^Fp      , Gd^Fmw      , Gd^Fmw      , Gd^Fdw      , Gd^Fdw      , Gd^Fdw      , Re^Fdw      , Re^Fdw      , Gd          , Re^Es       , Qxe         , Gd          , Gd          , Re^Es       , Gd^Es       , Gd          , Hhd^Vhhr    , Hhd         , Md          , Qlf         , Md^Xm       , Md^Xm       , Qlf         , Md          , Md          , Chr         , Hhd         , Hhd         , Hhd         , Hhd         , Uh          , Uh          , Uh          , Xos         , Rr^Zz/      , Rr          , Ur          , Xue         , Uh          , Ql          , Xu          , Uh          , Uh          , Xu          , Xu          , Xu          , Xu          
Gs^Fms      , Gll^Fp      , Gll^Fds     , Gll^Fp      , Gd^Fmw      , Gs^Fdw      , Gll^Fdw     , Gll^Fdw     , Gd^Fmw      , Gd^Fdw      , Gd^Fdw      , Gd          , Gd          , Re          , Gd          , Gd          , Re          , Gd^Es       , Gd          , Hhd         , Md          , Md          , Md          , Hhd         , Md^Xm       , Md^Xm       , Md          , Md          , Md          , Md          , Md          , Md          , Xue         , Uh          , Xos         , Xos         , Xos         , Xos         , Uue^Uf      , Rr          , Uu          , Uh          , Ql          , Xu          , Uu          , Uu^Ii       , Uh          , Xu          , Xu          , Xu          
Gll^Fp      , Gs^Fds      , Gll^Fms     , Gll^Fp      , Gd^Fmw      , Gs^Fms      , Gll^Fms     , Gll^Fp      , Gd^Fmw      , Gs^Fdw      , Gd^Fdw      , Gd^Fdw      , Gd^Fdw      , Re^Fdw      , Re^Fdw      , Gd          , Re^Fdw      , Gd          , Gd          , Hhd         , Gs          , Hhd         , Md          , Md          , Md^Xm       , Md^Xm       , Qlf         , Qlf         , Md          , Md          , Md          , Md          , Xue         , Xue         , Xue         , Xue         , Xue         , Xos         , Xue         , Uu^Em       , Uu^Uf       , Uue^Ii      , Uue         , Ql          , Ql          , Uh          , Uh          , Ql          , Ql          , Xu          
Gs^Fms      , Gll^Fp      , Gll^Fms     , Gll^Em      , Gs^Vl       , Gs^Fms      , Gs^Fms      , Gll^Fmw     , Gll^Fdw     , Gll^Fdw     , Gll^Fmw     , Gll^Fdw     , Gll^Fds     , Gll^Fdw     , Gd^Fdw      , Gd^Fdw      , Re^Fdw      , Re          , Re          , Gd          , Hhd         , Hhd         , Md          , Md^Xm       , Md          , Md          , Chr         , Qlf         , Qlf         , Qlf         , Qlf         , Xue         , Qlf         , Qlf         , Xue         , Xue         , Xue         , Xue         , Xue         , Xu          , Xue         , Uue^Uf      , Xue         , Ql          , Xu          , Xu          , Xu          , Xu          , Ql          , Xu          
Gs^Fms      , Gll^Fp      , Gll^Fp      , Gll^Fms     , Gll^Fp      , Gs^Fds      , Gll^Fp      , Gll^Fp      , Gs^Fms      , Gll^Fms     , Gll^Fp      , Gs^Fms      , Gll^Fp      , Gs^Fms      , Gs^Fms      , Gd^Fdw      , Gd^Fdw      , Re          , Re          , Gd          , Hhd         , Md          , Md          , Md^Xm       , Hhd         , Md          , Md          , Md          , Xue         , Xue         , Qlf         , Qlf         , Qlf         , Qlf         , Xue         , Xue         , Xu          , Xue         , Xue         , Xue         , Xue         , Xue         , Xue         , Ql          , Xu          , Xu          , Xu          , Xu          , Xu          , Xu          
