border_size=1
usage=map

Gd^Fmw, Wwg, Wog, Wog, Wwg, Gll^Em, Gll^Fdw, Gll^Fdw, Gll^Fmw, Gll^Fmw, Wwf, Wwf, Re^Fdw, Chr, Gs, Gs, Rp, Gs, Gs, Ch, Ch, Khr, Khr, Khr, Khr
Gll^Fp, Wwg, Wwg, Wog, Wog, Wwg, Wwg, Wwg, Wwg, Wwg, Re^Fdw, Re^Fdw, Re, Chr, Khr, Gd^Vhcr, Rb^Dr, Gd^Fetd, Re, Gs, Ch, Khr, Kh, Khr, Khr
Rr, Gll^Fmw, Wwg, Wog, Wwg, Wog, Wog, Wog, Wwg, Rb, Rb^Fdw, Re^Fdw, Rb^Fdw, Re^Dr, Qxe, Re^Es, Rb^Es, Rb, Gd, Ch, Ch, Khr, Ch, Kh, Khr
Gll^Fmw, Rp^Vhcr, Wwg, Wwf, Gs, Wwg, Wwg, Wog, Wog, Wwg, Rb^Vhcr, Re^Fdw, Re^Es, Rb^Es, Rb^Dr, Qxe, Re^Es, Rb, Gd^Fetd, Gs, Ch, Ch, Ch, Ch, Ch
Wwg, Wwf, Wwg, Gll^Fp, Gs, Wwg, Wog, Wog, Rp^Vhcr, Wog, Wwg, Re, Rb, Rb, Rb^Es, Rb^Dr, Qxe, Rp, Rp, Gs^Vhcr, Rp, Rr, Rp, Ch, Gs^Efm
Gll^Fp, Wwg, Gll^Fmw, Gg^Em, Wwg, Wog, Rp^Vhcr, Gd^Fdw, Rr, Wog, Wwg^Bw/r, Wwg^Bw/r, Rb^Dr, Rb^Es, Rb^Dr, Rb^Dr, Chr, Gd, Gs^Vhcr, Rp, Rr, Rr^Eza, Rr, Gs^Efm, Gd^Fetd
Gd^Fmw, Gs^Fms, Gll^Fp, Gll, Wwg, Wog, Gd^Fdw, Rr^Es, Khr, Rr, Wog, Wog, Wwg, Rb, Rb^Es, Re^Fdw, Gll^Fmw, Chr, Khr, Rp, Rr, Rr, Rp^Vhc, Rp, Rp
Gll^Fp, Gll^Fp, Gll^Fp, Gd^Fmw, Wwg, Wog, Rp^Vhcr, Rr^Es, Chr, Chr, Wog, Wog, Wwf, Re, Re^Fmw, Re^Fdw, Gll^Fp, Chr, Chr, Rr, Rr, Rr, Gs, Gs^Efm, Gg
Gll^Fp, Gll^Fp, Gs^Fms, Gll^Fp, Gll^Em, Wog, Wog, Gd^Dr, Wog, Wog, Wwg, Wwf, Gs, Gll^Fp, Gll^Fmw, Gll^Fp, Gs^Eff, Gg^Vhc, Rr, Rr, Rr, Rp, Khr, Gs, Chr
Gll, Gll^Fms, Gs^Fms, Gll^Fp, Gll^Emf, Gg^Em, Wog, Wog, Gs, Wwg, Gll^Fp, Gll^Fp, Gs, Gg, Gg^Eff, Gs^Eff, Rr, Rr, Rr, Rr, Rr, Chr, Qxe, Qxe, Re
Gll^Fmw, Gll^Fmw, Gs^Fms, Gll^Fp, Gll^Fmw, Gll^Fp, Wog, Gll^Fmw, Gll, Gll^Fmw, Gll^Fp, Gs^Fms, Gs, Gg^Eff, Rp, Rp, Rr, Rr, Rr, Rp, Re, Re^Es, Qxe, Qxe, Rb^Es
Gll^Fp, Gll^Fp, Gll^Fmw, Gd^Fmw, Gll^Fp, Gd^Fmw, Rp, Wwg, Wwf, Gs, Rp, Rp, Rp, Rp, 2 Rr, Rr, Rr, Rp, Gg^Eff, Gg^Vhc, Rb^Es, Re^Es, Rb^Es, Qxe, Re^Es
Gll^Em, Gll^Fmw, Gs^Em, Gll^Fp, Rr, Rp, Rp, Rr, Rr, Rp, Rr, Rr, 1 Rr, Rr, Rr, Rr, Gs^Eff, Gg^Eff, Gg^Efm, Gg^Em, Gll^Fp, Re^Es, Rb^Es, Re^Es, Gll^Fp
Gg^Em, Gg^Em, Rp, Rr, Rr, Rp, Rr, Rr, Rr, Rr, Rp, Rr, Rp, Rr, Rr, 3 Rr, Rr, Gs^Eff, Gg^Eff, Gll, Gll, Gll^Fp, Gll^Fp, Gll^Fp, Gll^Fp
Rr, Rp, Rr, Rr, Rr, Rr, Rp, Rr, Rp, Rp, Rp, Rr, Gll^Fmw, Rp, Rr, Rr, Rr, Rp, Rp, Gg^Em, Gg^Eff, Gg, Gg, Gll^Em, Gg
Rr, Rr, Rr, Rr, Rr, Rp, Gll^Fp, Gll^Fmw, Gd^Fmw, Gll^Fmw, Gll^Fp, Gll^Fmw, Gll^Fp, Gll^Fp, Gll^Fp, Rr, Rr, Rr, Rp, Rp, Rr, Gg^Eff, Gg^Eff, Gll, Gg
