border_size=1
usage=map

Hhd^Fdw, Hhd^Fdw, Hhd^Fdw, Hhd^Fdw, Hhd, Hhd^Fdw, Hhd^Fdw, Hhd, Hhd, Gs, Gs, Gg, Gs, Rr, Rr, Gs, Gs, Gs, Gs, Gs, Re, Re, Re, Gs, Gs, Gg, Gs, Gs, Gg, Gg, Rr, Gg, Gs, Gg, Re, Gg, Gs^Es, Re, Gs, Rb, Rb, Re, Re^Es, Re, Gd, Gd, Gd, Gd, Re, Gd, Gs, Gg, Gg, Gs, Gs, Gs, Re, Rr, Re, Re, Re, Re, Gd, Re
Hhd, Hhd^Fdw, Hhd^Fdw, Hhd^Fdw, Hhd, Hhd^Fdw, Hhd^Fdw, Hhd, Gs, Gd, Ce, Ce, Ce, Gs, Gs, Rr, Rr, Gs^Es, Gs, Re^Es, Re^Edb, Re^Es, Re, Re^Es, Re, Gg, Gs, Gs, Rr, Rr, Gs, Gs, Re, Rb, Rb, Rb, Re, Gg^Vhr, Gs^Es, Rb^Es, Gd, Re, Re, Re, Ce, Re, Re^Vhcr, Re, Re, Gd, Gd, Gs, Gd, Gd, Gs^Fdw, Re^Fdw, Re, Rr, Re, Rb, Rb, Chr, Chr, Re
Gs, Hhd, Hhd, Hhd^Fdw, Hhd, Hhd, Hhd, Hhd, Gd, Gd^Es, Ce, 5 Ke, Ce, Ce, Gd, Gs^Vhcr, Gs^Es, Rr, Rr, Gs^Es, Gd^Vhr, Re^Edb, Re^Es, Re^Es, Gs, Gs, Gd^Fetd, Rr, Gg^Efm, Gs, Gs, Re^Es, Rb^Es, Rb, Re^Es, Rb, Gs, Gg, Gs, Gd, Re, Ce, Ce, Ce, Re, Re, Rr, Re, Rb, Re, Gd^Fdw, Gs^Fdw, Gd, Gs, Re, Gs^Fdw, Re, Re, Rr, Rb^Fetd, Re^Fdw, Rb^Dr, Chr, Re
Gg, Gs, Hhd, Gs, Hhd, Gd, Gs, Gs, Gd, Gs, Gs, Ce, Gs, Gd, Gs, Gs, Gg^Es, Gs, Rr, Gs, Gg, Gs^Edb, Gg, Gg, Gg, Gs, Rr, Rr, Gg, Gs, Gd^Es, Gd^Es, Gs, Re, Gg, Gs, Gs, Gg, Gs, Gd, Re, Ket, Re, Re^Es, Re, 1 Rr, Re, Re, Rb, Re^Es, Re, Gs^Fdw, Re, Re^Gvs, Re^Gvs, Re, Re, Re^Fdw, Rb, Re, Re^Fdw, Rb, Gd, Re
Gs, Gs, Gs, Gs, Gs, Gd, Gs^Efm, Gs, Gs^Dr, Gs^Es, Gs, Gd^Es, Gs, Gs, Gd, Gg, Gd, Gd, Gs, Rr, Gs^Es, Gs, Gs, Gs, Rr, Rr, Gs, Gs, Gs, Gs, Gll, Gd^Es, Gs, Gd, Gg, Gg, Gll^Fdw, Gll^Fdw, Gd, Gd, Gs, Re, Re^Es, Re, Re^Edt, Re, Re, Rb^Edt, Re^Es, Re^Dr, Re^Edb, Re, Re, Re^Es, Re^Gvs, Re^Gvs, Ce, Re, Re, Rr, Rr, Gd^Fdw, Re, Re
Gg, Gg, Gs, Gg, Gg, Gs, Gg, Gg, Gs, Gs^Es, Gs, Gd^Vhr, Gs, Gs, Gs^Es, Gg, Gs, Gs^Edt, Gs^Edt, Rr, Re^Dr, Gs, Gll^Fdw, Gs, Rr, Gs, Gd, Gs, Gd^Fdw, Gll^Fdw, Gll^Fdw, Gs, Gd, Gd, Gs, Gll, Gll^Fdw, Gd^Fmw, Gs^Em, Chr, Re, Re, Re^Dr, Re^Es, Re^Edt, Re, Re^Es, Re, Re, Rb^Edt, Rb^Edb, Gs, Gs^Dr, Re^Gvs, Gd, Gg, Gs, Ce, Gs, Re, Rb, Re, Re, Gd
Gs, Gg, Gg, Gg, Wwg, Gg, Wwg, Gg, Gg, Gs, Gs, Gs, Gs^Es, Gs, Gd^Dr, Gs, Re^Es, Re^Edt, Rr^Edb, Rr^Es, Gs^Es, Gll^Fdw, Gll^Fdw, Gs^Em, Rr, Gd, Re^Es, Gs^Es, Re^Edt, Gll^Fdw, Gd^Es, Gs, Gs, Gs^Es, Gs^Es, Gll^Fdw, Gs, Gs, Rr, Re, Chr, Re^Es, Re, Re^Edt, Rb, Rb, Re, Re^Gvs, Gd, Re^Edt, Rb^Edt, Re^Edb, Re, Gs, Gd, Gs, Gs, Ce, Gg, Re, Re, Gd, Gs, Re
Gs, Gg, Wwg, Wwg, Wog, Wwg, Wwg, Wwg, Wwg, Wwg, Wwg, Gg, Gs^Es, Re^Dr, Gs^Es, Gd^Es, Gll^Fetd, Re^Es, Rr, Rr, Ce, Re, Ce, Ce, Rr, Gd^Es, Re, Re^Es, Re^Edt, Re^Edt, Gll^Fdw, Gll^Es, Gs^Fdw, Gs^Es, Ce, Gs, Re, Rr, Gs, Gs, Gll, Gll^Fdw, Re, Re^Dr, Rb, Re, Re, Gd^Vhr, Re, Rb^Es, Re, Re^Es, Re, Rb, Rb, Rb, Gs, Gg, Re, Rr, Gll, Gs, Gll^Fdw, Gg
Wwg, Gs, Wwg, Wog, Wwg, Wog, Wwg, Wog, Wog, Wog, Wog, Wwg, Wwg, Gs, Gd, Gll^Fdw, Gd, Gll^Fdw, Rr, Rr, Gll^Fdw, Wwf, Wwf, Wwf, Rr, Gs, Gs^Es, Re^Edt, Gll^Fdw, Gll, Gll^Fdw, Gd^Es, Ce, Ce, Rr, Re, Ce, Ce, Ce, Gs, Gll^Fdw, Gd, Gs, Re^Edt, Re^Dr, Re^Es, Re^Es, Re^Edt, Re^Edt, Re^Es, Re, Re^Gvs, Gs, Gs, Gd, Gd, Gs, Rr, Gs^Vhcr, Gll^Fdw, Gd, Gs, Gll^Fdw, Gll
Wog, Wwg, Wog, Wog, Wwg, Wwg, Gs, Wwg, Wwg, Wwg, Wwg, Wog, Wog, Wwg, Wwg, Gll^Fdw, Gd, Gd, Rr, Gll^Fdw, Wwf, Wwf, Gll^Fdw, Wwf, Gll^Fdw, Rr, Rr, Re^Edt, Gll^Fmw, Gll^Fdw, Rr, Gs^Fdw, Rr, Re, Gs, Gs, Gs, Gs, Ce, Gs, Gs, Gll^Fmw, Gd, Re, Re, Re, Re^Gvs, Re, Re^Edt, Re^Gvs, Gll^Fmw, Gll^Fdw, Gll^Fmw, Gll^Fdw, Gll^Fdw, Gs, Gll^Fdw, Rr, Gll, Gll^Fdw, Gd, Gll, Gs, Gll^Fdw
Wwg, Wwg, Wwg, Wwg, Gd^Fmw, Gg, Ce, Gs, Gs, Gg, Gg^Efm, Wwg, Wwg, Wog, Wog, Wwg, Wwg, Gs^Es, Wwg^Dr, Gll^Fdw, Wwf, Gll^Fdw, Gll^Fdw, Rr^Vhcr, Gll^Fdw, Gll^Fdw, Rr, Gs^Wm, Rr, Rr, Gll^Fdw, Rr, Rr, Gs, Rp^Vhcr, Chr, Gd, Gd, Gs, Ce, Wwf, Gd, Gll, Gd^Vhr, Gs, Re, Re, Rb^Gvs, Gs, Re, Re, Gs, Gll^Fdw, Gll^Fdw, Gll^Fmw, Re^Fdw, Gll, Re, Re, Gll, Gs, Gs, Gg, Gll^Fdw
Gs, Wwg, Gs, Gs, Gs^Fdw, Gd^Fdw, Re, Gd, Re, Gs, Gs, Gs, Gd, Wwg, Ss, Wog, Wog, Wwg^Es, Wwg^Dr, Wwg, Ss, Ss, Gd, Rr, Rr, Gs^Eza, Rr^Es, Rr, Rr^Es, Gs^Vhr, Gll^Fdw, Gll^Fdw, Gs, Rr, Rr, Re^Es, Gs, Gd, Gs, Ket, Wwf, Gs, Gs, Gs, Gs, Re^Dr, Rb, Rb, Gg, Gs, Gd^Fmw, Gs^Es, Gd^Fmw, Gll^Fdw, Gll, Gll, Re, Gs, Ce, Ce, Ce, Gs, Gg, Gg
Gs^Fdw, Gs, Re, Gs, Re, Re, Re^Edt, Re^Edt, Re, Gd^Vhr, Gd, Gg, Gs, Gs, Chs, Ss, Wwg, Wog, Rr^Es, Wwg, Wwg, Ss, Gs, Rr, Rr^Dr, Rr, Rr, Rr^Dr, Rr, Gs^Es, Gs, Gll^Fdw, Gs^Fmw, Gs, Gs, Rr, Gs, Wwg, Wwg, Wwg, Wwg, Wwg, Wwg, Wwg, Wwg, Gs, Gs, Gs, Gg, Gs, Gg, Gd^Fdw, Gd^Fmw, Gll^Fdw, Gs, Gs^Vhr, Gd, Re, Ce, 7 Ke, Ce, Gs, Gg, Gs
Gs^Fdw, Re^Fdw, Gs, Gd, Re, Re^Dr, Re^Edt, Rp, Rp, Gs, Gs, Gg, Re, Gd^Es, Re, Wwg, Wwg, Re, Rr, Ss, Wwg, Wwg, Gs^Vhr, Rr^Es, Rr^Es, Rr, Rr, Rr^Dr, Ss, Ss, Ss, Gll^Fdw, Wwg, Wwg^Es, Wwg, Wwg^Bsb|, Wwg, Wwg, Wwg, Wog, Wog, Wwg, Wog, Wog, Wwg, Wwg, Wwg, Wwf^Es, Wwf, Gs, Gg, Gs^Fdw, Gll^Fdw, Gll^Fdw, Gg, Gd, Gd, Re, Gs, Ce, Gs, Gg, Gs^Vhr, Re
Gs, Re, Gd, Ce, Gs^Fdw, Re, Gs, Gs, Gd^Vhr, Rr, Rr, Gd, Gd^Es, Re^Es, Re^Dr, Re^Dr, Wwg, Re, Rr, Ss, Wwg, Wwg, Wwg, Gs^Fdw, Gs^Fdw, Rr, Rr, Gs, Wwg, Wwg, Wog, Wog, Wwg, Wwg, Wwg, Wwg^Bsb|, Wwg, Wwg, Gs, Wwg, Wwg^Bw/r, Wog, Wwg, Wog, Wwg, Wog, Wog, Wwg, Wwg^Es, Gs, Gs, Gs, Gs, Gg, Gs, Gd, Gll^Fdw, Re, Re, Gs, Gs, Re, Gll^Fdw, Gll^Fdw
Gs^Fdw, Gg, Gs^Fdw, Gs, Re^Fdw, Gd^Fdw, Gs, Gs, Re^Edb, Gs, Gs, Rr, Rr, Re, Rr, Re^Es, Rr^Es, Rr, Rr^Vhcr, Re^Fetd, Re^Vhr, Wwg, Wog, Wwg, Wwg, Re^Es, Wwg^Bsb|, Wwg, Wog, Wog, Wwg, Ss, Ss, Wwg, Rr, Rr, Gll^Fp, Gs, Gs, Gs^Ve, Gs, Wwg, Gs, Wwg, Gd, Wwg, Wwg, Wog, Wog, Wwg, Wwg, Wwf, Gs, Gg, Gs, Re, Re, Gll^Fdw, Re^Fdw, Gd, Gd, Re, Re^Fdw, Gll^Fdw
Gs^Fdw, Re^Fdw, Re, Gs, Gs, Gs, Re, Re^Dr, Re^Edb, Re^Edb, Re, Gd, Gd, Rr, Ce, Rr, Re^Dr, Rr, Rr, Re, Re^Edt, Ch, Wwg, Wog, Chw, Wwg, Wwg^Bsb|, Wwg, Wog, Chw, Gs^Fmw, Gs^Fmw, Rr, Rr, Gll^Fp, Rr, Gll^Fp, Gll^Fp, Gs, Rr, Gs, Ket, Gs, Gd, Gd, Gd^Fmw, Gd^Fdw, Wwg, Wwg, Wog, Wog, Wwg, Wwg, Gs, Gg, Re, Gs, Re^Fdw, Re^Fdw, Gd, Gd, Re^Fdw, Re^Fdw, Re
Gs^Fdw, Re^Fdw, Gs^Fdw, Re, Re, Gg, Gs, Re^Edb, Re^Edb, Gs^Edb, Gs^Fdw, Re^Fdw, Re, Re, Ce, Re^Es, Wwg, Re^Fdw, Rr, Rr, Rr, Gs, Wwg, Wog, Gll^Fet, Gs^Fmw, Rr, Gs, Rp^Vhc, Gs^Fmw, Rr, Rr, Gs, Gs, Gll^Fp, Rr, Rr, Gll^Fp, Gs^Vh, Rr, Ce, Ce, Gd, Gs, Gd^Fdw, Re, Re^Edt, Wwf, Wwg, Wog, Wog, Wog, Wwg, Wwg, Wwg, Gs, Wwg, Re, Re, Gs, Re, Re, Gd, Re
Gs, Re, Gs^Fdw, Re^Dr, Re, Gs, Rr, Re^Edb, Rr, Gs, Gd, Re^Fdw, Gs, Re, Re, Re^Fdw, Rr, Rr, Ch, Re^Fdw, Wwg, Wwg^Es, Wwg^Es, Wwg, Gs^Dr, Gll^Es, Chr, Rr, Rr, Rr, Gs^Ve, Chr, Ss, Ss, Gs, Gll^Fp, Re^Es, Rr, Rr, Rr, Ce, Re, Re^Es, Re^Fdw, Gd^Fdw, Re, Re^Dr, Re, Gd, Wwg, Wwg, Wog, Wog, Wwg, Wog, Wwg, Wog, Wwg, Wwg, Gg, Gs, Re, Re, Gd
Re, Gs, Re, Gs, Rr, Rr, Gs, Rr, Gs, Rr, Rr, Re, Rr, Rr, Rr, Rr, Re^Edt, Re^Vhcr, Wwg^Es, Wwg, Wwg, Wwg, Ss, Gs^Es, Chr, Chr, Chr, Rr, Rr, Gs^Fetd, Gs^Fp, Khr, Ss, Ss, Gs, Re^Es, Re^Es, Rr, Re^Dr, Re^Es, Re^Es, Re^Dr, Re^Es, Re, Gs, Re^Es, Re^Es, Re^Es, Re, Wwf^Es, Wwg^Es, Wog, Wog, Wog, Wwg, Wog, Wwg, Wwg, Wog, Wwg, Gg, Re, Gs, Gd
Rb, Re, Re^Dr, Re, Gd^Vhr, Gs, Qxe, Qxe, Gd^Fdw, Gg, Gs, Rr, Gs, Ce, Wwg, Re^Dr, Wwg, Re^Edt, Wwg, Wwg, Gll^Fmw, Gs^Fmw, Ss, Gg^Dr, Chr, 2 Khr, Chr, Gs^Fet, Gs^Fdw, Rr, Gs, Re^Dr, Gll^Fmw, Ss, Gll^Fp, Gll^Fp, Re, Rr, Rr^Es, Re^Es, Gs, Ket, Ce, Gd^Es, Gs, Gd, Gd^Fdw, Re, Re, Wwf, Wwf^Es, Wwg^Es, Wwg, Wwg, Wwg, Wwg, Wwg, Wog, Wog, Wwg, Gd^Vhr, Gd, Gs, Gd
Wwg, Wwg, Wwg, Re, Wwg, Gs, Qxe, Re, Gd^Fdw, Gs^Fdw, Re, Gg, Wwg, Wwg, Re^Es, Wwg, Gs^Fdw, Wwg, Wwg, Chw, Gs, Gs^Fdw, Rr, Ss, Rr, Chr, Gs^Fdw, Chr, Rr, Rr, Gs, Re^Dr, Gll^Fdw, Gll^Fmw, Gll^Fmw, Gd^Fmw, Gll^Fp, Re^Es, Rd^Dr, Rr^Es, Rr, Gs, Gs, Ce, Ce, Gs, Gd^Fdw, Re, Re, Gs, Gd, Gs, Gs, Wwg, Re, Gs, Gs, Wwg, Wog, Wwg, Wwg, Gs, Gd^Fdw, Gs^Fdw
Re, Re, Rb^Dr, Wwg, Qxe, Qxe, Wwg, Wwg, Wwg, Gd, Wwg, Wwg, Gs^Es, Re^Es, Re^Dr, Gs^Es, Re, Rr, Rr, Wwg, Wwg^Bsb/, Rr, Gs^Fdw, Rr, Rp^Vhcr, Rr, Rr, Gs^Fdw, Rr, Rr, Rr, Gs^Fdw, Gs^Ve, Gll^Fmw, Gs^Fdw, Gd^Fmw, Gs, Re^Es, Rr, Rr, Rr, Gs^Vhr, Gll^Fp, Gll^Fp, Ce, Re, Re^Fdw, Gd^Fdw, Gs, Re, Re, Gs, Gs, Gs, Re, Re, Wwg, Wwg, Wwg, Wwg, Wwg, Gg, Gd^Fdw, Gs^Fdw
Re, Ce, Ce, Re, Re, Qxe, Re, Re, Gs, Wwg, Re, Gd, Re, Re^Es, Re, Rr, Ce, Gs^Fdw, Re, Rr, Ss, Wwg, Wwg, Chw, Gs^Fdw, Gs, Rr, Rr, Re^Dr, Chr, Gs, Rr, Rr, Gll^Fdw, Gs^Fet, Gs, Rr, Rr, Gd^Fmw, Gs, Gs, Rr, Re^Vhr, Re, Re^Edt, Re, Gs, Gs, Gs^Eff, Gs^Eff, Re^Eff, Re, Gs, Re, Re, Gs, Wwg, Wog, Wog, Wwg, Gg, Gs, Gd^Fdw, Gs^Fdw
Gs, Gs, 6 Ket, Gs, Re, Qxe, Re, Gs, Gs, Gd, Gd, Gs, Rr, Re, Gs^Es, Re, Ce, Gll^Fdw, Gll^Fmw, Re, Ss, Ss, Wwg, Gs, Gs^Fdw, Gs^Fmw, Rr, Rp^Vhcr, Gs^Fdw, Gll^Fdw, Gll^Fdw, Gs, Gs, Rr, Rr, Rr, Gs^Fetd, Gs^Fdw, Gd^Fmw, Gd^Fmw, Gll^Fp, Gll^Fp, Re^Fmw, Re^Edt, Re^Edt, Re^Es, Gs, Gs^Eff, Gs^Vh, Re, Re, Gs^Eff, Gs, Re, Gg, Wwg, Wog, Wog, Wog, Wwg, Gg, Gs^Fdw, Gd, Gd^Fdw
Gg, Gs, Gs, Ce, Gg, Gd, Gs, Re^Vct, Re, Gs, Rr, Re, Gs, Gs, Gd, Gs, Re^Dr, Gs^Fmw, Gll^Fdw, Gll^Fdw, Wwf, Wwg, Wwg, Gll^Fdw, Gll^Fmw, Gll^Fdw, Rr, Gs^Fmw, Gs^Fdw, Gll^Fmw, Gll^Fdw, Gs, Gs, Gs, Re, Gs, Gs, Gll^Fp, Gll^Fp, Gll^Fp, Gll^Fp, Gll^Fp, Ce, Re^Dr, Re^Edb, Re^Dr, Gd^Fmw, Gs, Rb, Rb^Gvs, Rb^Gvs, Re, Gs, Gs, Gg, Wwg, Wwg, Wog, Wog, Wwg, Wwg, Gs, Gs, Gg
Gg, Gs, Ce, Ce, Gs, Gs^Fdw, Rr, Re, Re^Dr, Rr, Gg, Re, Gs, Gd, Gd^Es, Re^Es, Re^Es, Gll^Fp, Gll^Fdw, Gll^Fp, Wwf^Es, Wwg, Wwg, Gll^Fp, Gs^Fet, Rr, Gs^Fetd, Gll^Fp, Gll^Fp, Gd^Fmw, Gll^Fmw, Gs^Fdw, Gll^Fdw, Gs^Fet, Re, Gs, Gs, Gs, Ket, Ce, Ce, Ce, Re^Dr, Re^Edb, Re^Fmw, Gll^Fp, Re, Re, Rb, Rb^Gvs, Re^Gvs, Re, Gs^Wm, Gg, Gg, Gg, Wwg, Wwg, Wwg, Wog, Wog, Wwg, Wwg, Wwg
Gs, Gs, Gs, Gs, Re, Rr, Gd^Fdw, Gs^Fdw, Gs, Re, Gs, Gs, Gs, Gs^Es, Gd^Dr, Re^Es, Gll^Fp, Gd^Fdw, Gd^Fmw, Wwf, Wwg, Wwg, Ss, Ss, Gs, Rr, Wwg, Gll^Fp, Gll^Fp, Gll^Fp, Gd^Fmw, Gd^Fmw, Gll^Fdw, Gd^Fmw, Gd^Fmw, Re, Rr, Ce, Gll^Fp, Re^Fdw, Re^Fp, Re^Fdw, Gd^Fmw, Re^Edb, Gd^Fmw, Re, Re^Es, Rb^Gvs, Rb^Gvs, Rb, Gs, Re, Gs, Gs, Re^Es, Gs, Gs, Wwg, Wwg, Wog, Wog, Wog, Wog, Wog
Rr, Rr, Rr, Re, Gs, Gd, Re^Edb, Gs^Fdw, Qxe, Re, Gs, Gd, Gll^Fp, Gll^Fp, Ce, Gll^Fp, Gd^Fmw, Gll^Fp, Gs, Wwf^Es, Wwf, Wwg, Wwg, Ss, Wwg^Es, Wwg^Bsb|, Wwg^Es, Wwg, Wwg, Wwf, Wwg, Wwg, Wwf, Gd^Fmw, Ket, Ce, Gs, Re, Gll^Fp, Gll^Fp, Re^Es, Re^Fdw, Gll^Fp, Gd^Fmw, Gs^Fdw, Gs^Fdw, Gs^Vhr, Rb^Gvs, Gs^Eff, Gs^Eff, Rb^Es, Re, Gs, Gd^Es, Re, Gg, Gs, Gg, Gd^Vhr, Wwg, Wwg, Wwg, Wwg, Wog
Gs, Gs, Gs, Gs, Ce, Ce, Re^Edb, Re, Qxe, Re, Re, Gd, Gd, Gll^Fp, Ce, Gll^Fp, Gs, Rr, Rr, Gs^Vhr, Gs, Wwg, Wwg, Wwg, Wwg^Es, Wwg^Es, Wwg, Wwg, Wog, Wwg, Wwg, Wwg, Wwg, Ce, Re^Es, Gll^Fp, Gs, Rr, Re^Es, Re, Gll, Gll^Fp, Gll^Fp, Gd^Fmw, Gs^Fdw, Gs, Gs, Gs^Eff, Gs, Rb, Gs, Gs, Re, Gs, Re, Gs, Gs, Re, Gs, Gg, Gs^Es, Wwg, Gg, Wwg
Gs, Gg, Hhd, Gs, Re, Re^Edb, Re^Edb, Qxe, Gs, Gs, Gs, Re, Gd, Gg, Gll^Fp, Ce, Ket, Gs, Gll^Fmw, Rr, Rr, Gs^Es, Gs^Es, Gs^Es, Gs^Vhr, Rrc, Wwf, Wwg, Wog, Wog, Wog, Wog, Wog, Re^Es, Re^Es, Re^Es, Gll^Fp, Re, Gs, Re^Dr, Chr, Gll^Fp, Re^Vhr, Gll^Fp, Gs, Gs, Gs, Gs, Re^Es, Re, Gs, Re, Re^Es, Qxe, Re, Gd^Es, Gs, Re^Es, Re, Gs, Gd^Es, Gg, Gg, Gg
Hhd, Gs, Hhd, Gs, Gg, Re^Edb, Gs, Gs, Gd^Vhr, Gg, Gg, Gs, Gg, Gs, Gd^Fdw, Gd^Dr, Re^Dr, Gs, Gd^Fmw, Gd^Fmw, Gll^Fp, Rr, Rr, Gs^Dr, Rrc, Rrc, Gs, Wwg, Wog, Wog, Wog, Wog, Ce, Ce, Gd^Fmw, Gll^Fp, Gll^Fp, Re, Rr, Re^Dr, Chr, Re^Es, Gll^Fp, Gll^Fp, Gs, Gs, Re, Re^Es, Re^Dr, Gs^Vhr, Re^Gvs, Re, Qxe, Qxe, Re, Rd^Es, Gs, Gs, Re, Gs, Gg, Gd^Es, Gs, Gg
Hhd, Hhd, Hhd, Hhd, Gs, Gs, Hh, Gs, Gs, Gg, Gs, Gs, Gll^Fp, Gs, Re^Fdw, Re, Qxe, Gd^Fdw, Gll^Fmw, Gd^Fmw, Gll^Fp, Gll^Fp, Gs, Rrc, Gs, Gs, Gs, Wwg, Wwg, Wog, Wog, Ket, Re^Es, Re, Gd^Fmw, Gll^Fp, Gd^Fmw, Gd^Fmw, Re^Es, Rr, Rr, Re, Re, Gll^Fp, Rb, Rb, Gs^Eff, Re, Re^Es, Re^Gvs, Re, Re^Es, Rb, Re^Es, Re, Gs, Re, Re, Chr, Re, Re, Gd^Vhr, Gs, Gg
Gs, Hhd, Hhd, Hhd, Gs, Gs, Hh, Hh, Gll^Fp, Gg, Gs, Gll^Fp, Gd^Fdw, Gd^Fdw, Re, Qxe, Qxe, Gd^Fdw, Re, Ce, Ce, Ce, Gs, Rr, Ce, Ce, Ket, Ce, Re^Dr, Wwg, Ce, Ce, Re^Es, Gd, Gll, Gll^Fp, Gd, Gd^Fmw, Re, Gd, Gs, Re^Es, Rr, Re, Gs, Gs^Eff, Re^Gvs, Re^Edt, Rb^Edt, Re, Qxe, Rb, Re^Es, Re^Es, Gs, Gg, Ce, Re, Rb, Rb^Dr, Ce, Gs, Re, Gg
Gs, Hhd, Gs, Gs, Gll^Fp, Gll^Fp, Gg, Gll^Fp, Gll^Fp, Gs, Gll^Fp, Gd^Fp, Gd^Fdw, Gd^Fmw, Qxe, Qxe, Qxe, Re, Gd, Gd, Gs, Gd^Fmw, Rr, Rr, Gs, Gs, Gll^Fp, Re^Es, Re^Edt, Re^Dr, Re^Edt, Gll^Fp, Gd^Fmw, Gd^Fmw, Gll, Gd, Gll^Fp, Gd, Gs, Re, Gs, Re^Edt, Re^Es, Rr, Rr, Gs^Eff, Gs^Eff, Re, Re^Edt, Rb^Es, Qxe, Qxe, Re, Re, Gs, Ce, Re, Chr, 4 Khr, Re, Gg, Ce, Gs, Gg
Gs, Gs, Hh, Gs, Gll^Fp, Gll^Fp, Gll^Fp, Gll^Fp, Hh, Gll^Fp, Gll^Fp, Gll^Fp, Gd^Fmw, Re, Re, Qxe, Re, Re, Gll, Gll^Fp, Gll^Fp, Rr, Gs, Gll^Fp, Gll^Fmw, Gll^Fmw, Gll^Fp, Re, Gll^Fp, Re^Edt, Re, Re, Gd^Fmw, Gll^Fp, Gd^Fmw, Gll, Gll^Fp, Gll^Fmw, Gll^Fdw, Gll, Gll^Fp, Re^Edt, Gs, Rr, Chr, Rr, Gd, Gs, Re^Edb, Rb^Edb, Rb^Es, Qxe, Re, Re^Gvs, Re, Ce, Re^Es, Rb^Dr, Chr, Chr, Gg, Gg, Gs, Gs
Hh, Gs, Hh, Gs, Gll^Fp, Gll^Fp, Hh^Fp, Hh^Fp, Hh, Gll^Fp, Gll^Fp, Gs, Gll^Fmw, Gd^Fp, Gd^Fmw, Re^Fdw, Re^Fdw, Gll^Fdw, Gll, Gll^Fp, Gll^Fp, Rr, Gs, Gs, Gs, Gll^Fmw, Gd^Fdw, Gll^Fdw, Gd^Fdw, Re, Re, Gd^Fmw, Gll^Fdw, Gd^Fdw, Gd^Fdw, Gll^Em, Gd^Fdw, Gll^Fmw, Gll^Fdw, Gll^Fp, Gd^Fmw, Re, Gs, Gs, Re, Rr, Rr, Gs, Gs, Rb^Edb, Rb^Edt, Re, Re^Es, Re^Gvs, Re^Edt, Re^Es, Rb, Rb, Rr^Es, Rr, Gs, Gs, Gg, Gs
Hh, Hh, Mm, Hh, Gs, Gll^Fp, Gs, Hh^Fp, Gll, Gll^Fp, Gs, Gs, Gll^Fp, Gd^Fmw, Gll^Fdw, Gll^Fdw, Gll^Fdw, Gll^Fdw, Gll^Fp, Gd, Gll^Fp, Rr, Rr, Gs^Ve, Gll^Fp, Gll^Fdw, Qxe, Re, Qxe, Re, Qxe, Qxe, Qxe, Re, Gd^Fdw, Gll^Fmw, Gll^Fdw, Gll^Fp, Gd^Fmw, Gd^Fmw, Gs^Em, Gs, Gs, Gs^Vhr, Re, Re, Re, Rr, Rr, Re^Edb, Re, Re^Es, Re, Re^Edt, Gs^Edt, Re^Dr, Chr, Re, Re^Es, Gs, Ce, Ce, Gs, Gs
Mm, Mm, Mm, Hh, Gll^Fp, Gll, Gs, Gll, Gg, Gd^Fmw, Gg, Gs, Gll^Fp, Gd^Fmw, Gd^Fmw, Hh, Hh, Gll^Fp, Hh, Gll^Fp, Gll^Fmw, Gll^Fmw, Rr, Gll^Fp, Gd^Fmw, Gll^Fdw, Re, Qxe, Qxe, Qxe, Qxe, Qxe, Re, Re, Gll^Fmw, Gll^Fmw, Gs^Em, Re^Vl, Re, Gll^Fp, Re, Gs, Re^Es, Re, Qxe, Qxe, Re^Es, Re, Gs, Re^Edt, Rr, Gs, Re^Eff, Re^Vhr, Gd, Re^Es, Re, Gs, Re, Gs, Re, Gg, Gs, Gg
Mm, Mm, Hh, Hh, Gll^Fp, Hh^Fp, Gs, Gs, Gd^Fmw, Gd^Fmw, Gd^Fmw, Gd^Fmw, Gd^Fmw, Gd^Fmw, Gll^Fp, Hh, Hh, Hh, Hh, Gll^Fp, Gll^Fmw, Gll^Fp, Rr, Gll^Fp, Gll^Fmw, Gd^Fdw, Re^Fdw, Re, Qxe, Qxe, Qxe, Qxe, Re, Gd^Fmw, Gll^Fdw, Gd^Fdw, Re, Re, Gs, Re, Re, Gs, Re, Re^Es, Qxe, Re^Es, Re^Edt, Re^Gvs, Gs, Gs, Gs, Re, Re^Es, Re^Eff, Gg, Gs, Gs, Gs, Rr, Re^Dr, Gd^Vhr, Gs, Gs, Gg
Mm, Mm, Hh, Hh, Gg, Gs, Gll^Fp, Gg, Hh, Gll^Fdw, Gll^Fmw, Hh, Hh, Gll^Fp, Gs, Gs, Gs, Gll^Fp, Gll^Fp, Gll^Fp, Rr, Rr, Gg, Gs, Gd, Gll^Fmw, Re^Fmw, Re, Re, Re, Qxe, Qxe, Qxe, Re, Re^Fdw, Gd, Re, Gs, Gll^Fdw, Gs, Gs, Gs, Re^Edt, Re^Es, Qxe, Re^Es, Re^Edt, Gs, Gs, Re, Re, Gg, Gs, Re, Re, Gs, Rp, Rr, Re, Re^Es, Gd, Re, Gg, Gg
Mm, Hh, Hh, Hh, Gg, Gll^Fp, Hh, Hh^Fp, Hh^Fp, Gll^Fp, Gd^Fmw, Gll, Hh, Gs, Gs, Gd, Gg, Gll^Fp, Rr, Rr, Gll^Fp, Gg, Gll^Fmw, Gs, Gll^Fp, Re^Fp, Gll^Fmw, Gll^Fdw, Re^Fmw, Re, Re, Qxe, Re^Fdw, Qxe, Re^Fdw, Re^Fdw, Re^Fmw, Gll^Fmw, Gs, Gd, Gs, Re, Qxe, Qxe, Gd, Re^Edt, Gs, Gs, Re, Gd, Re, Ce, Gs, Re^Es, Re, Rr, Rp, Gs, Gd, Re, Gs^Es, Gs, Gg, Gs
Mm, Hh, Hh, Hh, Hh, Hh, Hh, Hh^Fp, Hh^Fp, Gll^Fp, Gll^Fp, Gll^Fp, Gg, Gg, Gs, Gg, Rr, Rr, Gs, Gll^Fp, Gll^Fp, Gll^Fmw, Gll^Fmw, Gll^Fmw, Gs, Gll^Fp, Gll^Fmw, Re^Fmw, Gll, Re, Re, Qxe, Qxe, Re, Re, Re, Gll^Fmw, Gll^Fp, Gd, Re, Re, Re^Edb, Re^Edb, Re, Gs, Re^Es, Re, Re^Es, Re^Dr, Re^Es, Re, Ce, Ce, Gs, Re, Re, Rr, Gs, Re, Gs^Es, Gs, Gg, Gs, Gg
Hh, Hh, Hh, Hh, Hh, Hh, Hh, Hh^Fp, Gll^Fp, Hh, Gg, Gg, Gg, Gg, Gg, Rr, Gg, Gs, Gll^Fp, Gll^Fp, Gll^Fp, Gll^Fmw, Gg, Gll^Fp, Gg, Gll^Fp, Gll^Fmw, Gll^Fp, Gll, Gll, Re^Fmw, Re^Fdw, Gll^Fdw, Gll^Fdw, Gd, Gs, Gg, Gd, Gg, Re, Gd, Re^Edb, Rb^Edb, Re, Rb, Re, Re, Re, Re^Es, Re, Gg, Gg, Gg, Gg, Gs, Re, Gg, Rr, Rp, Gg, Gs, Gd, Gg, Gs
