Ww, Ww, Ww, Wwf, Ww, Ww, Ww, Ww, Wwf, Wwf, Wwf, Wwf, Ww, Ww, Ww, Ds, Hhd, Ds, Ww, Wo, Ww, Ww, Ww, Ww, Ww, Ds, Ds, Hh, Ds, Wwf, Ww, Ww, Ds, Ds, Hh, Ww, Ww, Ds, Hh, Hh, Hh, Hh, Hh^Fms, Hh^Fds, Hh, Hh, Hh, Gs^Fms, Gll^Fp, Gll^Fp, Gs^Fds, Hh
Ds, Ww, Wwr, Wwf, Wwr, Ww, Ds, Ww, Ww, Wwf, Wwr, Wwf, Ww, Ww, Ww, Wwf, Wwf, Ds, Ww, Ww, Ww, Wwf, Wwf, Ww, Wwf, Wwr, Wwr, Ds, Wwr, Ww, Hhd^Fmw, Ww, Wwr, Ds, Wwf, Chw, Wwr, Ds, Hh, Hh, Hh, Hh^Fms, Hh, Gg, Gs, Hh, Hh^Fp, Gs^Fms, Hh^Fp, Gs^Fms, Gs^Fds, Gll^Fp
Ds, Ww, Ww, Ww, Wwf, Ds, Wwr, Ww, Ww, Ww, Wwf, Ww, Wwf, Chw, Wwf, Ds, Ds, Wwr, Wwf, Ds, Wwr, Wwf, Ww, Ww, Ww, Ww, Hhd, Ww, Ww, Ww, Hhd^Fmw, Hhd, Ww, Ww, Chw, Chw, Ds, Hh, Hh, Gg, Hh^Fds, Hh^Fms, Gg^Efm, Gs, Gll^Fp, Hh, Gll^Fp, Hh^Fms, Gll^Fp, Gs^Fds, Gll^Fp, Gs^Fms
Ww, Wwf, Ww, Wwf, Hhd, Ds, Wwr, Ww, Wwr, Ww, Ww, Ww, Hhd^Vhhr, Wwf, Ds, Ds, Wwf, Ww, Wwr, Ds, Ds, Ww, Ww, Ww, Ds, Ww, Chw, Hhd^Fmw, Ww, Ds, Ds, Hhd^Fmw, Hh, Ww, Ww, Wwf^Es, Wwf, Ds^Esd, Gs, Gg, Hh, Hh^Fms, Gg^Efm, Gs, Gs^Fms, Gll^Fp, Gs, Gs, Gll^Fp, Gs^Fms, Gll, Gs^Fms
Wwr, Ww, Ds, Wwf, Wwf, Wwr, Ww, Wwf, Ds, Ww, Ww, Wwf, Ds, Wwf, Ww, Wwr, Ww, Ww, Ww, Wwr, Ww, Ww, Wwr, Hhd, Ds, Ww, Ww, Hhd^Fmw, Ds^Es, Wwr, Ds, Hhd, Hh^Fmw, Wwr, Hh^Fp, Ds, Wwr, Ds, Ds, Hh^Fms, Gg, Gg, Gg, Gg^Efm, Gg, Gll^Fp, Gs, Gll^Fp, Gll^Fms, Gll^Fms, Gs, Gs^Fms
Ww, Ds, Ds, Wwr, Ww, Ww, Ww, Wwf, Wwr, Wwr, Ww, Wwf, Wwf, Wwr, Wwr, Ww, Wwr, Wwr, Ww, Ww, Wwr, Hhd, Hhd, Ds, Wwr, Wwr, Ww^Es, Hhd^Vhhr, Hhd, Wwr, Ww, Ds, Wwf, Wwr, Hh, Hh^Fp, Ds, Wwr, Ds, Hh, Gg, Gg^Efm, Gg, Gd^Vhr, Re, Gg, Gs, Gll^Fp, Gll^Fp, Gs, Gg, Gg
Ww, Wwf, Ds, Ww, Wwr, Ds, Ds, Ww, Ww, Ww, Wwr, Ww, Wwf^Es, Wwr, Chw, Ww, Wwr, Ww, Wwr, Ww, Ww, Ds, Ds, Ds, Ww, Ww, Chw, Wwr, Ds^Es, Ds, Ww, Ww, Wwf^Ewl, Ds, Gs^Fms, Gll^Fp, Gs, Wwf, Wwf^Ewl, Gs^Esd, Gs, Gs, Gs, Gs, Re, Gs, Gg^Fet, Gs, Gg, Gg, Re, Re
Wwf, Wwr, Wwr, Ww, Wwr, Md, Md, Wwr, Ww, Wwf, Ww, Wwr, Chw, Khw, Wwr, Wwf, Ww, Ww, Chw, Khw, Wwr, Ww, Ww, Ww, Ww, Chw, Ww, Wwr, Ds, Hh, Hh^Fp, Ww, Hh^Fds, Ds, Gs^Fms, Gll^Fp, Gs^Fds, Gg, Gg, Gs^Vhr, Rd, Gg, Ce, Re, Ce, Gs, Gg, Gg^Efm, Re, Gg^Es, Re, Gg
Ds, Ds, Ww, Ww, Wwf, Hhd, Wwf, Ww, Wwf, Wwf, Ww, Wwr, Chw, Ww, Ds, Wwf, Wwf, Ww, Ww, Wwr, Ds, Wwf, Ww, Chw, Wwf, Wwf, Ww, Wwr, Ww, Hh, Ds, Hh^Fp, Gs^Fds, Gs^Fds, Gs^Fms, Gs^Fms, Gs^Fds, Gs, Rd, Gg, Gg, Gs, Re, Ce, 1 Ket, Re, Re, Re, Gg, Re, Gg, Gs
Ds, Wwr, Ww, Ww, Hhd, Hhd, Wwr, Ww, Ww, Ww, Wwr, Ww, Ww, Wwf, Ds, Ds^Es, Ch^Edt, Ds, Ds, Wwr, Chr, Ds^Es, Ww, Ww, Ww, Ww, Wwf^Es, Chw, Wwf^Ewl, Wwf, Hh, Ds, Hh^Fp, Gll^Fp, Gs^Fms, Gs^Fds, Gs, Gs, Re, Re, Re, Re, Re, Re, Ce, Ce, Gg, Gg^Fet, Gll^Fp, Gg, Hh, Gg
Wwf, Ww, Wwf, Wwr, Ww, Wwf, Wwr, Ww, Ww, Ww, Khw, Wwr, Ww, Ww, Chr^Edt, Ch, Gs, Gs, Rp^Vhcr, Gs^Edt, Ds, Chr, Wwf^Es, Ww, Ww, Ww^Ewl, Wwf^Ewf, Ds, Hh, Hh, Hh, Hh^Fp, Gs^Fms, Gs^Fds, Gll^Fp, Gg, Gg, Gg, Re, Gg, Gs, Gs, Gs, Gg, Gg, Re, Gg^Fet, Gll^Fp, Gll^Fp, Gs, Hh^Fp, Hh
Wwr, Ww, Wwr, Wwr, Ww, Wwr, Ww, Chw, Wwf, Ww, Ww, Chw, Wwf, Ds^Es, Ds^Edt, Gs, Gs^Edt, Gg, Rr, Gs^Esd, Gg, Ch^Edt, Ds^Esd, Wwr, Ce^Edt, Ww^Ewl, Ds, Ds^Esd, Gs, Hh, Gg, Gg, Gll^Fp, Gg^Efm, Gg, Re, Re, Re, Gg, Gg, Hh, Hh, Hh^Fms, Gll^Fp, Gg, Re, Re, Gd^Ve, Gll^Fp, Gll^Fp, Hh^Fp, Hh^Fp
Ww, Ww, Ww, Wwf, Wwr, Ww, Ww, Ww, Wwr, Ww, Ww, Wwr, Chr, Ds^Esd, Gs^Esd, Rp^Vhcr, Rr, Gg, 2 Kh, Chr, Gg, Gs, Gg^Esd, Ds, Ce, Ds, Hh, Gs, Gs, Gg, Gll^Fp, Gg, Gg, Gg^Efm, Re, Re, Gll^Fp, Re, Gg, Gg, Gs, Hh^Fp, Hh^Fms, Gll^Fp, Hh, Gg, Gll^Fp, Gll^Fp, Hh^Fp, Gll^Fp, Hh^Fms, Hh
Ww, Wwr, Ww, Wwr, Ww, Ww, Wwr, Wwf, Wwf, Ww, Wwr, Wwf^Es, Wwf^Es, Chr^Edt, Chr, Gs, Ch, Ch, Chr, Ch, Rr, Gs, Rp^Vhcr, Gg, Gg, Gs, Hh, Hh, Gg, Gll^Fp, Gll^Fp, Hh, Gg, Gg, Re, Re, Gll^Fp, Gs^Fms, Gg, Gs, Gs, Hh^Fms, Hh, Hh, Hh, Gg, Gs, Gll^Fp, Hh, Gll^Fp, Gg, Hh
Wwr, Wwr, Wwf, Wwf, Wwr, Wwf, Wwf, Ww, Wwf, Wwr, Chw, Wwf, Ww, Ww, Ds, Gs, Gg, Gs^Edt, Rr^Edt, Gg, Gs^Edt, Rr, Rr^Edt, Re, Re, Gg, Gg, Gg, Gll, Gll^Fp, Hh, Hh, Gll^Fp, Gg^Efm, Gg, Rp, Gg, Gg, Gll^Fp, Gll^Fp, Gg, Hh, Hh^Fms, Hh^Fp, Gs, Gg, Re, Gg, Gg, Gg, Chr, Hh
Ww, Ds, Wwf, Wwr, Hhd, Hhd, Wwf, Wwr, Ww, Ww, Wwr, Chr, Ds^Es, Ce, Ce^Edt, Ds^Esd, Gs, Rp^Vhcr, Gs^Edt, Gs, Ce, Gs, Rp, Gg^Fet, Gg^Efm, Rp, Rp, Gg, Gg, Gg, Hh, Hh, Gs^Fet, Ket, Re, Re, Gg^Efm, Gg^Efm, Gs^Fds, Gs^Fms, Gg, Gg, Gg, Hh^Fms, Gs^Edt, Gs, Gs^Fds, Gg^Efm, Gg, Hh^Fms, Hh, Hh
Ww, Ds, Ds, Ww, Ds, Md, Wwf, Ww, Wwf, Hh, Wwf, Ww, Ds^Es, Ds, Gs, Ce, Ce, Gg, Ce, Ce, Gs, Gs^Edt, Gg, Re, Gg, Gg, Re, Re, Gg, Gg, Gg, Gg, Gg^Es, Gg^Vc, Re, Gg, Gg^Efm, Gg, Gs^Fms, Gll, Gg, Gg, Gs, Gs, Gs, Gll^Fp, Gs^Fms, Gs, Gg, Hh^Fp, Hh^Fp, Mm
Ww, Wwf, Wwr, Ww, Ww, Wwf, Hhd, Ds, Wwf, Hh, Hh, Ds, Ds, Wwf, Gs, Gs, Gs, Ce^Edt, Gg, Gg, Gg, Gg, Re, Re, Gll^Fp, Gg^Efm, Re, Re, Re, Gg^Efm, Gg, Gg, Rp, Rp, Gg, Gg, Gg, Gll^Fp, Gll^Fp, Ss, Ss, Gll^Fp, Gs^Fds, Gll^Fp, Gg, Gll^Fp, Gs, Re, Re^Edt, Gg, Gg, Hh
Wwf, Ww, Ww, Wwf, Wwf, Ds, Wwr, Wwr, Wwf, Ds, Ww, Wwr, Ww^Ewl, Ds^Esd, Rd^Esd, Gll^Fp, Gs^Fms, Gs, Gll^Fp, Gll^Fp, Gg, Rp, Gg, Gg, Gs^Fms, Gll^Fp, Gg^Em, Re, Gg, Rp, Re, Re, Gg^Efm, Gg, Hh, Gg, Gg, Gs, Ss, Ss, Ss, Ss, Gs^Fds, Gs^Fms, Gg, Gg, Chr, Gs^Edt, Re^Edt, Gs^Vhr, Gs^Edt, Hh
Wwf, Wwf, Wwr^Ewf, Ww, Wwf, Ww, Ds, Wwf^Ewl, Wwf, Ds, Wwf, Wwf^Ewl, Ds, Ds, Gs^Edt, Gll^Fp, Gs^Fds, Gs^Fds, Gs^Fms, Gs^Fds, Gs, Re, Gg^Vc, Gs^Fms, Gs^Fds, Gll^Fp, Gg, Gg, Gg, Gg, Gg, Gg^Efm, Gg, Gg, Gg, Hh, Gg, Gg, Chs, Ss, Ss, Gll^Fp, Ss, Gll, Gg, Hh, Chr, Gs^Dr, Chr, Gg, Hh, Gs
Ds, Wwr^Ewl, Wwr^Ewl, Wwf^Ewf, Gll^Fp, Ds, Rd^Esd, Gs^Esd, Gs, Gs, Wwf, Ds, Rd, Gs^Vc, Rd, Gs, Gs^Fds, Gs^Fms, Gll, Gll^Fp, Gg, Re, Gg, Gll^Fp, Gs^Fds, Gg^Efm, Gg, Gll^Fp, Gg, Hh, Hh, Gg, Hh, Hh, Gg, Hh, Gg, Gs^Fms, Gs^Fms, Ss, Ss, Ss, Gll, Gll^Fp, Hh^Fp, Hh, Hh^Fp, Gg, Gg, Gg, Hh, Hh
Ds^Esd, Ds, Ds, Wwr, Gll^Fp, Gll^Fp, Rd, Gs, Gs, Rd, Gll^Fp, Wwf, Gs, Gg, Gg, Gs^Fds, Gs^Fds, Gg, Gg, Gg, Rd, Re, Gg, Gll^Fp, Gg, Gg, Gll^Fp, Gll, Gg, Gg, Hh, Hh, Gg, Hh^Fds, Gs, Hh, Hh^Fds, Gs^Fds, Gs^Fms, Ss^Emf, Ss^Vhs, Gll^Fp, Gll, Gll^Fp, Gll^Fp, Hh, Hh^Fms, Hh, Hh, Hh, Mm, Mm
Gs, Gs^Esd, Gs, Wwf, Hh, Gs, Gs, Rd, Gs, Gg, Hh, Gg, Hh, Hh, Gg, Gs^Fds, Gg, Gg, Gs, Re, Rd, Gg^Es, Gg, Gg, Gg, Gll^Fp, Gs^Fms, Hh, Gs, Gg, Hh, Hh, Gs, Gs^Edt, Khr, Gs^Edt, Gs^Fet, Gs, Gs^Edt, Gs^Fms, Gs, Gll^Fp, Gll^Fp, Gll^Fp, Gll^Fp, Gg, Hh, Hh, Mm^Xm, Hh, Mm, Mm
Hh, Gg, Gg, Hh^Fp, Hh, Gg, Gll^Fp, Gll^Fp, Gll^Fp, Gll, Hh, Gg, Gg, Gg, Gs, Gs, Re, Gg, Gs, Gg, Re, Re, Re, Gs, Gg, Gg, Gll^Fp, Gs^Fds, Gg, Gg, Hh, Hh^Fms, Hh^Fms, Chr, Re^Edt, Re^Dr, Re^Edt, Gs^Edt, Gs^Edt, Gg^Edt, Gll, Gll^Fp, Gll^Fp, Gll^Fp, Gll, Gg, Hh, Mm, Mm, Mm, Mm, Hh
Hh^Fp, Hh^Fp, Gg, Hh^Fp, Hh, Gs, Gll^Fp, Gll^Fp, Gll, Gll, Gll^Fp, Gg, Gg, Re, Gg, Gs, Re, Re, Re, Gs, Gg, Re, Re, Ket, Gs^Vc, Gg, Gs, Gs^Fms, Gll, Hh^Fms, Gll^Fp, Hh^Fp, Hh^Fms, Chr, Gs^Es, Gs^Es, Gs^Edt, Gg, Hh^Fds, Gs, Hh, Gg, Gg, Gll^Fp, Gg, Hh, Gg, Hh, Gg, Mm, Mm, Mm
Hh^Fp, Gg, Gg, Gll^Fp, Gg, Gs, Gg, Gg, Hh, Gll^Fp, Gs, Gg, Gs^Vc, Gs, Gg, Re, Gs, Gg, Gs^Fds, Re, Gg^Es, Gg, Re, Gg^Fet, Gs^Edt, Gg, Gll^Fp, Gg, Gs^Fms, Gs^Fms, Gll^Fp, Hh^Fp, Hh, Gs^Edt, Gg, Gs^Edt, Gs, Gs, Hh, Hh, Mm, Gg, Hh, Gg, Hh, Hh, Gs, Gg, Hh, Hh^Fp, Hh^Fp, Mm
Gg, Gll^Fp, Gll^Fp, Gll, Hh^Fp, Gg, Gg, Chr, Chr, Gll^Fp, Gs, Gg, Gg, Gg, Gg^Efm, Rd, Rd, Gs^Fms, Gs^Fds, Re, Re, Re, Gg, Gg, Gll, Gg, Gg, Gll^Fp, Gs^Fms, Gs^Fds, Gll^Fp, Gs, Gg, Gs, Gs, Hh, Gs, Hh, Mm, Mm, Hh, Hh, Gs^Fds, Hh^Fms, Gs^Fms, Gg, Gs, Gg, Hh, Hh^Fp, Hh^Fms, Mm
Hh, Gll^Fp, Hh^Fp, Gll^Fp, Gs^Fds, Gs^Fds, Hh^Fds, Gs, Gs, Gg, Gs^Fms, Gg, Gs, Gg^Efm, Gg, Gs, Gs, Re, Gs^Fms, Gg, Gll^Fds, Gll^Fms, Re, Gg, Gll^Fp, Gg, Gll^Fp, Gll^Fp, Gg, Gll^Fp, Hh^Fp, Hh, Hh, Gs, Hh, Hh, Hh, Hh, Mm, Mm, Hh, Hh, Gll, Gs^Fds, Gs^Fms, Gg, Hh, Gs, Gs, Gs, Hh, Hh
Hh, Hh^Fp, Hh^Fp, Gs^Fms, Gs^Fds, Gs, Gs, Gg, Gg, Gll^Fp, Gs^Fms, Gll, Gg, Gg, Gg, Ket, Re, Re, Gg, Gg, Gll^Fms, Gll^Fms, Gg, Gll^Fp, Gll^Fms, Gg, Gg, Hh^Fp, Gg, Hh, Hh, Hh, Mm, Mm, Gg, Gg, Hh, Mm, Hh, Gs, Gs, Hh, Gg, Gll^Fp, Gs, Gg, Hh, Gg, Gs, Gs^Efm, Gg, Hh^Fms
Gll^Fp, Hh^Fp, Hh, Gs^Fms, Gs^Fds, Gll^Fp, Gg, Chr, Gg, Gll^Fp, Gs^Fds, Gs^Fds, Gg, Gg, Gg, Re, Re^Edt, Gs^Edt, Re^Edt, Re, Gg, Re, Gg, Gll^Fms, Gll^Fp, Gll^Fp, Gg, Hh^Fp, Hh^Fds, Gg, Hh, Mm, Mm, Hh, Gg, Gg, Hh, Gg, Gg, Gs, Gg, Gg, Co, Gs, Re^Edt, Gg, Gg, Hh, Gs, Gs, Hh, Hh
Gll^Fp, Hh, Gll^Fp, Gll^Fp, Gs^Fds, Gs^Fms, Gs^Fds, Gll^Fp, Gs^Fms, Gll, Gs^Fms, Gs^Fms, Gll^Fp, Gs^Fds, Gg, Re, Gg, Gg^Vc, Gll^Fp, Re, Gg, Gg, Gll, Gll^Fms, Gll^Fp, Gll, Gg, Hh, Hh, Hh, Mm, Mm^Xm, Mm, Hh, Hh, Gg, Gg, Hh, Gg, Gg, Gs, Co^Edt, Gg, Gs^Edt, Rb^Edt, Gg, Co^Edt, Gg, Gs, Gs, Hh, Gg
Gll^Fp, Gll^Fp, Gll^Fp, Gg^Fet, Gs^Fms, Gs^Fds, Gs^Fds, Gll^Fp, Gll^Fp, Gs^Fds, Gs^Fms, Gs^Fms, Gll^Fp, Gs^Fms, Gg, Re, Gg, Gll^Fp, Gll^Fms, Gg, Gg, Gll^Fp, Gll^Fp, Gll^Fp, Gll^Fp, Gll^Fp, Gll^Fp, Gg, Hh^Vhh, Hh, Mm, Mm, Mm, Hh, Chr, Gg, Gg^Efm, Gg, Co, Gs, Re^Vct, Gg, Gs, Rb, Co, Gg, Gg, Co, Gll^Fp, Gg, Gs, Gs
Ww, Gll^Fp, Gll^Fp, Gs^Fms, Gll^Fp, Gg, Gg, Gg, Gll^Fp, Gll^Fp, Gs^Fds, Gll^Es, Gg, Gg, Re, Re, Gg, Gll^Fp, Gll^Fp, Gll, Gll^Fp, Gll^Fp, Gll^Fms, Gll^Fp, Gll^Fp, Gll^Fp, Gll^Fms, Gll^Fp, Gg, Hh, Hh, Mm, Mm, Hh, Hh, Gg, Gll^Fp, Gg, Co, Gg, Gg, Rb^Edt, Co, Rb, Rb, Rb^Edt, Gg, Gg, Gll^Fp, Gll^Fp, Gs^Fet, Gll^Fp
Ww, Gll^Fp, Gll^Fp, Gll^Fp, Gg, Gg, Cer, Cer^Edt, Cer^Edt, Gs^Fms, Gg, Gs, Ket, Gg, Re, Re, Gg, Gll^Fp, Gs, Gll, Gs, Gll^Fp, Gll^Fp, Gll^Fp, Gll^Fms, Gll^Fds, Gll^Fds, Gll^Fp, Hh, Hh, Hh, Hh, Mm, Mm, Hh, Hh^Fp, Gll^Fp, Gll^Fp, Gg, Gg^Efm, Gg, Rb, Co^Edt, 4 Ko, Co^Edt, Rb^Edt, Rb^Edt, Gll^Fp, Gs, Gll^Fp, Gll^Em, Gll^Fp
Ww, Gg, Gg, Gg, Cer^Edt, Cer, Gg, Gs, Gll^Fp, Cer, Gg, Gs, Re, Re, Cer, Gs, Gg, Gg, Gg, Gg, Gs, Gg, Gll, Gll^Em, Gll^Fp, Gll^Em, Gll^Fms, Gg, Gll^Fp, Gll^Fp, Gll^Fp, Hh, Hh, Mm, Hh, Hh^Fp, Gll^Fp, Gll^Fp, Gg, Re^Edt, Rb, Rb^Edt, Rb, Co^Edt, Rb, Rb, Rb, Rb^Vct, Gg, Gll^Fp, Gll^Fp, Gll^Fp
Ww, Wwf, Cer, Cer^Edt, Gs, Gg, Gg, Gll^Fp, Gll^Fp, Cer^Edt, Cer, Gg, Rd^Edt, Gg, Gll^Fp, Cer, Cer^Edt, Gg, Re^Edt, Re, Gg, Gs, Gll^Fp, Gll, Gg, Gll^Em, Gll^Fp, Gll^Fp, Gll^Fp, Gll^Fms, Gll^Fp, Hh, Hh, Hh, Gs, Gll^Fp, Re, Gs, Rb, Rb, Gg, Rb^Vct, Gs, Co^Edt, Gs, Gg, Gg^Edt, Gg, Gs, Gll^Es, Gll^Fms, Gll^Fms
Ww, Ww, Wwr, Gs, Gg, Gll^Fp, Gll^Fp, Gs^Vh, Gs^Edt, Gg, Gg, Rd^Edt, Rd, Gg, Gll^Fp, Gll^Fp, Re^Edt, Gg, Re, Re, Rd, Gs, Gg, Gg^Efm, Gll^Fp, Gll^Fp, Gg, Gll, Gg, Gll^Fp, Gs^Vc, Gll^Fp, Gg, Gg, Gg, Re^Es, Re, Re, Gll^Fp, Co, Co^Edt, Gg, Gs, Gg, Gs, Gg, Co, Co, Gll^Fp, Gll^Fp, Gll^Fp, Gll^Fms
Cer, Ww, Ww, Ww^Ewl, Ket, Gll^Fp, Gll^Fp, Re^Edt, Re^Edt, Re, Ch, Ch, Ch, Re, Re, Re^Edt, Re^Edt, Re, Rd, Ket, Gg, Rd^Edt, Gg, Gg, Gg, Gg, Re, Re, Gg, Gg, Gg, Gg, Re, Re, Gg, Re, Gg, Gg, Gll^Fp, Gll^Fp, Gll^Fp, Gll^Fp, Gg, Gg, Gll^Fp, Gs, Gs, Gll^Fp, Gll^Fp, Hh, Hh, Gll^Fp
Gll^Fp, Gs, Wwf^Ewl, Ww, Ww, Ww, Ww, Gs^Edt, Re, Gg, Chr, 3 Kh, Ch, Rd, Gs, Re^Es, Gg, Cer, Gs^Edt, Gs^Edt, Gg, Re, Gg, Re, Re, Gg, Re, Re, Re, Re, Gg, Re, Gg, Re, Gg, Gg^Efm, Gg, Gll, Gll^Fp, Gll^Fp, Gll^Fp, Gll^Fp, Gll, Gll^Fp, Gll^Fms, Gll^Fp, Gll^Fp, Gll, Hh, Hh, Hh, Gll^Fp
Gll^Fp, Gg, Gg, Gg, Gll^Fp, Gs, Wwf^Ewl, Ww, Gg, Gs, Rd, Ch, Rd, Rd, Gs^Vh, Gg^Edt, Gg, Cer^Edt, Gg, Gs^Edt, Gg, Gll^Fp, Gs^Fms, Re, Gg, Re, Re, Gg, Re, Gs, Gg, Gg, Hh, Gg, Gg, Gll^Fp, Gll^Fp, Gg, Gll, Gs, Gll^Em, Gll^Fp, Gll^Fp, Gs^Fds, Gll^Fp, Gll, Gg, Gll^Fp, Hh, Hh^Fp, Gll^Fms, Gll^Fms
Gll^Fp, Gll^Fp, Gs, Gll^Fp, Gll^Fp, Gs, Gg^Edt, Ww, Wwf^Ewl, Re^Edt, Re, Gg, Re^Vct, Re, Gg^Edt, Gll^Fp, Cer^Edt, Cer, Gs^Fms, Gg, Gs, Gs^Fms, Gs^Fds, Gg, Gg^Efm, Gg^Efm, Gg, Gg, Gg, Gs, Gg, Hh, Gg, Gg, Gll^Fp, Gs, Gll^Fp, Gg, Gll^Fp, Gll, Gll^Fp, Gll^Fms, Gll^Fms, Gs^Fds, Hh, Hh, Mm^Xm, Hh, Hh, Gll^Fp, Gs^Fds, Gs^Fds
Gll^Fp, Gll^Fp, Gg, Gg, Gll^Fp, Gg, Gg^Edt, Re^Vct, Re^Edt, Wwf^Ewl, Ww, Gg^Edt, Gg, Gg, Gs, Cer, Gll^Fp, Gs^Fms, Gs^Fms, Gll^Fp, Gs^Fms, Gs^Fds, Gs^Fds, Gs^Fms, Gs, Gg, Gll^Fp, Gll^Fp, Gg, Gg, Hh, Hh, Gg, Gll, Gll^Fp, Gs, Gll^Fp, Gll^Fp, Gll^Fp, Gll^Fp, Gll^Fms, Gll^Fms, Hh^Fms, Hh, Hh, Mm, Mm, Mm, Hh^Fp, Hh, Gll^Fp, Gll^Fp
Gll^Fp, Gs, Gg, Re^Vct, Re^Edt, Rd, Re, Re, Gll^Fp, Gg, Ket, Ww, Wwf, Gs^Es, Gg, Cer, Cer, Gll^Fp, Gg, Gll^Fp, Gs^Fms, Gs^Fds, Gs, Gll^Fp, Gs, Gs, Gs^Fms, Gll^Fp, Gg, Gg, Hh, Chr, Hh, Gs, Gg, Gll^Fp, Gll^Fp, Gll, Gg, Gll^Fp, Gll^Fp, Gs^Fds, Hh, Hh^Fp, Mm, Mm, Hh, Hh, Gll^Fp, Hh^Fms, Gll^Fms, Gll^Fp
Gll^Fp, Gll^Fp, Gg, Gs^Fp, Re, Re, Gg, Gll^Fp, Gs, Gs, Gg, Ww, Ww, Gg, Gg, Gs, Gg, Cer, Cer, Gg, Gll^Fp, Gll^Fp, Gg, Gg, Gg, Gs, Gs, Gg, Gg, Hh, Hh, Hh, Hh, Hh, Gg, Gll^Fp, Gll^Fp, Gll^Fp, Gll^Fp, Gll^Fms, Gll^Fp, Hh, Hh^Fp, Hh^Fp, Hh^Fp, Hh, Gll^Fp, Hh, Gll^Fp, Gs^Fds, Gll^Fp, Gll^Fp
