Ww, Ww, Ww, Wwf, Ww, Ww, Ww, Ww, Wwf, Wwf, Wwf, Wwf, Ww, Ww, Ww, Ds, Hhd, Ds, Ww, Wo, Ww, Ww, Ww, Ww, Ww, Ds, Ds, Hh, Ds, Wwf, Ww, Ww, Ds, Ds, Hh, Ww, Ww, Ds, Hh, Hh, Hh, Hh, Hh^Fms, Hh^Fds, Hh, Hh, Hh, Gs^Fms, Gll^Fp, Gll^Fp, Gs^Fds, Hh
Ds, Ww, Ww, Wwf, Ww, Ww, Ds, Ww, Ww, Wwf, Ww, Wwf, Ww, Ww, Ww, Wwf, Wwf, Ds, Ww, Ww, Ww, Wwf, Wwf, Ww, Wwf, Ww, Ww, Ds, Ww, Ww, Hhd^Fmw, Ww, Ww, Ds, Wwf, Chw, Ww, Ds, Hh, Hh, Hh, Hh^Fms, Hh, Gg, Gs, Hh, Hh^Fp, Gs^Fms, Hh^Fp, Gs^Fms, Gs^Fds, Gll^Fp
Ds, Ww, Ww, Ww, Wwf, Ds, Ww, Ww, Ww, Ww, Wwf, Ww, Wwf, Chw, Wwf, Ds, Ds, Ww, Wwf, Ds, Ww, Wwf, Ww, Ww, Ww, Ww, Hhd, Ww, Ww, Ww, Hhd^Fmw, Hhd, Ww, Ww, Chw, Chw, Ds, Hh, Hh, Gg, Hh^Fds, Hh^Fms, Gg^Efm, Gs, Gll^Fp, Hh, Gll^Fp, Hh^Fms, Gll^Fp, Gs^Fds, Gll^Fp, Gs^Fms
Ww, Wwf, Ww, Wwf, Hh, Ds, Ww, Ww, Ww, Ww, Ww, Ww, Hhd^Vhhr, Wwf, Ds, Ds, Wwf, Ww, Ww, Ds, Ds, Ww, Ww, Ww, Ds, Ww, Chw, Hhd^Fmw, Ww, Ds, Ds, Hhd^Fmw, Hh, Ww, Ww, Wwf^Es, Wwf, Ds, Gs, Gg, Hh, Hh^Fms, Gg^Efm, Gs, Gs^Fms, Gll^Fp, Gs, Gs, Gll^Fp, Gs^Fms, Gll, Gs^Fms
Wo, Ww, Ds, Wwf, Wwf, Ww, Ww, Wwf, Ds, Ww, Ww, Wwf, Ds, Wwf, Ww, Ww, Ww, Ww, Ww, Ww, Ww, Ww, Ww, Hh, Ds, Ww, Ww, Hhd^Fmw, Ds^Es, Ww, Ds, Hhd, Hh^Fmw, Ww, Hh^Fp, Ds, Wwf, Ds, Ds, Hh^Fms, Gg, Gg, Gg, Gg^Efm, Gg, Gll^Fp, Gs, Gll^Fp, Gll^Fms, Gll^Fms, Gs, Gs^Fms
Wo, Ds, Ds, Ww, Ww, Ww, Ww, Wwf, Ww, Ww, Ww, Wwf, Wwf, Ww, Ww, Ww, Ww, Ww, Ww, Ww, Ww, Hh, Hh, Ds, Ww, Ww, Ww^Es, Hhd^Vhhr, Hhd, Ww, Ww, Ds, Wwf, Wwf, Hh, Hh^Fp, Ds, Wwf, Ds, Hh, Gg, Gg^Efm, Gg, Gd^Vhr, Re, Gg, Gs, Gll^Fp, Gll^Fp, Gs, Gg, Gg
Wo, Wwf, Ds, Ww, Ww, Ds, Ds, Ww, Ww, Ww, Ww, Ww, Wwf^Es, Ww, Chw, Ww, Ww, Ww, Ww^Es, Ww, Ww, Ds, Ds, Ds, Ww, Ww, Chw, Ww, Ds^Es, Ds, Ww, Ww, Wwf, Ds, Gs^Fms, Gll^Fp, Gs, Wwf, Wwf, Gs, Gs, Gs, Gs, Gs, Re, Gs, Gg^Fet, Gs, Gg, Gg, Re, Re
Wwf, Ww, Ww, Ww, Ww, Md, Md, Ww, Ww, Wwf, Ww, Ww, Chw, Khw, Ww, Wwf, Ww, Ww, Chw, Khw, Ww, Ww, Ww, Ww, Ww, Chw, Ww, Ww, Ds, Hh, Hh^Fp, Ww, Hh^Fds, Ds, Gs^Fms, Gll^Fp, Gs^Fds, Gg, Gg, Gs^Vhr, Rd, Gg, Ce, Re, Ce, Gs, Gg, Gg^Efm, Re, Gg^Es, Re, Gg
Ds, Ds, Ww, Ww, Wwf, Hhd, Wwf, Ww, Wwf, Wwf, Ww, Ww, Chw, Ww, Ds, Wwf, Wwf, Ww, Ww, Ww, Ds, Wwf, Ww, Chw, Wwf, Wwf, Ww, Ww, Ww, Hh, Ds, Hh^Fp, Gs^Fds, Gs^Fds, Gs^Fms, Gs^Fms, Gs^Fds, Gs, Rd, Gg, Gg, Gs, Re, Ce, 1 Ket, Re, Re, Re, Gg, Re, Gg, Gs
Ds, Ww, Ww, Ww, Hhd, Hhd, Ww, Ww, Ww, Ww, Ww, Ww, Ww, Wwf, Ds, Ds^Es, Ch, Ds, Ds, Ww, Chr, Ds^Es, Ww, Ww, Ww, Ww, Wwf^Es, Chw, Wwf, Wwf, Hh, Ds, Hh^Fp, Gll^Fp, Gs^Fms, Gs^Fds, Gs, Gs, Re, Re, Re, Re, Re, Re, Ce, Ce, Gg, Gg^Fet, Gll^Fp, Gg, Hh, Gg
Wwf, Ww, Wwf, Ww, Ww, Wwf, Ww, Ww, Ww, Ww, Khw, Ww, Ww, Ww, Chr, Ch, Gs, Gs, Rp^Vhcr, Gs, Ds, Chr, Wwf^Es, Ww, Ww, Ww, Wwf, Ds, Hh, Hh, Hh, Hh^Fp, Gs^Fms, Gs^Fds, Gll^Fp, Gg, Gg, Gg, Re, Gg, Gs, Gs, Gs, Gg, Gg, Re, Gg^Fet, Gll^Fp, Gll^Fp, Gs, Hh^Fp, Hh
Ww, Ww, Ww, Ww, Ww, Ww, Ww, Chw, Wwf, Ww, Ww, Chw, Wwf, Ds^Es, Ds, Gs, Gs, Gg, Rr, Gs, Gg, Ch, Ds, Ww, Ce, Ww, Ds, Ds, Gs, Hh, Gg, Gg, Gll^Fp, Gg^Efm, Gg, Re, Re, Re, Gg, Gg, Hh, Hh, Hh^Fms, Gll^Fp, Gg, Re, Re, Gd^Ve, Gll^Fp, Gll^Fp, Hh^Fp, Hh^Fp
Ww, Ww, Ww, Wwf, Ww, Ww, Ww, Ww, Ww, Ww, Ww, Ww, Chr, Ds, Gs, Rp^Vhcr, Rr, Gg, 2 Kh, Chr, Gg, Gs, Gg, Ds, Ce, Ds, Hh, Gs, Gs, Gg, Gll^Fp, Gg, Gg, Gg^Efm, Re, Re, Gll^Fp, Re, Gg, Gg, Gs, Hh^Fp, Hh^Fms, Gll^Fp, Hh, Gg, Gll^Fp, Gll^Fp, Hh^Fp, Gll^Fp, Hh^Fms, Hh
Ww, Ww, Ww, Ww, Ww, Ww, Ww, Wwf, Wwf, Ww, Ww, Wwf^Es, Wwf^Es, Chr, Chr, Gs, Ch, Ch, Chr, Ch, Rr, Gg, Rp^Vhcr, Gg, Gg, Gs, Hh, Hh, Gg, Gll^Fp, Gll^Fp, Hh, Gg, Gg, Re, Re, Gll^Fp, Gs^Fms, Gg, Gs, Gs, Hh^Fms, Hh, Hh, Hh, Gg, Gs, Gll^Fp, Hh, Gll^Fp, Gg, Hh
Ww, Ww, Wwf, Wwf, Ww, Wwf, Wwf, Ww, Wwf, Ww, Chw, Wwf, Ww, Ww, Ds, Gs, Gg, Gs, Rr, Gg, Gg, Rr, Rr, Re, Re, Gg, Gg, Gg, Gll, Gll^Fp, Hh, Hh, Gll^Fp, Gg^Efm, Gg, Rp, Gg, Gg, Gll^Fp, Gll^Fp, Gg, Hh, Hh^Fms, Hh^Fp, Gs, Gg, Re, Gg, Gg, Gg, Chr, Hh
Ww, Ds, Wwf, Ww, Hhd, Hhd, Wwf, Ww, Ww, Ww, Ww, Chr, Ds^Es, Ce, Ce, Ds, Gs, Rp^Vhcr, Gg, Gg, Ce, Gg, Rp, Gg^Fet, Gg^Efm, Rp, Rp, Gg, Gg, Gg, Hh, Hh, Gs^Fet, Ket, Re, Re, Gg^Efm, Gg^Efm, Gs^Fds, Gs^Fms, Gg, Gg, Gg, Hh^Fms, Gs, Gs, Gs^Fds, Gg^Efm, Gg, Hh^Fms, Hh, Hh
Ww, Ds, Ds, Ww, Ds, Md, Wwf, Ww, Wwf, Hh, Wwf, Ww, Ds^Es, Ds, Gs, Ce, Ce, Gg, Ce, Ce, Gs, Gg, Gg, Re, Gg, Gg, Re, Re, Gg, Gg, Gg, Gg, Gg^Es, Gg^Vc, Re, Gg, Gg^Efm, Gg, Gs^Fms, Gll, Gg, Gg, Gs, Gs, Gs, Gll^Fp, Gs^Fms, Gs, Gg, Hh^Fp, Hh^Fp, Mm
Ww, Wwf, Ww, Ww, Ww, Wwf, Hhd, Ds, Wwf, Hh, Hh, Ds, Ds, Wwf, Gs, Gs, Gs, Ce, Gg, Gg, Gg, Gg, Re, Re, Gll^Fp, Gg^Efm, Re, Re, Re, Gg^Efm, Gg, Gg, Rp, Rp, Gg, Gg, Gg, Gll^Fp, Gll^Fp, Ss, Ss, Gll^Fp, Gs^Fds, Gll^Fp, Gg, Gll^Fp, Gs, Re, Re, Gg, Gg, Hh
Wwf, Ww, Ww, Wwf, Wwf, Ds, Wwf, Wwf, Wwf, Ds, Ww, Wwf, Ww, Ds, Rd, Gll^Fp, Gs^Fms, Gs, Gll^Fp, Gll^Fp, Gg, Rp, Gg, Gg, Gs^Fms, Gll^Fp, Gg^Em, Re, Gg, Rp, Re, Re, Gg^Efm, Gg, Hh, Gg, Gg, Gs, Ss, Ss, Ss, Ss, Gs^Fds, Gs^Fms, Gg, Gg, Chr, Gs, Re, Gs^Vhr, Gs, Hh
Wwf, Wwf, Ww, Ww, Wwf, Ww, Ds, Wwf, Wwf, Ds, Wwf, Wwf, Ds, Ds, Gs, Gll^Fp, Gs^Fds, Gs^Fds, Gs^Fms, Gs^Fds, Gg, Re, Gg^Vc, Gs^Fms, Gs^Fds, Gll^Fp, Gg, Gg, Gg, Gg, Gg, Gg^Efm, Gg, Gg, Gg, Hh, Gg, Gg, Chs, Ss, Ss, Gll^Fp, Ss, Gll, Gg, Hh, Chr, Gs^Dr, Chr, Gg, Hh, Gs
Ds, Ww, Wwf, Wwf, Gll^Fp, Ds, Rd, Gs, Gs, Gs, Wwf, Ds, Rd, Gs^Vc, Rd, Gs, Gs^Fds, Gs^Fms, Gll, Gll^Fp, Gg, Re, Gg, Gll^Fp, Gs^Fds, Gg^Efm, Gg, Gll^Fp, Gg, Hh, Hh, Gg, Hh, Hh, Gg, Hh, Gg, Gs^Fms, Gs^Fms, Ss, Ss, Ss, Gll, Gll^Fp, Hh^Fp, Hh, Hh^Fp, Gg, Gg, Gg, Hh, Hh
Ds, Ds, Ds, Wwf, Gll^Fp, Gll^Fp, Rd, Gs, Gs, Rd, Gll^Fp, Wwf, Gs, Gg, Gg, Gs^Fds, Gs^Fds, Gg, Gg, Gg, Rd, Re, Gg, Gll^Fp, Gg, Gg, Gll^Fp, Gll, Gg, Gg, Hh, Hh, Gg, Hh^Fds, Gs, Hh, Hh^Fds, Gs^Fds, Gs^Fms, Ss, Ss^Vhs, Gll^Fp, Gll, Gll^Fp, Gll^Fp, Hh, Hh^Fms, Hh, Hh, Hh, Mm, Mm
Gs, Gs, Gs, Wwf, Hh, Gs, Gs, Rd, Gs, Gg, Hh, Gg, Hh, Hh, Gg, Gs^Fds, Gg, Gg, Gs, Re, Rd, Gg^Es, Gg, Gg, Gg, Gll^Fp, Gs^Fms, Hh, Gg, Gg, Hh, Hh, Gs, Gs, Khr, Gs, Gs^Fet, Gs, Gs, Gs^Fms, Gs, Gll^Fp, Gll^Fp, Gll^Fp, Gll^Fp, Gg, Hh, Hh, Mm^Xm, Hh, Mm, Mm
Hh, Gg, Gg, Hh^Fp, Hh, Gg, Gll^Fp, Gll^Fp, Gll^Fp, Gll, Hh, Gg, Gg, Gg, Gs, Gs, Re, Gg, Gs, Gg, Re, Re, Re, Gg, Gg, Gg, Gll^Fp, Gs^Fds, Gg, Gg, Hh, Hh^Fms, Hh^Fms, Chr, Re^Es, Re^Dr, Re, Gs, Gg, Gg, Gll, Gll^Fp, Gll^Fp, Gll^Fp, Gll, Gg, Hh, Mm, Mm, Mm, Mm, Hh
Hh^Fp, Hh^Fp, Gg, Hh^Fp, Hh, Gs, Gll^Fp, Gll^Fp, Gll, Gll, Gll^Fp, Gg, Gg, Re, Gg, Gs, Re, Re, Re, Gs, Gg, Re, Re, Ket, Gg^Vc, Gg, Gg, Gs^Fms, Gll, Hh^Fms, Gll^Fp, Hh^Fp, Hh^Fms, Chr, Gs^Es, Gs^Es, Gs, Gg, Hh^Fds, Gg, Hh, Gg, Gg, Gll^Fp, Gg, Hh, Gg, Hh, Gg, Mm, Mm, Mm
Hh^Fp, Gg, Gg, Gll^Fp, Gg, Gs, Gg, Gg, Hh, Gll^Fp, Gs, Gg, Gs^Vc, Gs, Gg, Re, Gs, Gg, Gs^Fds, Re, Gg^Es, Gg, Re, Gg^Fet, Gs, Gg, Gll^Fp, Gg, Gs^Fms, Gs^Fms, Gll^Fp, Hh^Fp, Hh, Gs, Gg, Gs, Gg, Gg, Hh, Hh, Mm, Gg, Hh, Gg, Hh, Hh, Gs, Gg, Hh, Hh^Fp, Hh^Fp, Mm
Gg, Gll^Fp, Gll^Fp, Gll, Hh^Fp, Gg, Gg, Chr, Chr, Gll^Fp, Gs, Gg, Gg, Gg, Gg^Efm, Rd, Rd, Gs^Fms, Gs^Fds, Re, Re, Re, Gg, Gg, Gll, Gg, Gg, Gll^Fp, Gs^Fms, Gs^Fds, Gll^Fp, Gg, Gg, Gs, Gg, Hh, Gg, Hh, Mm, Mm, Hh, Hh, Gs^Fds, Hh^Fms, Gs^Fms, Gg, Gs, Gg, Hh, Hh^Fp, Hh^Fms, Mm
Hh, Gll^Fp, Hh^Fp, Gll^Fp, Gs^Fds, Gs^Fds, Hh^Fds, Gs, Gs, Gg, Gs^Fms, Gg, Gs, Gg^Efm, Gg, Gs, Gs, Re, Gs^Fms, Gg, Gll^Fds, Gll^Fms, Re, Gg, Gll^Fp, Gg, Gll^Fp, Gll^Fp, Gg, Gll^Fp, Hh^Fp, Hh, Hh, Gg, Hh, Hh, Hh, Hh, Mm, Mm, Hh, Hh, Gll, Gs^Fds, Gs^Fms, Gg, Hh, Gs, Gs, Gs, Hh, Hh
Hh, Hh^Fp, Hh^Fp, Gs^Fms, Gs^Fds, Gs, Gs, Gg, Gg, Gll^Fp, Gs^Fms, Gll, Gg, Gg, Gg, Ket, Re, Re, Gg, Gg, Gll^Fms, Gll^Fms, Gg, Gll^Fp, Gll^Fms, Gg, Gg, Hh^Fp, Gg, Hh, Hh, Hh, Mm, Mm, Gg, Gg, Hh, Mm, Hh, Gs, Gs, Hh, Gg, Gll^Fp, Gs, Gg, Hh, Gg, Gs, Gs^Efm, Gg, Hh^Fms
Gll^Fp, Hh^Fp, Hh, Gs^Fms, Gs^Fds, Gll^Fp, Gg, Chr, Gg, Gll^Fp, Gs^Fds, Gs^Fds, Gg, Gg, Gg, Re, Re, Gs, Re, Re, Gg, Re, Gg, Gll^Fms, Gll^Fp, Gll^Fp, Gg, Hh^Fp, Hh^Fds, Gg, Hh, Mm, Mm, Hh, Gg, Gg, Hh, Gg, Gg, Gs, Gg, Gg, Co, Gs, Re, Gg, Gg, Hh, Gs, Gs, Hh, Hh
Gll^Fp, Hh, Gll^Fp, Gll^Fp, Gs^Fds, Gs^Fms, Gs^Fds, Gll^Fp, Gs^Fms, Gll, Gs^Fms, Gs^Fms, Gll^Fp, Gs^Fds, Gg, Re, Gg, Gg^Vc, Gll^Fp, Re, Gg, Gg, Gll, Gll^Fms, Gll^Fp, Gll, Gg, Hh, Hh, Hh, Mm, Mm^Xm, Mm, Hh, Hh, Gg, Gg, Hh, Gg, Gg, Gs, Co, Gg, Gs, Rb, Gg, Co, Gg, Gs, Gs, Hh, Gg
Gll^Fp, Gll^Fp, Gll^Fp, Gg^Fet, Gs^Fms, Gs^Fds, Gs^Fds, Gll^Fp, Gll^Fp, Gs^Fds, Gs^Fms, Gs^Fms, Gll^Fp, Gs^Fms, Gg, Re, Gg, Gll^Fp, Gll^Fms, Gg, Gg, Gll^Fp, Gll^Fp, Gll^Fp, Gll^Fp, Gll^Fp, Gll^Fp, Gg, Hh^Vhh, Hh, Mm, Mm, Mm, Hh, Chr, Gg, Gg^Efm, Gg, Co, Gs, Re^Vct, Gg, Gs, Rb, Co, Gg, Gg, Co, Gll^Fp, Gg, Gs, Gs
Ww, Gll^Fp, Gll^Fp, Gs^Fms, Gll^Fp, Gg, Gg, Gg, Gll^Fp, Gll^Fp, Gs^Fds, Gll^Es, Gg, Gg, Re, Re, Gg, Gll^Fp, Gll^Fp, Gll, Gll^Fp, Gll^Fp, Gll^Fms, Gll^Fp, Gll^Fp, Gll^Fp, Gll^Fms, Gll^Fp, Gg, Hh, Hh, Mm, Mm, Hh, Hh, Gg, Gll^Fp, Gg, Co, Gg, Gg, Rb, Co, Rb, Rb, Rb, Gg, Gg, Gll^Fp, Gll^Fp, Gs^Fet, Gll^Fp
Ww, Gll^Fp, Gll^Fp, Gll^Fp, Gg, Gg, Cer, Cer, Cer, Gs^Fms, Gg, Gs, Ket, Gg, Re, Re, Gg, Gll^Fp, Gs, Gll, Gs, Gll^Fp, Gll^Fp, Gll^Fp, Gll^Fms, Gll^Fds, Gll^Fds, Gll^Fp, Hh, Hh, Hh, Hh, Mm, Mm, Hh, Hh^Fp, Gll^Fp, Gll^Fp, Gg, Gg^Efm, Gg, Rb, Co, 4 Ko, Co, Rb, Rb, Gll^Fp, Gs, Gll^Fp, Gll^Em, Gll^Fp
Ww, Gg, Gg, Gg, Cer, Cer, Gg, Gs, Gll^Fp, Cer, Gg, Gs, Re, Re, Cer, Gs, Gg, Gg, Gg, Gg, Gs, Gg, Gll, Gll^Em, Gll^Fp, Gll^Em, Gll^Fms, Gg, Gll^Fp, Gll^Fp, Gll^Fp, Hh, Hh, Mm, Hh, Hh^Fp, Gll^Fp, Gll^Fp, Gg, Re, Rb, Rb, Rb, Co, Rb, Rb, Rb, Rb^Vct, Gg, Gll^Fp, Gll^Fp, Gll^Fp
Ww, Wwf, Cer, Cer, Gs, Gg, Gg, Gll^Fp, Gll^Fp, Cer, Cer, Gg, Rd, Gg, Gll^Fp, Cer, Cer, Gg, Re, Re, Gg, Gs, Gll^Fp, Gll, Gg, Gll^Em, Gll^Fp, Gll^Fp, Gll^Fp, Gll^Fms, Gll^Fp, Hh, Hh, Hh, Gs, Gll^Fp, Re, Gs, Rb, Rb, Gg, Rb^Vct, Gs, Co, Gs, Gg, Gg, Gg, Gs, Gll^Es, Gll^Fms, Gll^Fms
Ww, Ww, Ww, Gs, Gg, Gll^Fp, Gll^Fp, Gs^Vh, Gs, Gg, Gg, Rd, Rd, Gg, Gll^Fp, Gll^Fp, Re, Gg, Re, Re, Rd, Gs, Gg, Gg^Efm, Gll^Fp, Gll^Fp, Gg, Gll, Gg, Gll^Fp, Gs^Vc, Gll^Fp, Gg, Gg, Gg, Re^Es, Re, Re, Gll^Fp, Co, Co, Gg, Gs, Gg, Gs, Gg, Co, Co, Gll^Fp, Gll^Fp, Gll^Fp, Gll^Fms
Cer, Ww, Ww, Ww, Ket, Gll^Fp, Gll^Fp, Re, Re, Re, Ch, Ch, Ch, Re, Re, Re, Re, Re, Rd, Ket, Gg, Rd, Gg, Gg, Gg, Gg, Re, Re, Gg, Gg, Gg, Gg, Re, Re, Gg, Re, Gg, Gg, Gll^Fp, Gll^Fp, Gll^Fp, Gll^Fp, Gg, Gg, Gll^Fp, Gs, Gs, Gll^Fp, Gll^Fp, Hh, Hh, Gll^Fp
Gll^Fp, Gs, Wwf, Ww, Ww, Ww, Ww, Gs, Re, Gg, Chr, 3 Kh, Ch, Rd, Gs, Re^Es, Gg, Cer, Gs, Gs, Gg, Re, Gg, Re, Re, Gg, Re, Re, Re, Re, Gg, Re, Gg, Re, Gg, Gg^Efm, Gg, Gll, Gll^Fp, Gll^Fp, Gll^Fp, Gll^Fp, Gll, Gll^Fp, Gll^Fms, Gll^Fp, Gll^Fp, Gll, Hh, Hh, Hh, Gll^Fp
Gll^Fp, Gg, Gg, Gg, Gll^Fp, Gs, Wwf, Ww, Gg, Gs, Rd, Ch, Rd, Rd, Gs^Vh, Gg, Gg, Cer, Gg, Gs, Gg, Gll^Fp, Gs^Fms, Re, Gg, Re, Re, Gg, Re, Gs, Gg, Gg, Hh, Gg, Gg, Gll^Fp, Gll^Fp, Gg, Gll, Gs, Gll^Em, Gll^Fp, Gll^Fp, Gs^Fds, Gll^Fp, Gll, Gg, Gll^Fp, Hh, Hh^Fp, Gll^Fms, Gll^Fms
Gll^Fp, Gll^Fp, Gs, Gll^Fp, Gll^Fp, Gs, Gg, Ww, Wwf, Re, Re, Gg, Re^Vct, Re, Gg, Gll^Fp, Cer, Cer, Gs^Fms, Gg, Gs, Gs^Fms, Gs^Fds, Gg, Gg^Efm, Gg^Efm, Gg, Gg, Gg, Gs, Gg, Hh, Gg, Gg, Gll^Fp, Gs, Gll^Fp, Gg, Gll^Fp, Gll, Gll^Fp, Gll^Fms, Gll^Fms, Gs^Fds, Hh, Hh, Mm^Xm, Hh, Hh, Gll^Fp, Gs^Fds, Gs^Fds
Gll^Fp, Gll^Fp, Gg, Gg, Gll^Fp, Gg, Gg, Re^Vct, Re, Wwf, Ww, Gg, Gg, Gg, Gs, Cer, Gll^Fp, Gs^Fms, Gs^Fms, Gll^Fp, Gs^Fms, Gs^Fds, Gs^Fds, Gs^Fms, Gs, Gg, Gll^Fp, Gll^Fp, Gg, Gg, Hh, Hh, Gg, Gll, Gll^Fp, Gs, Gll^Fp, Gll^Fp, Gll^Fp, Gll^Fp, Gll^Fms, Gll^Fms, Hh^Fms, Hh, Hh, Mm, Mm, Mm, Hh^Fp, Hh, Gll^Fp, Gll^Fp
Gll^Fp, Gs, Gg, Re^Vct, Re, Rd, Re, Re, Gll^Fp, Gg, Ket, Ww, Wwf, Gs^Es, Gg, Cer, Cer, Gll^Fp, Gg, Gll^Fp, Gs^Fms, Gs^Fds, Gs, Gll^Fp, Gs, Gs, Gs^Fms, Gll^Fp, Gg, Gg, Hh, Chr, Hh, Gs, Gg, Gll^Fp, Gll^Fp, Gll, Gg, Gll^Fp, Gll^Fp, Gs^Fds, Hh, Hh^Fp, Mm, Mm, Hh, Hh, Gll^Fp, Hh^Fms, Gll^Fms, Gll^Fp
Gll^Fp, Gll^Fp, Gg, Gs^Fp, Re, Re, Gg, Gll^Fp, Gs, Gs, Gg, Ww, Ww, Gg, Gg, Gs, Gg, Cer, Cer, Gg, Gll^Fp, Gll^Fp, Gg, Gg, Gg, Gs, Gs, Gg, Gg, Hh, Hh, Hh, Hh, Hh, Gg, Gll^Fp, Gll^Fp, Gll^Fp, Gll^Fp, Gll^Fms, Gll^Fp, Hh, Hh^Fp, Hh^Fp, Hh^Fp, Hh, Gll^Fp, Hh, Gll^Fp, Gs^Fds, Gll^Fp, Gll^Fp
