border_size=1
usage=map

Gll^Fp, Gll^Fp, Gll^Fp, Gg, Gll, Gll^Fp, Gll, Gll^Fp, Gs, Gg, Re, Re, Gg^Efm, Gg, Gs, Gg, Gll^Fp, Gll^Fp, Gll^Fp, Ss, Ss, Gll^Fp, Gll^Fp, Ds, Ww, Ds, Gll^Fp, Hh, Gll^Fp, Hh, Hh, Hh, Hh, Hh, Gll^Fp, Hh, Mm, Mm, Mm, Mm, Mm, Hh, Hh, Hh, Hh, Hh, Hh^Fp, Gg, Gg, Gs, Gs, Gg^Zi, Gg, Gg, Gll^Fp, Re, Re, Gs, Gll^Fp, Gll^Fp, Gll^Fp, Hh^Fp, Hh, Mm
Gll, Gll, Re^Vct, Gll^Fp, Gs, Gs, Gll^Zi, Gll, Re^Vct, Re, Re, Gg, Gg, Gs, Re^Vct, Gs, Gll^Fp, Gll^Fp, Gll^Fp, Ss, Ss, Gll^Fp, Gll^Fp, Ww, Ds, Ds, Gll^Fp, Gll^Fp, Hh^Fp, Hh^Fp, Gg, Gg, Hh, Hh, Gll^Fp, Hh^Fp, Mm, Mm, Mm, Hh, Hh^Fp, Hh, Hh, Hh, Gg, Hh^Fp, Hh, Gg, Gg, Gs, Re^Vct, Gll, Gs, Gg, Gs, Re, Gs, Gs, Hh, Hh, Hh^Fp, Hh^Fp, Mm, Mm
Gll^Fp, Gll^Fp, Gll, Re, Re, Gs, Gg, Gs, Gg, Re, Re, Gs, Ce, Gg, Re, Re, Gll, Gll, Gll^Fmw, Ss, Ds, Ds, Ww, Ww, Gs, Gll^Fp, Wwf, Gll^Fp, Hh^Fp, Hh^Fp, Gll^Fp, Gg, Hh, Gll^Fp, Gll^Fp, Hh, Mm, Mm, Hh, Hh^Fp, Gll^Fp, Hh, Hh, Gg, Gg, Gg, Hh, Gs, Hh, Gg, Re, Re, Gg, Gll^Fp, Re, Re, Gg, Hh^Fp, Hh, Hh, Hh^Fp, Hh, Mm, Mm
Gs, Gll^Fp, Gs, Gg, Rd, Gg, Gs, Gg, Re, Re, Re, Gg, Gg, Re, Gg^Zi, Gg, Gs, Gg, Ss, Ss, Ds, Ww, Gll^Fp, Wwf, Wwf, Ww, Ww^Ewf, Hh, Hh^Fp, Hh^Fp, Gll^Fp, Gll, Gll^Fp, Gll^Fp, Hh, Hh, Hh, Hh, Gg, Gg, Gg, Gs, Gg, Gg, Gs, Gs, Gs, Gs, Gs, Gs^Vct, Re, Gs, Gg, Gll^Fp, Re, Gg^Vct, Gg, Hh, Gll^Fp, Hh, Hh, Mm, Hh, Hh
Gs, Gs, Gll^Fp, Gg, Re^Vct, Rd, Re, Ce, Ce, Ce, Ce, Gg, Re, Rd, Gg, Gg, Gs, Gg, Gll, Ds, Ww, Ww, Gg, Gll^Fp, Ww, Ww^Ewl, Wwf, Re, Gs, Hh, Gll^Fp, Gll, Hh, Hh, Mm, Mm, Mm, Hh, Gg, Gg, Gg, Hh, Gg, Hh, Hh, Gll^Fp, Gll^Fp, Gll, Gg, Gg, Gg, Rd, Re, Gg, Gg, Re, Re, Gg, Gg, Gg, Hh, Hh, Gg, Hh
Re, Gs^Vct, Re, Rd, Rd, Re, Re, Ce, Ce, 2 Ket, Ce, Re, Re^Vct, Re, Re, Gg, Gs, Gs, Ce, Ds, Ww, Ww, Gll^Fp, Gll^Fp, Hh, Ww^Ewf, Re, Gg, Gg, Gg, Gll^Fp, Gg, Hh, Hh, Hh^Fp, Mm, Mm, Gg, Gg, Gg, Gll, Gs, Gg, Hh, Hh, Gll^Fp, Gll^Fp, Gll, Gg, Re^Vct, Re, Gs, Ce, Re, Gg, Gll^Fp, Re, Gg, Re^Vct, Ce, Gg, Gg, Gs, Gs
Gll^Fp, Re, Gll, Gg, Gg^Zi, Re, Re, Re, Re, Ce, Ce, Gg, Gs, Gg, Ce, Re, Re, Gg, Gg^Efm, Ds, Ww, Ds, Ds, Gg, Gg, Gg, Gg, Gg^Efm, Gg, Gs, Gs, Gll, Gg, Gll^Fp, Gll^Fp, Hh, Mm, Hh, Hh, Gll^Fp, Gll^Fp, Gg, Gll^Fp, Gg, Gll^Fp, Gg, Gll^Em, Gll^Fp, Gg, Gg, Gg^Zi, Re, Re, Re, Rd, Re, Ce, Re, Re, Gg, Re, Gg, Gg^Vct, Gs
Gll, Gll^Fp, Gs, Gg, Re, Re, Re^Vct, Gg, Re, Ce, Rd, Gg, Gs, Gs, Gll, Re, Gll^Fp, Re, Re, Wwf, Wwf, Ds, Ds, Gs, Gg^Efm, Gg, Gg^Efm, Gg, Gll^Fp, Gg, Gs, Gll, Gg, Gll^Fp, Gg, Hh, Hh, Mm, Hh, Gll^Fp, Gll^Fp, Gll^Fp, Gll, Gg, Gg, Gg, Gll, Gll, Gll, Gg, Gg, Gg, Re, Re, Gg, Ce, 1 Ke, Ce, Gg, Gg^Zi, Re, Gg, Gg, Hh
Gg, Gll, Gll, Re, Re, Gg^Es, Gg^Efm, Gg, Gg, Rd, Rd, Re, Re, Re^Vct, Gs, Gll^Fmw, Gll^Fp, Gg, Wwf, Wwf, Re, Gg, Gg, Ds, Gg, Gg, Gg, Gg, Gll^Fp, Gll^Fp, Gll, Gg, Gg, Gs^Vhr, Gg, Gg, Hh, Mm, Hh, Gll^Fp, Gll, Gll^Fp, Gll, Gg, Hh, Gg, Gll^Fp, Gg, Gll, Ce, Gs, Re^Vct, Gg, Re, Gg, Ce, Ce, Ce, Re, Re, Gg, Gll^Fp, Hh, Hh
Re, Gll, Re, Re, Gll, Gg, Gg, Gs, Gll^Fp, Gll^Fmw, Ce, Re, Re, Ce, Re, Gg, Ww, Ww, Ds, Re, Re, Re, Gg, Ds, Gg, Gg, Gll^Fp, Gs, Gg, Gll, Gs, Gg, Gg, Re, Re, Gg, Gg, Hh, Gs, Gg, Gs, Gs, Gs, Gs, Hh, Gg, Gg, Gg, Gs, Gg, Gll, Gg, Gs, Re, Gg, Re, Re, Gg, Re, Re, Gs, Hh, Hh^Fp, Hh
Gg, Re, Ds, Ds, Ww, Gs, Ww, Ds, Ds, Gll^Fdw, Gll^Fdw, Gg, Re, Re, Re, Gg, Wwf, Ww, Ds, Gll, Gll, Rp, Rp, Gg, Gg, Gs, Gll^Fp, Gll^Fp, Gs^Fmw, Gll, Gs, Gg, Gll^Fp, Gg, Re, Gg, Gg, Gg, Hh, Gs, Gll, Gg, Gg, Gg, Gg^Fmw, Gs^Fdw, Gg, Gg^Es, Gg, Gll^Fp, Gll^Fp, Gg, Gs, Re, Re, Re, Re, Gg, Re, Ce, Gs, Hh, Hh, Gg
Gll^Fp, Gll^Fp, Wwf, Ww, Ds, Ww, Gll^Fp, Wwf, Ww, Gll^Fmw, Gll^Fp, Gg^Efm, Gg^Efm, Re, Wwf, Ww, Ds, Ds, Gll, Gll^Fp, Gs, Re, Rp, Re, Gg, Gg, Gs, Gll^Fp, Re, Gs, Gs, Gll^Fp, Gs, Gg, Re, Re, Gg, Hh, Gll^Fmw, Hh, Gs, Gg, Gg, Gll^Fp, Gd^Fmw, Gs, Gg, Hh, Gg, Gll^Fp, Gll^Fp, Gs, Ce, Gg, Rd, Gg^Zi, Gg, Re^Vct, Gg, Re, Re, Hh, Gg, Gg
Gll^Fp, Ww, Ww, Ds, Gll^Fp, Ss, Ss, Gll^Fp, Gll^Fp, Ww, Ww, Wwf, Ww, Wwf, Re, Ww, Gs, Gll^Fp, Gll, Gs^Fds, Gll^Fmw, Gs, Gg, Rp, Re, Re, Re, Re, Re, Re, Re, Gg, Re, Re, Re, Re, Gg, Hh, Hh^Fp, Gd^Fmw, Gg, Gg, Gs, Gg, Gs, Gg, Gg, Gg, Gg, Gll^Fp, Gg, Gll, Gg, Gg, Re, Gg, Gll, Gg, Gll^Fp, Gg, Re, Hh, Gg, Gg
Ww, Ww, Ds, Ds, Ss, Ss, Ss, Gll^Fp, Gll^Fmw, Ds, Ds, Ds, Gg, Re, Re, Rp, Gg, Gg, Gll, Gll^Fp, Gs^Fms, Gs^Fdw, Gg, Re, Re, Rp, Gs, Gs, Gs^Vhr, Re, Re, Rd, Rd, Re, Re, Gg, Gg, Gs, Hh^Fmw, Gll^Fetd, Gg, Gg, Gg, Re, Gs, Gg, Gg, Gg, Gd^Es, Gg, Gs, Re, Gs, Re, Re, Ce, Gll^Fp, Gs^Em, Gs^Fp, Gll^Fp, Re^Vct, Gs, Gll, Gll^Fp
Ww, Ds, Gll^Fp, Ss, Ss, Gll^Fp, Gs, Gs, Gll^Fmw, Gs^Fdw, Gd, Gg, Re, Re, Re, Rp, Re, Gs, Gg, Gs^Fds, Gs, Gs^Fdw, Gs, Gg, Rp, Re, Gs, Gd^Fdw, Gd, Gs, Chr, Rd, Re, Gg, Gs, Re, Re, Gll^Fp, Gs, Hh, Gg, Gg, Gs^Vhr, Re, Re, Gg, Gg, Gg, Gg, Gg^Es, Gs, Gs, Rd, Re, Gs, Gs, Hh, Gs^Fp, Gg, Gll^Fp, Gll^Em, Gs, Gll^Fp, Gll^Fp
Ds, Ds, Gll^Fp, Ss, Ss, Gll^Fp, Gd^Fmw, Gd^Fetd, Gll^Fdw, Gs, Gg, Gg^Vhr, Rp, Re, Gg, Re, Rp, Re, Gg, Gll, Gll^Fp, Gs, Gd, Gs, Rp, Re, Gg, Gg, Qxe, Chr, 4 Kh, Chr, Rp, Gg, Gs, Re, Re, Gs, Gg, Hh, Gg, Gs, Re, Re, Rr, Rp, Rr, Gs, Re, Gg, Gg, Re, Gs, Re, Gg, Gg, Hh, Gll^Fp, Gg, Gg, Gg, Gg, Gg, Gll^Fp
Gg, Gs, Gll^Fp, Gs, Gll^Fp, Gll^Fp, Gg, Gll^Fp, Gs, Gg, Re, Re, Chr, Chr, Ch, Gg, Rp, Rp, Gg, Gd, Qxe, Qxe, Qxe, Qxe, Rr, Rr, Ch, Qxe, Qxe, Ch, Chr, Rp, Rp, Gs^Vhr, Gd, Re^Fdw, Re^Fdw, Re, Re, Re, Re, Rp, Rp, Rp, Re, Rp, Rp, Re, Re, Re, Re, Rd, Gg, Gs, Gg, Gg, Gs, Hh, Hh, Gll^Fp, Gg^Fet, Gg, Hh, Hh
Gg, Gg, Gs, Gs, Gs, Gg^Efm, Gg, Gs^Fdw, Rp, Re, Gs^Vhr, Gg, Chr, 3 Khr, Chr, Gg, Rp, Rr, Gs, Gd, Qxe, Gd^Fetd, Chr, Ch, Rr, Re, Qxe, Ch, Qxe, Qxe, Gg, Rr, Rr, Gg, Gs^Fdw, Re, Re^Fdw, Re^Fdw, Re, Re, Rr, Rr, Chr, Ch, Ch, Gg, Gs^Vhr, Re, Gs, Gg, Gg, Gs, Gs, Gs, Gs, Gll^Fp, Gg, Gg, Hh, Hh^Fp, Gg, Hh, Hh^Fp, Hh^Fp
Qxe, Gg, Gg, Gs, Gg, Gg^Efm, Gg, Gs, Rp, Re, Gs, Gg, Qxe, Ch, Qxe, Qxe, Rr, Rp, Qxe, Qxe, Ch, Chr, Qxe, Qxe, Re, Rr, Gg, Ch, Ch, Qxe, Qxe, Rr, Re, Gg, Gs^Fdw, Re^Fdw, Re, Re, Rp, Rp, Gs, Re, Chr, 5 Kh, Chr, Gg, Gs, Re, Gs, Gg, Gg, Gg, Gg, Gll^Fp, Gs, Gll^Fp, Gg, Gg, Hh, Hh^Fp, Hh^Fp, Hh, Hh, Hh^Fp
Ch, Qxe, Qxe, Gg, Gll^Fp, Gg, Rp, Rp, Gg, Gd^Fetd, Gs, Gd, Qxe, Qxe, Chr, Ch, Rr, Rr, Chr, Qxe, Chr, Qxe, Qxe, Qxe, Rr, Rp, Gs, Gs, Gg, Ch, Rr, Rr, Re, Qxe, Gs, Re^Fdw, Re, Re, Rr, Rr, Gd, Gs, Gg, Ch, Gs, Gg, Gg, Gd, Gg, Gg, Gll^Fp, Gs, Gll^Fp, Gll^Fp, Hh, Gll^Fp, Gll^Fp, Hh, Hh, Hh^Fp, Hh, Hh, Hh, Hh
Gg, Chr, Qxe, Gg, Gll^Fp, Gll^Fp, Rp, Re, Gg, Gs^Fdw, Gg, Qxe, Ch, Chr, Gd, Qxe, Re, Rr, Rr, Ch, Gg, Gg, Rp, Rr, Rp, Rr, Re, Gd^Fetd, Gs, Re, Rr, Rr, Chr, Qxe, Qxe, Re, Re, Re, Rp, Gs, Gg, Qxe, Qxe, Gs, Gs^Vhr, Gs, Gd, Gs, Gs, Gll^Fp, Hh, Gs, Gll^Fp, Gll^Fp, Hh, Hh^Fp, Hh^Fp, Hh, Mm, Hh, Hh, Hh, Gg, Hh
Gg, Chr, Chr, Gg, Gs, Gs, Gg, Rp, Rp, Gg, Qxe, Qxe, Ch, Gs^Es, Gs, Qxe, Qxe, Rr, Rr, Re, Rp, Rp^Vhcr, Rr, Rr, Gs, Rp, Re, Re, Re, Rr, Rr, Gg, Gg, Chr, Ch, Re, Rp, Re, Gs, Gg, Qxe, Qxe, Qxe, Gs, Gd, Gd, Qxe, Re, Gll^Fp, Gll^Fp, Hh, Hh, Gll^Fp, Hh, Hh, Hh^Fp, Hh, Hh, Hh, Mm, Hh, Hh, Gg, Gg
Gs, Re, Re, Re, Gg, Gs, Gg, Re, Rp, Gs, Qxe, Qxe, Chr, Gs, Gg^Es, Gs, Qxe, Gll^Fmw, Gll^Fdw, Rr, Rp, Rr, Rr, Rp, Ch, Ch, Ch, Rr, Rr, Rr, Rr, Rp, Re, Gg, Re, Rp, Rr, Qxe, Qxe, Qxe, Chr, Chr, Ch, Qxe, Qxe, Qxe, Qxe, Gd, Qxe, Qxe, Qxe, Hh, Qxe, Hh, Hh, Mm, Mm, Hh, Mm, Mm, Hh, Hh^Fp, Hh, Gs
Gs, Gs, Re, Gs, Qxe, Gg, Qxe, Ch, Rp, Rp, Gg, Qxe, Ch, Gg, Gg, Gd, Qxe, Gll^Fdw, Gs^Vh, Rr, Rp, Gg, Ch, Rr, Xos, Ch^Xo, Xos, Rr, Ch, Gs^Vhr, Gll^Fp, Rr, Rr, Gg, Rr, Rr, Chr, Chr, Qxe, Qxe, Qxe, Qxe, Ch, Qxe, Gll^Fdw, Qxe, Ch, Qxe, Qxe, Ch, Ch, Qxe, Qxe, Hh, Hh, Mm, Mm, Mm, Mm^Xm, Mm, Hh, Hh, Mm^Xm, Hh
Qxe, Gll^Fp, Gll^Fp, Chr, Qxe, Qxe, Ch, Chr, Re, Rr, Rp, Chr, Re, Chr, Rr, Gs, Gs^Es, Gll^Fdw, Rr, Rr, Gg, Ch, Ch^Xo, Xol, Xol, Iwr^Xo, Xol, Xol, Ch^Xo, Ch, Gll^Fp, Rr, Rr, Rr, Rp, Rp, Gs, Gg, Gg, Qxe, Re, Qxe, Qxe, Gll^Fmw, Gll^Fmw, Chr, Gll^Fp, Qxe, Qxe, Qxe, Gll^Fp, Ch, Gll^Fp, Qxe, Qxe, Mm, Qxe, Mm^Xm, Mm^Xm, Mm, Mm, Hh, Mm, Hh
Ch, Qxe, Gs^Fms, Qxe, Qxe, Ch, Gg, Gs, Gg, Re, Re, Rp, Rr, Rr, Re, Rr, Rr, Gg, Rr, Re, Gg, Ch, Xos, Iwr^Xo, Iwr^Cov, Iwr^Cov, Iwr^Cov, Iwr^Xo, Xos, Ch, Rp^Vhcr, Rr, Re, Re, Gg, Ce, Gd^Fmw, Gs^Fdw, Gs, Re, Re, Gg, Gll^Fp, Gll^Fp, Gll^Fmw, Gll^Fp, Gd^Fmw, Gll^Fp, Qxe, Gd^Fmw, Gll^Fp, Gll^Fp, Gll^Fp, Gll^Fp, Gll^Fp, Qxe, Gll^Fp, Qxe, Mm, Mm^Xm, Mm^Xm, Hh, Hh, Hh
Gll^Fp, Ch, Gs^Fms, Gll^Fp, Gs^Fds, Gll^Fp, Gs, Gd, Gs, Gg^Vh, Gs, Rp, Rp, Re, Gs, Ce, Re, Rr, Rr, Rp, Rr, Rr, Xol, Xol, Iwr^Cov, 9 Urb^Kov, Iwr^Cov, Xol, Xol, Rr, Rr, Rr, Rp, Gg, Ce, Ket, Qxe, Gs, Gs^Es, Re, Re, Gll^Fp, Gll^Fmw, Gll^Em, Gll^Fp, Gll^Fmw, Gs, Gd^Fmw, Gll^Fp, Gd^Fmw, Gll^Fp, Gs, Gll^Fp, Gll^Fp, Hh, Gll^Fp, Hh^Fp, Mm, Mm, Mm, Mm^Xm, Mm, Mm, Mm
Gs, Gs, Gs, Gll^Fp, Gs^Fds, Gs^Fms, Gll^Fp, Gll^Fp, Gg, Gg, Rr, Rr, Re, Gg, Gs, Ket, Ce, Rp, Rp, Re, Gg, Ch, Ch^Xo, Iwr^Xo, Xos, Iwr^Cov, Xos, Iwr^Xo, Ch^Xo, Ch, Gg, Rr, Rp, Ce, Gll^Fmw, Gll^Fmw, Qxe, Gg, Re, Re, Gll^Fp, Gll^Fp, Gll^Fp, Gll^Emf, Gs, Gll^Fp, Qxe, Qxe, Gll^Fp, Gll^Fp, Gll^Fp, Gs, Gg, Gll^Fp, Hh, Hh^Fp, Mm, Mm, Hh, Mm, Mm, Mm^Xm, Mm^Xm, Mm
Ww, Gs, Gll^Fp, Gs, Gll^Fp, Hh^Fmw, Hh^Fp, Gg, Chr, Chr, Ch, Re, Gs^Vhr, Gg, Gg, Gg, Gs^Es, Gs, Rp, Re, Gs, Ch, Ch, Xos, Xos, Iwr^Xo, Xos, Xos, Ch, Ch, Gg, Rr, Rr, Gg, Gg, Gd^Fmw, Rr, Qxe, Re, Re, Gg, Gll^Fmw, Gll^Fp, Gll^Em, Gs^Em, Qxe, Qxe, Gll^Fp, Gll^Fmw, Gll^Em, Gll^Fp, Gll^Fp, Gg, Hh, Gs, Hh, Hh, Mm, Hh, Mm, Qxe, Mm^Xm, Mm^Xm, Mm
Gll^Fp, Ww, Gll^Fp, Gs, Gs, Hh, Hh, Gg, Chr, 7 Kh, Chr, Re, Re, Gs, Gg, Gs, Gs, Re, Ce, Rr, Re, Gs, Rr, Rr, Ch, Ch^Xo, Ch, Rr, Rr, Gg, Rr, Re, Rr, Rr, Rr, Re, Rr, Rr, Re, Re, Gs, Gg, Gs^Es, Gs, Gg, Gs, Gs, Gll^Fp, Gll^Fmw, Gll^Em, Gd^Fetd, Hh, Hh, Hh, Gs, Hh^Fp, Hh^Fp, Hh, Gs, Mm, Mm, Qxe, Mm^Xm, Mm
Hh, Ww, Ww, Gll^Fp, Gs, Hh, Hh^Fms, Gg, Gg, Ch, Gs, Gs, Re, Gg, Gs^Fms, Gd^Fmw, Ce, Gs, Gs, Re, Rr, Rp, Rp^Vhcr, Gs^Es, Gs^Es, Ch, Gg, Rr, Rr, Rr, Rr, Rr, Re, Rr, Rp, Rr, Gll^Fp, Re, Re, Rr, Rr, Gs, Gg, Gg, Qxe, Gg, Gg, Gll^Fp, Gll^Fmw, Gll^Fp, Hh^Fmw, Hh^Fp, Hh, Hh^Fp, Gg, Hh, Hh, Gs, Mm, Mm, Mm, Qxe, Qxe, Mm^Xm
Hh, Hh, Ss, Ww, Ww, Gll^Fp, Gs^Fms, Gs^Fds, Gg, Gg, Gg, Gd, Gll^Fp, Gs, Gs^Fms, Gs^Fds, Gs^Fms, Ket, Ce, Gs^Es, Rp, Rr, Re, Gg^Es, Gs^Es, Gs, Re, Re, Rr, Re, Gs^Es, Re, Re, Rr, Rp, Ce, Gll^Fp, Gll^Fp, Gll^Fp, Re, Re, Gg, Chr, Chr, Qxe, Gg, Qxe, Gs, Gs, Gd^Fmw, Hh^Fp, Hh^Fdw, Mm, Hh, Hh, Gg, Hh, Hh, Hh, Hh, Mm^Xm, Mm, Mm, Qxe
Hh, Ss, Ss, Ss, Ww, Ss, Ss, Gs^Fds, Gll^Fp, Gll^Fp, Gll^Fp, Gs, Yhs, Gd^Fmw, Gd^Fmw, Hh^Fp, Hh, Gg, Re, Re, Re, Rr, Re, Rp, Rr, Rr, Rr, Rr, Gg, Gg, Gs, Gs^Es, Gg, Rp, Re, Ce, Ce, Gll^Fp, Gs^Vhr, Rr, Rr, Qxe, Qxe, Qxe, Uh, Qxe, Qxe, Qxe, Gg, Gd^Fmw, Hh^Fmw, Hh, Hh, Mm, Mm, Mm, Mm, Mm, Mm^Xm, Hh, Mm, Mm^Xm, Mm^Xm, Mm
Hh, Ss, Gll^Fp, Gll^Fp, Ww, Ww, Ss^Vhs, Gs^Fms, Gll^Fp, Ww^Es, Wo, Ds, Yhs, Yhs, Gd^Fmw, Hh, Re, Re, Rd, Re, Re, Re, Re, Rr, Re, Rr, Gs, Gs, Ket, Ce, Ce, Gs^Es, Ce, Rp, Re, Gll^Fp, Gg, Gll^Fp, Rr, Re, Rr, Qxe, Uue, Uh, Uue^Uf, Qxe, Uue^Em, Chr, Gg, Gs^Fdw, Hh, Hh^Fp, Mm, Hh, Hh, Mm, Mm, Mm, Mm^Xm, Mm, Mm, Mm, Mm^Xm, Mm^Xm
Gg, Gd^Fmw, Gll^Fp, Ds, Ww, Ww, Gll^Fp, Gll^Fp, Ww^Es, Ww, Wo, Ds, Ds, Yhs, Wwf, Rb, Re, Re, Rd, Re, Rb, Re, Re, Rr, Rr, Gs, Ce, Ce, Gs, Gs, Gg, Ce, Gg, Re, Re, Gg, Re, Re, Rr, Re, Rr, Qxe, Uue^Em, Uue^Em, Uue^Uf, Yhs, Qxe, Chr, Qxe, Gs, Gs, Hh^Fp, Hh, Hh, Hh, Mm, Mm, Mm, Mm, Mm^Xm, Mm^Xm, Mm, Mm, Mm^Xm
Hhd, Ss, Ss, Ww, Ww, Ww, Gll^Fmw, Ds, Ww, Ww, Ww, Wo, Ww, Ds, Wwf, Wwf, Re^Es, Re^Es, Re^Es, Re, Rb, Rb^Fdw, Re, Re, Rr, Gs, Ce, Gs, Gs^Es, Gg^Es, Chr, Gg, Rr, Re, Re, Gs^Vh, Re, Rr, Re, Rr, Chr, Chr, Chr, Yhs^Xp, Yhs^Vu, Yhs^Xp, Qxe, Uh, Qxe, Qxe, Gd^Fdw, Hh, Yhs, Yhs, Yhs, Hh, Hh, Mm, Mm^Xm, Mm^Xm, Mm, Mm^Xm, Mm, Mm
Hhd, Ss, Yhs, Ww, Ww, Ww, Ww, Ww, Gll^Fp, Gll^Fp, Ww, Ww, Wo, Ww, Ww, Ds, Re, Re^Es, Rd^Es, Re, Rb^Fdw, Rb^Fetd, Re, Re, Rp, Ce, Gg, Gs, Re^Es, Ch, 8 Kh, Chr, Rr, Qxe, Re, Rp, Rp, Rr, Qxe, Re^Es, Chr, 6 Khr, Chr, Uue^Uf, Yhs^Uf, Qxe, Uue, Uh, Qxe, Gs, Gs^Fdw, Gs^Fdw, Hhd, Yhs, Hhd^Fdw, Hhd, Hh, Mm, Mm^Xm, Mm^Xm, Mm, Hh, Hh, Mm
Hhd, Hhd, Ss, Ss, Yhs, Ww, Ww, Ww, Gll^Fp, Ds, Ww, Wo, Wo, Ww, Ds, Ds, Rb^Fdw, Re, Re^Es, Re, Re^Es, Re, Re, Rr, Re, Gs, Gs^Vhr, Gs, Re, Chr, Ch, Chr, Qxe, Qxe, Gg, Re, Rp, Rr, Qxe, Qxe, Yhs, Chr, Gd^Fetd, Chr, Yhs, Yhs^Xp, Uue^Em, Qxe, Chr, Gs, Hhd, Gd^Fdw, Yhs, Yhs, Hhd, Hhd, Hh, Mm, Mm, Mm^Xm, Mm^Xm, Hh, Mm, Hh
Md, Hhd, Hhd, Yhs, Yhs, Wwf, Ww, Ww, Ww^Es, Ds^Esd, Ww, Wo, Ww, Ww, Yhs, Yhs, Rb^Fmw, Rb^Fmw, Re, Rd^Es, Rd, Rr, Rr, Re, Re, Gs, Rp, Rp, Rr, Rr, Gs^Es, Qxe, Gs, Qxe, Qxe, Gg, Rp, Re^Es, Gs^Es, Qxe, Yhs^Xp, Yhs, Uue^Vu, Qxe, Qxe, Yhs^Xp, Uue, Uh, Chr, Hhd, Hhd^Fdw, Hhd, Hhd, Hhd^Fdw, Mm, Mm, Hh, Hh, Mm, Mm^Xm, Mm^Xm, Mm, Mm, Mm
Md, Hhd, Hhd, Yhs, Ds, Wwf^Es, Wwf, Ww, Ww, Ww^Es, Ww, Ww, Ds, Yhs, Yhs, Yhs, Gd^Fmw, Gll^Fp, Rb, Re^Fmw, Gs, Rr, Rp, Rr, Rr, Rp, Re, Rr, Chr, Chr, Gs, Gs, Gg, Gs, Qxe, Gg, Re, Re, Gs^Es, Chr, Uue^Em, Yhs^Uf, Yhs^Xp, Qxe, Qxe, Yhs, Gs, Chr, Gs, Gg, Hhd^Fdw, Hhd, Hhd, Hhd, Mm, Mm, Mm, Hh, Mm, Mm^Xm, Mm^Xm, Mm, Mm^Xm, Mm
Md, Md, Hhd, Hhd, Hhd, Ds, Wwf, Ds, Ww, Wo, Ww, Ww, Wwf, Ds, Yhs, Gs^Fdw, Gs^Fdw, Gd^Fmw, Gs^Fdw, Gll^Fp, Gd^Fmw, Gg, Gs, Rp, Re, Rr, Rr, Gs, Ch, Qxe, Gs, Gd^Es, Gg, Qxe, Re, Rp, Re, Rp, Gs, Chr, Chr, Uue^Uf, Chr, Yhs, Gg, Gs, Gs, Gs, Hhd, Hhd, Hhd, Hhd, Md^Xm, Hhd, Hhd^Fdw, Mm, Hh, Hh, Mm, Mm, Mm, Mm, Mm, Mm
Md, Md^Xm, Md, Md, Md, Hhd, Ds, Ds, Wwf, Ww, Ww, Wwf, Ds, Ds, Gs, Gs, Gd^Fmw, Gs^Fdw, Qxe, Gs^Fdw, Gs^Fdw, Gg, Gg, Gs, Gg, Re, Rp, Rr, Gs, Qxe, Qxe, Gs, Re, Re, Re, Re, Re, Gs^Vhr, Gs, Gg, Gg, Gs, Gg, Chr, Gg, Gs, Gg, Gs, Gg, Gg, Hhd^Fmw, Hhd, Md^Xm, Hhd, Hhd, Mm, Hh, Mm, Mm, Md, Md, Md^Xm, Md, Md^Xm
Md^Xm, Md, Md, Md^Xm, Md, Hhd, Ds, Ds, Wwf, Ww, Ww, Ds, Hhd, Hhd, Gg, Gd^Vhr, Chr, Chr, Yhs, Yhs^Xp, Qxe, Qxe, Chr, Gs, Gs, Gg, Rp, Rr, Rr, Gg, Gs, Gs, Re, Re, Qxe, Gs, Gs, Re^Es, Re^Dr, Gd, Re^Es, Gs, Gs, Gs^Es, Gs, Gs, Hhd, Gs, Gg, Hhd, Hhd^Fdw, Md, Md, Md^Xm, Md^Xm, Md, Hh, Hh, Mm, Md, Md^Xm, Md, Md^Xm, Md^Xm
Md^Xm, Md, Md^Xm, Md^Xm, Md, Hhd, Hhd, Hhd, Ww, Ww, Hhd, Hhd, Md, Md, Hhd, Hhd, Ch, Yhs, Yhs^Xp, Yhs^Xp, Yhs, Qxe, Chr, Ch, Gs^Fdw, Gg, Gs, Rp, Rp, Gg, Gg, Re, Rd, Re, Gg, Gg, Gs, Gd^Es, Re^Es, Gd, Gg, Gg, Gg, Gs, Gs, Hhd, Hhd, Gg, Hhd^Fmw, Hhd, Hhd, Md, Md, Md, Md, Md, Mm, Hh, Md, Md, Md^Xm, Md^Xm, Md^Xm, Md^Xm
Md^Xm, Md^Xm, Md^Xm, Md^Xm, Md, Md, Ww, Ww, Ww, Hhd, Hhd, Md, Md, Md, Md, Hhd, Gg, Yhs, Qxe, Qxe, Ch, Qxe, Gg, Gg, Gs^Fdw, Gg, Gs, Re, Re, Rp, Re, Re, Re, Gs, Gs, Gs, Gs, Gg, Gg, Gs, Gs, Gg, Gg, Gg, Gs, Gg, Hhd, Hhd^Fdw, Hhd^Fmw, Md, Hhd, Md, Md, Md, Md, Md^Xm, Md, Mm, Md, Md, Md^Xm, Md^Xm, Md^Xm, Md^Xm
Md^Xm, Md^Xm, Md^Xm, Md, Md, Md, Ww, Ww, Ww, Md, Md, Md, Md, Md, Md, Hhd, Gg, Gg, Gg, Gg, Gg, Gg, Gll^Fp, Gd^Fmw, Gg, Gs^Fdw, Gg, Gs, Gg, Re, Re, Re, Re, Gg, Gg, Gg, Gs, Gs, Gg, Gs, Gg, Gg, Gg, Gg, Gg, Gg, Gg, Hhd, Md, Md, Md, Md, Md, Md, Mm, Md, Md, Md, Md^Xm, Md^Xm, Md, Md, Md^Xm, Md^Xm
