border_size=1
usage=map

Xu, Xu, Xu, Xu, Xu, Xu, Xos, Xos, Xos, Xos, Xos, Xos, Xos, Xos, Xos, Xos, Rrc, Rrc^Es, Rrc, Rrc, Xu, Xu, Xu, Xu, Uh, Uu
Xu, Xu, Xu, Xu, Uu^Ii, Uu, Uu, Xos, Xu, Xos, Xos, Xos, Xos, Xos, Xu, Xu, Rrc^Es, Rrc^Es, Uu, Xu, Xu, Xu, Xu, Xu, Uh, Uh
Xu, Xu, Uu, Xu, Uu^Ii, Uu^Ii, Xu, Xu, Xu, Xos, Xu, Xu, Xu, Uu, Xu, Xu, Rrc, Rrc^Ii, Rrc^Es, Xu, Xos, Xu, Xu, Xu, Xu, Xu
Xos, Xu, Uu, Xu, Uu^Ii, Uu, Xu, Xu, Xu, Xu, Xu, Xu, Xu, Uu, Uu, Rrc, Xu, Rrc^Es, Rrc^Es, Rrc^Es, Rrc, Xos, Xos, Xu, Xu, Xu
Xos, Xos, Xos, Uu, Uu, Xu, Xu, Xu, Xu, Xu, Xos, Xu, Xu, Xu, Rrc, Rrc^Es, Xu, Xu, Uu, Rrc, Rrc, Rrc^Ii, Rrc, Xos, Xos, Xu
Rrc, Xos, Xu, Xos, Xos, Xu, Xos, Xu, Xos, Xos, Uu^Es, Xu, Uh, Xu, Xu, Xu, Xu, Xu, Xu, Uu, Uu, Rrc^Ii, Rrc^Ii, Xos, Xos, Xos
Rrc, Rrc^Es, Rrc^Es, Xu, Xu, Xu, Uh^Ii, Xos, Uu, Uu, Rrc^Dr, Rrc, Rrc, Xu, Xu, Xu, Xu, Xu, Xu, Xu, Xos, Rrc, Rrc, Rrc, Rrc, Xos
Xos, Rrc^Es, Rrc^Zz/, Xu, Rrc, Uu^Es, Uu, Uu, Uh, Uh, Rrc^Es, Rrc, Qxua, Qxua^Ii, Qxua, Xu, Xu, Xu, Xu, Xos, Uu, Rrc^Es, Rrc, Rrc^Es, Rrc, Rrc
Xos, Xos, Xos, Rrc^Es, Qxu, Rrc^Es, Rrc^Es, Rrc^Ii, Rrc^Ii, 2 Rrc, Rrc^Es, Rrc, 1 Rrc^Ii, Qxua, Rrc^Es, Rrc^Ii, Xu, Uu, Uu, Xos, Uu, Rrc^Es, Rrc^Ii, Xos, Xos, Rrc
Xos, Xos, Xos, Xos, Qxu, Qxu, Rrc^Ii, Rrc^Ii, Rrc^Dr, Uh, Uu, Rrc, Rrc^Ii, Rrc^Ii, Rrc^Dr, Rrc^Dr, Qxu, Xu, Rrc, Xos, Rrc^Zz\, Rrc^Es, Rrc, Xos, Xos, Xos
Uu, Xos, Xos, Xos, Qxu, Qxu, Uh^Ii, Uh^Ii, Xu, Uh, Uh, Rrc, Rrc, Rrc^Es, Rrc, Xu, Qxu, Xu, Rrc^Es, Rrc^Ii, Rrc^Ii, Rrc^Zz\, Xos, Xos, Xos, Xos
Uu^Ii, Uu^Ii, Xu, Xu, Xu, Qxu, Qxu, Xu, Xu, Xos, Xos, Rrc^Es, Rrc^Es, Xos, Uu^Ii, Qxu, Qxu, Uu, Xu, Rrc^Ii, Xu, Rrc, Rrc, Xu, Xu, Xos
Uu^Ii, Uu^Ii, Uh^Ii, Xu, Xu, Qxu, Qxu, Xu, Xu, Xu, Xos, Rrc^Zz\, Rrc^Zz\, Xos, Uu^Dr, Qxu, Uu, Xu, Xu, Xu, Xu, Xu, Rrc^Ii, Rrc^Es, Xu, Xu
Uh, Uu^Ii, Uh^Ii, Uu^Ii, Uu^Ii, Xu, Uh, Qxu, Xu, Xu, Xu, Uu^Ii, Uu, Xu, Uu, Uh, Xu, Uu, Xu, Wwf, Wwf, Xu, Xu, Rrc^Dr, Rrc, Rrc
Xu, Xu, Xu, Uh^Ii, Uu^Ii, Uu, Uu, Qxu, Uu, Xu, Xu, Xu, Uu, Uu, Xu, Uh, Xu, Qxu, Qxu, Wwg, Wwg, Wwg, Wwg, Uu, Uu^Ii, Rrc
Xu, Xu, Xu, Uu^Ii, Uu^Ii, Xu, Xu, Uu, Uu, Xu, Uu, Uh, Uh, Xu, Qxu, Xu, Xu, Qxu, Qxu, Qxu, Uu, Wwf^Ii, Wwg, Uu^Ii, Uu^Ii, Uu
Xu, Xu, Xu, Xu, Xu, Xu, Xu, Xos, Xos, Xu, Xu, Uu^Dr, Uu^Ii, Uh^Ii, Uu, Xu, Qxu, Qxu, Qxu, Uu, Uu, Ss^Ii, Wwg, Wwg, Wwg^Ii, Uu
Xos, Xu, Xos, Xu, Xu, Xu, Xu, Xos, Xos, Xos, Xu, Xu, Uu^Ii, Uh^Ii, Uu, Uu, Uu, Qxu, Xu, Xu, Uu, Ss, Ss, Wwg, Wwf, Uu
Xu, Xos, Xos, Xos, Xos, Xu, Xu, Xu, Xu, Xu, Xu, Uh^Ii, Uh^Ii, Uh^Ii, Uu, Uh, Wwf, Wwf^Ii, Uu^Ii, Xu, Uh^Ii, Xu, Xu, Wwg, Wwf, Wwg
Xu, Xu, Uu, Xos, Xos, Xos, Xos, Xu, Uu, Uh, Uu^Ii, Uh^Ii, Uu^Ii, Uu^Ii, Xu, Xu, Xu, Wwf, Wwf, Uu^Ii, Uu^Ufi, Xu, Xu, Xu, Uu^Dr, Wwf
Xos, Uu, Uu^Ii, Xu, Uu^Ii, Xos, Xos, Xos, Xu, Uu^Dr, Uh, Xu, Xu, Xu, Xu, Xu, Xos, Xu, Wwf, Uu^Ii, Uu^Uf, Uu^Ufi, Xu, Xu, Xu, Uu
Xos, Xos, Xos, Uu^Ii, Uu^Ii, Uu, Uu, Xos, Xos, Xu, Uu, Uh, Uh, Xu, Xu, Xos, Xos, Xu, Wwf, Wwf, Uu, Uu^Uf, Uu^Uf, Xu, Xu, Uu
