Gll^Fp, Gs, Ss, Ss, Gs, Gs, Gs, Gs, Gll^Fp, Hh, Hh, Mm, Mm, Mm, Hh, Qxe, Hh, Mm, Mm, Mm, Hh, Hh, Hh, Hh, Mm, Mm^Xm, Mm^Xm, Xue, Xue, Xue, Xue, Xue, Xue, Xue, Mm^Xm, Mm, Hh, Qxe, Qxe, Qxe
Gll^Fp, Chr, Ss, Sm, Gg^Dr, Gll^Fp, Gd^Fmw, Gll^Fdw, Gll^Fmw, Hh, Hh, Mm, Hh, Hh, Qxe, Qxe, Hh, Mm, Hh, Hh, Hh, Hh, Hh, Hh, Mm, Mm^Xm, Mm^Xm, Xue, Xue, Xue, Xue, Xue, Xue, Mm^Xm, Mm, Mm, Qxe, Qxe, Qxe, Mm^Xm
Chr, Chr, Sm, Ss, Ss, Gll^Fp, Ss, Ss, Ss, Gll^Fp, Hh, Hh, Hh, Qxe, Hh, Hh, Hh^Fp, Hh, Gll^Fp, Hh, Mm, Mm, Mm^Xm, Mm, Mm^Xm, Mm^Xm, Xue, Xue, Xue, Xue, Xue, Xue, Xue, Mm^Xm, Mm, Qxe, Qxe, Qxe, Mm, Mm^Xm
Gll^Fp, Sm, Sm, Gll^Fp, Gll^Fp, Ss, Chr, Chs, Ss, Gll^Fmw, Gd^Fmw, Hh, Qxe, Qxe, Hh, Hh, Hh^Fp, Gll^Fmf, Gll^Fp, Hh, Mm, Mm, Mm, Mm^Xm, Mm^Xm, Mm^Xm, Xue, Xue, Xue, Xue, Xue, Xue, Xue, Xue, Qxe, Qxe, Mm, Mm, Mm^Xm, Mm^Xm
Gd^Fmw, Gll^Fp, Gll^Fmf, Gll^Fp, Gd^Fmw, Ss, Chr, Ss, Ss, Gll^Fp, Gll^Fp, Hh, Hh, Hh, Hh, Gd^Fmw, Gll^Fmf, Gd^Fmw, Hh, Hh, Mm, Mm, Mm, Mm, Mm^Xm, Mm^Xm, Xue, Xue, Xue, Xue, Xue, Xue, Xue, Xue, Qxe^Xo, Qxe, Mm^Xm, Mm, Mm^Xm, Mm^Xm
Hh, Hh, Gd, Gll^Fmw, Gll^Fdw, Chr, Chr, Gll^Fp, Ss, Gll^Fmw, Hh, Hh, Gg, Gg, Gll^Fp, Gd^Fmw, Gll^Fp, Gll^Fp, Hh, Hh, Hh, Hh, Mm, Mm, Hh, Mm, Uhe, Uhe, Cud, Wwf, Wwf, Xue, Uhe, Qxe, Qxe, Xue, Xue, Mm^Xm, Xue, Xue
Hh, Gs, Qxe, Qxe, Gg, Gs, Gd, Gll^Fp, Re^Vhcr, Ss, Gll^Fp, Chr, Chr, Gg, Gg, Gll^Fp, Gd^Fmw, Hh, Gg, Hh, Hh, Hh, Hh, Hh, Gs, Hh, Gs, Uue, Uue, Uue, Wwf, Uhe, Qxe, Qxe, Xue, Xue, Xue, Xue, Xue, Xue
Gs, Gs, Qxe, Gs, Re^Vhcr, Gs, Gg, Gs, Rp, Gg, Gg, Chr, Chr, Gg, Gg^Es, Gg, Gg, Gg, Gg, Gg, Gg, Gg, Gs, Gs, Gg, Gs, Re, Uue, Re^Em, Re, Uue, Re^Em, Uhe, Xue, Xue, Xue, Xue, Xue, Xue, Xue
Gg, Qxe, Gs, Re, Rp, Gg, Ch, Rp, Rp, Gg, Re^Es, Gg, Gg, Gg^Es, Re^Dr, Gg, Re, Gd, Re, Gd, Gg, Gg, Gg, Gg, Hh, Re, Uue, Wwf, Uue, Re, Uue^Em, Uue, Uue, Cud, Wwf, Xue, Xue, Xue, Xue, Xue
Chr, Gs, Gll^Fp, Re, Rp, Ch, 1 Khr, Chr, Rp, Re, Re^Dr, Rp, Rp, Rp, Re^Es, Re, Rp, Gs, Gg, Gg, Gg, Gg, Hh, Hh, Mm, Mm, Xue, Wwf, Xue, Cud, Uhe, Wwf, Wwf, Uue^Em, Uue^Emf, Uhe, Xue, Xue, Xue, Xue
Chr, Hh, Gll^Fp, Gg, Gg, Chr, Chr, Ch, Rp, Gg, Chr, Gg, Gg, Gg, Gg, Gg, Rp^Vhcr, Gg, Hh, Hh, Gg, Gg, Hh, Mm, Mm^Xm, Xue, Xue, Xue, Xue, Xue, Uhe, Wwf, Re, Re, Uue, Uue, Uhe, Xue, Xue, Xue
Hh, Gll^Fp, Gll^Fp, Gs, Hh, Gs, Gg, Gg, Re^Vhcr, Gg, Qxe, Qxe, Chr, Hh, Hh, Gg, Gg, Gs, Hh, Mm, Hh, Hh, Mm^Xm, Mm^Xm, Mm^Xm, Xue, Ww, Xue, Xue, Xue, Uhe, Uue, Re, Re, Gll^Em, Uhe, Hh, Mm^Xm, Mm^Xm, Mm^Xm
Mm, Hh, Hh, Gll^Fp, Hh, Gg, Gs, Gg, Gs, Gs, Qxe, Qxe, Chr, Hh, Hh, Gg, Hh, Hh, Mm, Mm, Mm, Mm, Mm^Xm, Mm^Xm, Xue, Xue, Ww, Xue, Mm^Xm, Mm^Xm, Hh, Gll^Emf, Gll^Fp, Rp, Gll^Fp, Chr, Hh, Mm, Ww, Ww
Mm, Hh, Hh, Hh^Fp, Mm, Hh, Gg, Gll^Fp, Gll^Fmf, Hh^Fp, Qxe, Chr, Hh, Hh, Mm, Hh, Mm, Hh, Mm, Mm, Mm^Xm, Mm^Xm, Xue, Xue, Mm^Xm, Mm^Xm, Mm^Xm, Ww^Xo, Ww, Mm, Gs, Gll^Fp, Rp, Gll^Fp, Gll^Fp, Chr, Hh, Mm, Ww, Mm^Xm
Mm, Mm, Mm, Hh, Mm, Hh, Hh, Gll^Fp, Hh, Qxe, Hh, Hh^Fp, Hh, Hh, Hh, Mm, Mm, Mm^Xm, Mm^Xm, Mm^Xm, Xue, Xue, Mm^Xm, Mm^Xm, Mm, Mm, Hh^Fp, Gll^Fp, Hh, Ww, Ww, Rp, Rp^Vhcr, Gs, Gll, Gll^Fp, Ww, Ww, Mm^Xm, Mm^Xm
Mm^Xm, Mm, Mm, Mm, Mm, Mm, Mm, Hh, Mm, Hh, Hh, Hh, Hh, Hh, Hh, Mm, Mm^Xm, Mm^Xm, Xue, Xue, Mm^Xm, Mm^Xm, Hh, Mm, Hh, Hh, Gll^Fp, Gll^Fp, Ds, Wwf, Wwr, Wwf, Wwf, Ds, Wwf, Wwf, Hh, Mm, Mm^Xm, Mm^Xm
Mm^Xm, Mm^Xm, Mm, Mm, Mm, Mm^Xm, Mm^Xm, Mm, Hh, Hh, Hh, Mm, Hh, Hh, Mm, Mm, Mm^Xm, Mm^Xm, Xue, Mm^Xm, Mm^Xm, Mm, Mm, Hh, Gs, Chr, Gll^Fp, Gll^Fms, Chr, Rp, Rp, Wwf^Ewl, Gs, Wwr, Gg, Hh, Mm, Mm, Mm, Mm^Xm
Mm^Xm, Mm^Xm, Mm^Xm, Mm, Mm, Mm^Xm, Mm^Xm, Mm^Xm, Mm, Hh, Hh, Mm, Mm, Mm, Mm^Xm, Mm^Xm, Xue, Xue, Mm^Xm, Mm^Xm, Mm, Mm, Hh, Hh, Gg, Gs, Gg^Efm, Gll^Fms, Gll^Fp, Chr, Chr, Gg^Es, Rp^Vhcr, Gg^Efm, Gs, Hh, Mm, Mm, Mm^Xm, Mm^Xm
Xu, Mm^Xm, Mm^Xm, Mm^Xm, Mm^Xm, Mm^Xm, Mm^Xm, Mm, Mm^Xm, Mm^Xm, Mm^Xm, Mm^Xm, Mm^Xm, Mm^Xm, Mm^Xm, Mm^Xm, Xue, Mm^Xm, Mm, Mm^Xm, Hh, Hh, Chr, Chr, Gll^Es, Rp^Vhcr, Rp, Gg^Fet, Gll^Fp, Khr, Chr, Rp, Gg^Es, Gs, Gg, Hh, Mm, Mm, Mm^Xm, Mm^Xm
Xu, Xu, Xu, Xu, Xu, Mm^Xm, Mm^Xm, Mm^Xm, Mm^Xm, Mm^Xm, Mm^Xm, Mm^Xm, Xue, Xue, Xue, Xue, Mm^Xm, Mm^Xm, Mm, Hh, Gll^Fp, Hh, Chr, Gs, Gll^Fp, Gs^Fms, Gs, Gll^Fp, Gll^Fp, Gll^Fms, Gg^Fet, Gll^Fp, Rp, Gs, Gg, Chr, Hh, Mm, Mm, Mm
Xu, Xu, Xu, Xu, Xu, Xu, Xu, Mm^Xm, Xu, Xu, Xu, Xue, Xue, Xue, Mm^Xm, Mm^Xm, Mm, Mm, Hh, Hh, Gll^Fp, Gs, Gll^Fp, Gg^Fet, Gll^Fp, Hh^Fp, Chr, Rp, Gg, Gll^Fp, Rp^Vhcr, Gll^Fms, Gll^Fp, Gg^Efm, Chr, Chr, Mm, Hh, Hh, Mm
Xu, Xue, Xu, Xu, Xos, Xos, Xos, Xu, Xos, Xos, Xos, Xue, Xue, Mm^Xm, Mm, Mm^Xm, Hh, Hh, Hh, Gg, Gg, Gll^Es, Gll^Fp, Hh, Hh, Hh, Rp, Gll, Rp^Vhcr, Gg, Gg, Rp, Gg, Rp, Gg, Hh, Hh, Mm, Hh, Mm
Xu, Xu, Xos, Xos, Xos, Xos, Xu, Xu, Xu, Xos, Xu, Xue, Xue, Mm^Xm, Mm^Xm, Mm, Mm, Mm, Hh, Hh, Chr, Gll, Gs, Gll^Fms, Gll^Fds, Gll^Fp, Gs, Gll^Fp, Gll^Fp, Gg^Efm, Hh, Chr, Khr, Gg^Fet, Gs^Es, Gg, Hh^Fds, Mm, Mm, Mm
Xu, Xos, Xos, Xos, Uh, Uh, Qxu, Uh, Uu^Uf, Uu, Uh, Xu, Xuc, Xue, Xue, Mm^Xm, Mm^Xm, Mm, Hh, Hh, Hh, Khr, Rp, Gll^Fp, Gg^Es, Gg^Fet, Gll^Fp, Gll^Fp, Gll^Fms, Gg, Gs^Es, Gll^Fms, Gll^Fms, Gll^Fp, Khr, Gll^Fp, Gll^Fms, Hh, Mm, Mm
Xu, Xu, Xuc, Xu, Uu^Uf, Uh, Qxu, Uu^Uf, Uu, Uh, Qxu, Qxu, Qxu, Xuc, Xue, Mm^Xm, Mm^Xm, Mm, Mm, Mm, Hh, Chr, Gg, Gs, Gg, Gg, Chr, Gll^Fp, Hh, Gs, Gg, Gll^Fp, Hh^Fds, Gll^Fp, Chr, Gll^Fp, Gll^Fp, Mm, Mm, Mm^Xm
Xu, Xu, Uh, Xuc, Uu^Uf, Qxu, Urb, Uu^Es, Uu^Vu, Uu, Uu, Uh, Uu, Xuc, Xuc, Xue, Xu, Mm^Xm, Mm^Xm, Mm, Mm, Hh, Hh, Hh^Fp, Gs, Gs, Gg, Hh^Fp, Hh, Hh, Hh^Fp, Gg, Gg, Chr, Hh, Hh, Hh, Mm, Mm^Xm, Mm^Xm
Xu, Uh, Uu^Uf, Uu, Uu, Rb, Cud, Rb^Es, Urb^Es, Urb, Uu, Uh, Uh, Uh, Qxu, Xuc, Xue, Mm^Xm, Mm^Xm, Mm^Xm, Mm^Xm, Mm, Mm, Gg, Gg, Gs, Hh, Hh, Mm^Xm, Mm, Hh, Gg, Gs, Gg^Efm, Gg, Hh, Mm, Mm, Mm^Xm, Mm^Xm
Wwg, Uu^Uf, Uu^Vud, Urb, Cud, Cud, 2 Kud, Cud, Rb^Em, Urb, Uu^Vud, Uu, Uu, Qxu, Qxu, Xu, Xu, Xue, Xue, Mm^Xm, Mm^Xm, Mm^Xm, Mm^Xm, Hh, Gg, Gs, Mm^Xm, Mm^Xm, Xue, Mm^Xm, Mm^Xm, Hh, Gg, Gg, Hh, Hh, Mm, Mm, Mm^Xm, Xue
Wog, Wwf, Uu, Uu, Wwf, Wwf, Cud, Cud, Urb^Es, Rb, Urb, Uu, Cud, Qxu, Qxu, Uh, Xu, Xu, Xu, Xue, Xue, Mm^Xm, Mm^Xm, Mm^Xm, Mm^Xm, Mm^Xm, Xue, Xue, Xue, Xue, Xue, Mm^Xm, Mm^Xm, Hh, Mm^Xm, Mm^Xm, Mm^Xm, Mm^Xm, Xue, Xue
Wog, Wwg, Wwg, Uu, Wwf, Cud, Urb, Rb^Es, Urb, Rb^Em, Uu^Emf, Cud, Urb, Uu^Es, Uu, Uh, Uh, Xu, Xu, Xu, Xu, Xue, Xue, Xue, Uue, Re, Xue, Xue, Xue, Xue, Uue^Ii, Uhe, Re, Mm^Xm, Xue, Xue, Xue, Xue, Xue, Xue
Xu, Wwg, Wog, Wwf, Cud, Urb, Uu, Uu^Vud, Uu, Uu^Uf, Uu^Uf, Cud, Uu, Urb^Em, Ur, Uh, Uu, Xu, Xu, Xu, Xu, Xu, Uu^Uf, Xu, Uu, Re^Ii, Uhe, Xue, Uu, Uu, Uue, Uue, Uhe, Xue, Xue, Xue, Xue, Xue, Xue, Xue
Xu, Wog, Wog, Wwg, Uu, Cud, Cud, Uh, Qxu, Uu^Emf, Uh, Qxu, Qxu, Uu^Uf, Uu^Uf, Ur, Uu, Xu, Xuc, Xuc, Xuc, Uh, Uu^Uf, Uh, Ur, Uu^Ii, Uu, Re, Uu, Re, Uue, Re, Xue, Xue, Xue, Xue, Xue, Xue, Xue, Xue
Wog, Wog, Xu, Xu, Uu, Uu, Uu, Qxu, Qxu, Uh, Uh, Qxu, Xu, Uu^Uf, Uu^Uf, Uh, Uu, Uu, Uu, Xuc, Ur, Uu^Uf, Uu, Ur, Uu, Uh, Xu, Uu, Uh, Uu, Re^Ii, Uue, Xue, Xue, Xu, Xue, Xue, Xue, Xue, Xue
Wog, Wwg, Xu, Xu, Uh, Urb, Uu^Es, Qxu, Xu, Xu, Xos, Xos, Xu, Xu, Uh, Uu^Em, Uu^Ii, Ur, Ur^Es, Uu, Uu, Uu, Uu^Ii, Uu, Uh, Uu^Uf, Xu, Uh, Uu, Re, Xu, Xu, Xuc, Xu, Xu, Xu, Xue, Xue, Xue, Xue
Xu, Xu, Xu, Xu, Uh, Urb, Urb, Uu, Xos, Xos, Xu, Xu, Xu, Xu, Qxu, Uu^Vud, Qxu, Uu, Uu^Em, Uu, Ur, Uu, Xu, Uu, Uu^Vu, Uu, Uu, Ur^Em, Ur, Uu^Em, Uu, Uh, Uh, Xuc, Xu, Xu, Xue, Xue, Xue, Xue
Xu, Xu, Xu, Xu, Xu, Uu, Uu^Zz/, Urb^Zz/, Uu, Xuc, Xuc, Xu, Xu, Qxu, Qxu, Qxu, Qxu, Uh, Qxu, Ur, Uu, Xuc, Xuc, Uu, Ur^Es, Ur, Cud, Cud, Cud, Uu, Uu^Vu, Uu, Xu, Xu, Xu, Xu, Xue, Xue, Xue, Xue
Xu, Xu, Xu, Xu, Xos, Xos, Uh, Urb^Es, Urb, Uu^Ufi, Uu^Uf, Xu, Cud, Uh, Uu, Qxu, Uu, Qxu, Xu, Xu, Xu, Xuc, Xuc, Uu, Uu^Em, Ur^Em, Cud, 3 Kud, Cud, Uu^Ii, Uu, Uu, Uh, Xu, Xu, Xu, Xue, Xue, Xue, Xue
Xu, Xu, Xu, Xu, Xos, Xos, Xu, Uh, Uu, Uu, Ur, Uu, Uu^Uf, Uu, Urb^Ii, Uh, Uu, Cud, Xu, Xu, Xu, Xu, Xu, Uu^Vud, Xu, Uu, Uu, Cud, Ur, Uu, Uh, Xu, Xu, Xu, Xos, Xu, Xue, Xue, Xue, Xue
Xu, Xu, Xu, Xu, Xos, Xos, Xu, Xu, Qxu, Uu^Vu, Uu^Uf, Ur, Uu, Uh, Ur, Uh, Xu, Xu, Xu, Xu, Xu, Xu, Uh, Xu, Xu, Xu, Uu, Ur, Ur^Em, Uu, Uu^Uf, Uh, Xu, Xos, Xos, Xu, Xue, Xue, Xue, Xue
Xu, Xu, Xu, Xu, Xu, Xu, Xu, Qxu, Xu, Xu, Cud, Uu, Uu, Ur, Uu, Uu, Cud, Xu, Xu, Xu, Xu, Uh, Uu^Uf, Uu^Uf, Uu^Em, Uu, Uu^Uf, Uu^Emf, Uu^Vu, Uu^Em, Uu^Uf, Uu^Uf, Uh, Xos, Xos, Xu, Xue, Xue, Xue, Xue
Xue, Xue, Xue, Xu, Xu, Xu, Xu, Qxu, Xu, Xu, Xu, Uu, Uh, Uu, Uue, Uhe, Cud, Xuc, Xu, Xu, Xu, Uh, Uh, Uu^Ufi, Uu^Uf, Xu, Uu^Uf, Uu^Uf, Uu^Ufi, Uu^Uf, Uu^Emf, Uh, Uh, Xos, Xos, Xu, Xue, Xue, Xue, Xue
Xue, Xue, Xue, Xue, Xue, Xue, Xue, Xu, Xu, Xu, Xu, Uu^Ii, Uh, Ur, Re, Uue, Xue, Xu, Xue, Xu, Xue, Xu, Xue, Uu^Uf, Xu, Xu, Uh, Uu^Uf, Uu^Uf, Uu^Uf, Uh, Uu^Ufi, Uh, Xos, Xos, Xu, Xue, Xue, Xue, Xue
Xue, Xue, Xue, Xue, Xue, Xue, Xue, Xue, Xue, Xue, Xue, Xue, Xue, Uue, Re^Xo, Uue^Xo, Uue^Uf, Xue, Xue, Xue, Xue, Xue, Xue, Xue, Xos, Xos, Xos, Uh, Xu, Uh, Xu, Uu^Uf, Xu, Xos, Xos, Xu, Xue, Xue, Xue, Xue
Xue, Xue, Xue, Xue, Xue, Xue, Xue, Xue, Xue, Xue, Mm^Xm, Xue, Xue, Uue^Xo, Uue, Uue, Re^Es, Uhe, Xue, Xue, Mm^Xm, Mm^Xm, Mm^Xm, Xue, Xu, Xos, Xos, Xos, Xos, Xu, Xue, Xu, Xue, Xos, Xu, Xu, Xue, Xue, Xue, Xue
Xue, Xue, Xue, Xue, Xue, Xue, Xue, Xue, Mm^Xm, Mm^Xm, Mm^Xm, Mm^Xm, Mm, Xue, Hh, Uue, Re, Uue, Gg^Es, Mm, Mm, Mm^Xm, Mm^Xm, Mm^Xm, Mm^Xm, Xu, Xu, Xos, Xos, Xue, Xue, Xue, Xue, Xu, Xue, Xue, Xue, Xue, Xue, Xue
Xue, Xue, Wo, Wo, Wo, Xue, Xue, Xue, Mm^Xm, Mm^Xm, Mm, Mm, Hh, Mm, Gg, Gs^Es, Re, Re^Es, Gg, Hh, Hh, Mm, Hh^Fp, Mm, Mm^Xm, Mm^Xm, Mm^Xm, Xu, Xue, Xue, Xue, Xue, Mm^Xm, Xue, Xue, Xue, Xue, Xue, Xue, Xue
Xue, Xue, Xue, Wo, Wo, Xue, Xue, Mm^Xm, Mm^Xm, Mm, Hh, Hh^Fp, Hh, Hh, Gg, Gg, Gs, Gg, Gll^Fp, Gg, Gg, Hh^Fms, Gll^Fp, Hh, Mm, Mm^Xm, Mm^Xm, Mm^Xm, Mm^Xm, Mm^Xm, Mm^Xm, Mm^Xm, Mm^Xm, Mm^Xm, Mm^Xm, Xue, Xue, Xue, Xue, Xue
Xue, Xue, Xue, Wo, Wo^Xo, Xue, Mm^Xm, Mm^Xm, Mm, Hh, Hh^Fp, Hh^Fp, Hh^Fp, Hh, Gg, Gd^Es, Re, Gll^Fp, Gll^Fp, Gg, Gg, Gll^Fp, Gll^Fp, Hh, Hh^Fp, Mm^Xm, Mm, Mm^Xm, Mm^Xm, Mm^Xm, Mm^Xm, Mm^Xm, Mm^Xm, Mm^Xm, Mm^Xm, Xue, Mm^Xm, Xue, Mm^Xm, Xue
Mm^Xm, Xue, Xue, Wo^Xo, Wo, Mm^Xm, Mm^Xm, Mm^Xm, Mm, Mm, Hh, Gll^Fp, Gll^Fp, Gg, Gg, Gll^Fp, Re, Re, Gg, Gll^Fp, Gg, Gg, Gll^Fp, Gs^Fms, Hh, Mm, Mm, Mm^Xm, Mm^Xm, Mm^Xm, Mm^Xm, Mm^Xm, Mm^Xm, Mm^Xm, Mm^Xm, Mm^Xm, Mm^Xm, Mm^Xm, Mm, Mm^Xm
Mm^Xm, Mm^Xm, Mm^Xm, Wo, Wo, Ww, Mm, Mm, Mm, Hh, Hh^Fp, Gll^Fms, Gll^Fp, Gs, Gs, Gs, Re, Gll^Fp, Gg, Gg, Gg, Gll^Fp, Gg, Gll^Fp, Hh^Fp, Hh, Mm, Mm, Mm^Xm, Mm, Mm^Xm, Mm^Xm, Mm^Xm, Mm^Xm, Mm, Mm^Xm, Mm, Mm, Mm^Xm, Mm^Xm
Mm^Xm, Mm^Xm, Mm^Xm, Mm, Ww, Wo, Ww, Mm, Hh^Fp, Hh^Fp, Hh, Gll^Fp, Gg, Gll^Fp, Re, Gg^Es, Gg^Efm, Gg, Gg, Gg, Gll^Fp, Re, Gg, Gll^Fp, Gll^Fp, Hh^Fp, Mm, Mm, Mm, Mm, Mm^Xm, Mm^Xm, Mm^Xm, Mm, Mm, Mm, Mm, Mm, Mm, Mm
Mm, Mm^Xm, Mm, Mm, Hh, Wo, Wo, Hh^Fp, Hh^Fp, Hh^Fp, Gg, Gg, Gg, Gll^Fp, Gs, Gg, Gg^Efm, Gg, Gg, Gll^Fp, Gll^Fp, Re, Re, Gll^Fp, Gs^Fms, Hh, Hh^Fp, Mm, Mm, Hh, Mm, Mm^Xm, Mm, Mm, Hh, Hh, Hh, Mm, Hh, Mm
Hh, Mm, Mm, Hh, Hh, Ww, Wo, Ww^Ewl, Gll^Fp, Gll^Fp, Gll^Fp, Gg, Gll^Fp, Re, Gg, Gg, Gg, Gg, Gs, Gg, Gs, Gs, Gg, Gg, Gll^Fp, Hh^Fp, Gll^Fp, Hh^Fp, Hh, Hh, Mm, Mm^Xm, Mm, Hh, Hh^Fp, Hh^Fp, Hh, Hh, Hh, Mm
Hh^Fp, Hh, Hh, Mm, Hh, Hh^Fp, Wwr, Ww, Wo, Gll^Fp, Gll^Fp, Gll^Fp, Gll^Fp, Gll^Fp, Re, Gll^Fp, Gg, Gg, Gs, Gg^Es, Re, Gg, Gg, Gll^Fp, Gll^Fp, Gll^Fp, Gll^Fp, Hh, Hh^Fp, Hh, Mm, Mm, Mm, Hh, Hh, Hh, Hh^Fp, Mm, Mm, Mm
Hh^Fp, Hh^Fp, Hh, Hh, Hh^Fp, Gll^Fp, Gll^Fp, Ww^Ewl, Wo, Ww, Wwr, Gll^Fms, Gll^Fp, Gll^Fp, Gll^Fp, Gg, Gs^Es, Re, Gg, Gg, Gg, Gg, Gs, Gs, Gg, Gg, Gll^Fp, Gll^Fp, Hh, Hh, Hh^Fp, Hh, Hh, Mm, Hh, Hh^Fp, Hh^Fp, Hh, Mm, Mm^Xm
Mm, Hh^Fp, Hh^Fp, Hh^Fp, Hh^Fp, Gll^Fp, Gs^Es, Hh, Hh, Ww, Wwf^Es, Gll^Fp, Gll^Fp, Gll^Fp, Gll^Fp, Gs, Re, Re, Gll^Fp, Gg, Gg, 5 Gg, Gg, Gg, Gll^Fp, Gll^Fp, Gll^Fp, Gll^Fp, Gll^Fp, Gll^Fp, Hh^Fp, Hh, Hh^Fp, Mm, Hh, Hh, Hh, Hh, Mm^Xm, Mm^Xm
Mm^Xm, Hh, Hh, Gll^Fp, Gll^Fp, Gll^Fp, Gs, Gg, Gs, Ds, Ww, Ww^Es, Ww, Gll^Fp, Gll^Fp, Gll^Fp, Re, Re, Gll^Fp, Gg, Gg, Gg, Gg, Re, Gs, Gg, Gll^Fp, Gll^Fms, Gll^Fp, Gll^Fp, Hh, Hh, Gll^Fp, Hh, Hh^Fp, Hh^Fp, Hh, Hh^Fp, Mm, Mm^Xm
Mm, Mm, Hh, Hh^Fp, Hh, Gll^Fp, Gs^Fp, Gll^Fp, Gll^Fp, Gs, Gll^Fp, Wo, Wo^Ewl, Ww, Gll^Fp, Gll^Fp, Gll^Fp, Gg, Gg, Gg, Gll^Fp, Gg, Gg, Gs, Re, Gll^Fp, Gll^Fp, Gll^Fp, Gll^Fp, Gg, Gll^Fp, Gll^Fp, Gll^Fms, Hh^Fp, Hh^Fp, Hh, Hh, Hh, Mm, Mm
Hh, Mm, Hh, Hh^Fp, Hh, Gll^Fp, Gll^Fp, Gll^Fms, Gll^Fp, Gll^Fp, Gll^Fp, Ww^Ewl, Wwr, Wwr, Re, Gll^Fp, Gg, Gll^Fp, Gll^Fp, Gg, Gll^Fp, Gs, Gg, Gg, Gg, Re, Gg, Gg, Gll^Fp, Gg, Gg, Gll^Fp, Gll^Fp, Gll^Fp, Hh^Fp, Hh, Hh, Mm, Mm^Xm, Mm^Xm
Mm, Hh, Mm, Hh, Hh, Hh, Hh^Fp, Gll^Fp, Gll^Fp, Gs, Gs, Gll^Fp, Wwr, Wwf^Es, Ww^Ewl, Gll^Fp, Ds, Gll^Fp, Gg, Gs, Gg, Gg, Gg^Efm, Gg, Re, Gg, Gs, Re^Es, Gg, Gg, Gll^Fp, Gll^Fp, Hh^Fp, Hh, Hh, Hh, Hh^Fp, Mm, Mm^Xm, Mm^Xm
Mm, Hh, Mm, Mm, Hh, Hh^Fp, Hh, Gll^Fp, Gll^Fp, Gs, Gs, Gg, Ds, Wwf^Es, Wwr, Wo, Wo, Ds, Gg, Gs^Es, Gs, Gg, Gg, Gg, Gs^Es, Gs, Gs, Gg, Gg, Gg, Gll^Fms, Gll^Fms, Hh^Fp, Hh, Gll^Fp, Hh^Fp, Hh, Hh, Mm, Mm^Xm
Mm, Mm, Mm, Hh, Hh, Hh, Gll^Fp, Gll^Fp, Gll^Fp, Gll^Fp, Gll^Fp, Gll^Fp, Gd^Esd, Ds, Ds, Wo, Wo, Wo, Wo, Gg, Gs, Gg, Gg, Re, Gg, Gg, Gll^Fp, Gll^Fp, Gll^Fp, Gll^Fp, Hh^Fp, Hh^Fp, Gll^Fp, Gll^Fp, Gll^Fp, Hh^Fp, Hh, Hh, Hh, Mm
Hh, Mm, Hh, Hh, Gll^Fp, Gg, Gll^Fp, Gll^Fp, Gg, Gs, Gg, Gg, Re, Ds, Re^Esd, Ds^Esd, Ds, Ww, Wwf^Ewl, Ds, Gg, Gg, Gg, Gg, Gg, Gg, Gg, Gg, Gg, Gg, Hh, Hh, Gg, Gg, Gg, Gg, Hh, Hh, Hh, Hh
Hh, Hh, Gll^Fp, Hh^Fp, Gll^Fp, Gg, Gll^Fp, Gll^Fp, Gg, Gs, Gg, Re, Gs, Gg, Gs, Gs^Esd, Ds, Ww^Es, Wwr, Ds, Ds^Esd, Gg, Gll^Fp, Gll^Fp, Gg, Gg, Gg, Gg, Gg, Gg, Gg, Gg, Hh^Fp, Gg, Gg, Gg, Gg, Mm, Mm, Mm
Gg, Hh, Hh, Gll^Fp, Gll^Fp, Gll^Fp, Gg, Gg, Re, Re, Gg, Re, Gll^Fp, Gll^Fp, Gll^Fp, Gg, Gg, Wwf, Ww, Ww, Gg, Gg, Gll^Fp, Gll^Fp, Gg, Gll^Fp, Gll^Fp, Gll^Fp, Gg, Gg, Gg, Gg, Gll^Fp, Hh, Mm, Hh, Hh, Hh, Mm, Mm
Gll^Fp, Gll^Fp, Gll^Fp, Gll^Fp, Gg, Gg, Gg, Gg, Re, Gg, Re, Gll^Fp, Gg, Gg, Gll^Fp, Gll^Fp, Gll^Fp, Gg, Ww, Wo, Wo, Gg, Gg, Gg, Gg, Hh, Hh^Fp, Gll^Fp, Gll^Fp, Gg, Gg, Gll^Fp, Gg, Hh, Hh, Mm, Mm, Hh, Hh, Mm
