border_size=1
usage=map

Hh^Fp, Hh^Fp, Hh^Fp, Hh^Fp, Hh^Fp, Hh^Fp, Gll^Fp, Gll^Fp, Hh^Fp, Hh^Fp, Hh^Fp, Hh^Fp, Hh^Fp, Gll^Fp, Gll^Fp, Gll^Fp, Gll^Fp, Gll^Fp, Gll^Fp, Gll^Em, Gg, Re, Re, Gg, Gll^Fp, Gll^Fp, Gll^Fp, Gll^Fp, Gll^Fp, Gll^Fp, Gll^Fp, Gll^Fp
Gll^Fp, Hh^Fp, Hh^Fp, Gll^Fp, Hh^Fp, Hh^Fp, Hh^Fmw, Hh^Fmw, Hh^Fmw, Hh^Fp, Hh^Fp, Hh^Fp, Gll^Fp, Gll^Fp, Gll^Fp, Gll^Fp, Gll^Em, Gll^Fp, Gs, Gll, Gg, Re, Gg, Gll^Fp, Gll^Fp, Gll^Fp, Gll^Fp, Gll^Fp, Gll^Fp, Gll^Fmw, Gll^Fp, Gll^Fp
Hh^Fp, Gll^Fp, Gll^Fp, Gll^Fmw, Gll^Fp, Hh^Fp, Hh^Fmw, Hh^Fp, Hh^Fp, Hh^Fp, Gll^Fp, Gll^Fp, Gll^Fp, Gll^Fp, Gll^Fp, Gll^Fp, Gll^Fp, Gll, Gs^Es, Gg, Gg, Re, Re, Gg, Gll^Fp, Gll^Fp, Gg, Gll^Fp, Gll^Fp, Gll^Fp, Gll^Fp, Gll^Fp
Hh^Fp, Hh^Fp, Gll^Fmw, Gll^Fmw, Gll^Fp, Gll^Fmw, Gll^Fp, Gll^Fp, Gll^Fp, Hh^Fp, Hh^Fp, Gll^Fp, Gll, Gll^Em, Gll, Gll^Fp, Gs, Gll^Fp, Gll^Fp, Gg, Re, Re, Gg, Gs, Gll^Fp, Gll^Fp, Gg, Gg, Gll^Fp, Gll^Fp, Gll^Fp, Gll
Gll^Fp, Hh^Fp, Hh^Fmw, Hh^Fp, Gll^Fp, Gll^Fmw, Gll, Gll^Es, Gs, Gll^Fp, Gg, Gll^Fp, Gg, Gg, Gg, Gg, Gg, Gs, Gg, Gg, Gg, Gg, Gs, Gs, Gll^Fp, Gll, Gll^Em, Gll^Fp, Gll^Fp, Gll^Fp, Gll^Em, Gll^Em
Gll^Fp, Gll^Fp, Hh^Fp, Hh^Fp, Gll^Fp, Gll, Gll^Fp, Gg, Gs, Gs, Gg, Gg^Vct, Gg, Gg, Gg^Vct, Gg, Gg, Gs, Gg, Gg, Re, Gg, Gll^Fp, Gll^Fp, Gll^Fp, Gll^Fp, Gll, Gs, Gll, Gll^Fp, Gll^Fp, Gll
Gg, Gll^Fp, Gll^Fp, Gll^Fp, Gll^Fp, Gll, Gg, Gg, Gg^Vct, Gs, Gs, Gg, Gg, Gg, Re, Re, Re, Gg, Gg, Re, Re, Gg, Gg, Gg, Gg, Gll^Fp, Gg, Gs, Gs, Gll^Fp, Gll^Fp, Gg
Gg, Gll^Fp, Gll^Fp, Gll^Fp, Gll^Fp, Gll^Fp, Gg, Gg, Gs, Gs, Ce, Ce, Ce, Re, Re, Re, Re, Gg, Re, Re, Gg, Gg, Re, Gg, Gg, Gll^Fp, Gs, Gs, Gs, Gll^Fp, Gs, Gg
Gg, Gll^Fp, Gll^Fp, Gll, Gll^Fp, Gll^Em, Gll^Fp, Gg, Gg, Gs, Ce, 1 Ke, Ce, Re, Gg^Ecf, Gg, Re, Re, Re, Gg, Gg, Gg^Vct, Re, Re, Gg, Gg, Gg, Gg, Gs, Gll^Fp, Gll^Fp, Gs
Gg, Gg, Gg, Gg, Gg, Gll, Gll, Gg, Gg^Vct, Gg, Re, Ce, Gs, Gg, Gg, Gg, Gg, Gg^Vct, Gg, Gg, Re, Gg, Gll, Re, Gll^Fp, Gg, Gg, Gg, Gg, Gg, Gll, Gll^Fp
Gll^Fp, Gll^Fp, Gll^Fp, Gg, Gg, Gs, Gs^Es, Gg, Gg, Gg, Re, Re, Gg, Gg^Vct, Gg, Gs, Re, Gg, Gg, Gg, Re, Gg, Gll, Gll^Fp, Gll^Fp, Gll, Gs, Gg, Gg^Es, Gg, Gg, Gll
Gs^Fms, Gll^Fp, Gll^Fp, Gg, Gg, Gs, Gs, Gg, Gll, Gg, Re, Re, Re, Gg, Gll^Fp, Gll^Fms, Re, Re, Gll^Fms, Gg, Re, Re, Gg, Gll^Fmw, Gs^Fmw, Gll^Fp, Gs, Gg, Gg, Gg, Gll^Fp, Gll
Gll^Fp, Gll^Fp, Gll, Gs, Gg, Gs, Gg, Gs, Gll^Fp, Gg, Gg, Re, Re, Re, Gll^Fp, Gs, Re, Gll^Fp, Gll^Fms, Gll, Gg, Re^Es, Gll, Gll^Fp, Gs^Fmw, Gll^Fp, Gll^Fp, Gll^Em, Gg, Gg, Gg, Gll^Fp
Gll^Fp, Gll^Fp, Gll, Gs, Gs, Gg, Gg, Gll, Gll^Fp, Gs, Gg, Gg, Re, Re, Gg, Re, Gll^Fms, Gll^Fmw, Gll^Fmw, Gll^Em, Gll, Gg, Gg, Gll, Gll^Fp, Gs^Fmw, Gs^Fms, Gll^Fp, Gg, Gll^Fms, Gll^Fms, Gll^Fp
Gll^Fp, Gll, Gll, Gg, Gg, Gg, Gg, Gll^Fp, Gll^Fp, Gll, Gg^Vct, Re, Re, Gs, Gg, Re, Gs, Gll^Fmw, Gll^Fmw, Gll^Fp, Gll, Gll^Fms, Gll, Gg, Gll^Fp, Gs^Fmw, Gs^Fmw, Gll^Fp, Gll^Fp, Gll^Fms, Gll^Fmw, Gll^Fp
Gg, Gg, Gg, Gg, Gg, Gg, Gll^Fp, Gll^Fp, Gll, Gg, Gg, Re, Re, Gg, Gg, Gg, Gg, Gll^Fp, Gll, Gll^Fmw, Gs^Fmw, Gll^Fms, Gll^Fms, Gll, Gg, Gll^Fp, Gll^Fp, Gll^Fp, Gll^Fp, Gll^Fmw, Gll^Fp, Gll^Fms
Gll^Fp, Gll^Fp, Gll^Fp, Gll, Gll^Fp, Gg, Gg, Gll, Re, Gg, Gg, Re, Re, Gg, Gg, Gs, Gs, Gs, Gll, Gll^Fp, Gs^Fmw, Gll^Fp, Gll^Fp, Gll^Fp, Gll, Gll^Fp, Gll, Gll^Fp, Gll^Fmw, Gll^Fmw, Gll^Fp, Gll^Fp
Gll^Fp, Gs^Fmw, Gll^Fp, Gll^Fp, Gs^Fms, Gll^Fp, Gg, Gg, Gs^Es, Gs, Gg, Gg, Re, Re, Gg, Gg, Gs, Gs, Gll^Fp, Gs^Fms, Gs^Fmw, Gll^Fmw, Gll^Fmw, Gll^Fp, Gll^Fp, Gg^Em, Gll, Gll^Fp, Gll^Fp, Gll^Fms, Gll^Fp, Gll^Fp
Gll^Fp, Gll^Fmw, Gd^Fmw, Gll^Fp, Gll^Fp, Gg, Re, Gg, Gs, Gg, Re, Gg, Re, Re, Gll^Fp, Gg, Gg, Gll, Gll^Fp, Gll^Fp, Gs^Fms, Gs^Fmw, Gs^Fms, Gll^Fp, Gll^Fmw, Gll^Fp, Gll, Gll, Gll^Fmw, Gll^Fmw, Gll^Fp, Gll^Fp
Gll^Fp, Gll^Fp, Gs^Fms, Gll^Fp, Gll, Gll^Fp, Gg, Gg, Re, Re, Re, Re, Gg, Gg, Gs^Fms, Gs, Gll, Gll^Fp, Gll^Fp, Gll^Fmw, Gll^Fp, Gs^Fmw, Gll^Fp, Gll^Fmw, Gll^Fms, Gll, Gll^Fp, Gll^Fms, Gll^Fmw, Gll^Fmw, Gll^Fms, Gll^Fp
Gll, Gll, Gll^Fp, Gll, Gg, Gg, Gg, Gg, Re, Re, Gg, Gg, Gll^Fms, Gll, Gll^Fmw, Gs^Fms, Gs, Gs^Fms, Gll^Fmw, Gll^Fmw, Gs^Fmw, Gll^Fp, Gll^Fmw, Gll^Fmw, Gll^Fmw, Gll, Gll^Fp, Gs^Fms, Gll^Fmw, Gll^Fp, Gll^Fmw, Gll^Fp
Gll, Gll, Gg, Gll, Gll, Gg, Re, Re, Re, Gg, Gg, Gg, Gll^Fms, Gll^Fmw, Gll^Fmw, Gs^Fms, Gll^Fp, Gll^Fp, Gll^Fmw, Gs^Fmw, Gll^Fmw, Gll^Fp, Gll^Fmw, Gll^Fmw, Gll, Gg, Gll^Fp, Gll^Fmw, Gll^Fp, Gll^Fmw, Gll^Fp, Gll^Fms
Gg, Gg, Gg, Gll^Fp, Gg, Gg^Es, Re, Re, Gg, Gg, Gll, Gll, Gll^Fmw, Gll^Fmw, Gll^Fmw, Gs^Fms, Gll^Fp, Gll^Fmw, Gll^Fp, Gs^Fmw, Gs^Fmw, Gs^Fms, Gll^Fmw, Gll^Fms, Gll^Fp, Gg, Gll, Gll, Gll, Gll^Fms, Gll^Fp, Gll^Fms
Gg, Gg, Gg, Gg, Gg, Re, Re, Re, Gg, Gll^Fp, Gll^Fp, Gll^Fp, Gll^Fmw, Gll^Fmw, Gll^Fp, Gll^Fmw, Gll^Fp, Gll^Fp, Gll^Fp, Gll^Fp, Gs^Fms, Gs^Fmw, Gll^Fmw, Gs^Fms, Gll^Fp, Gll^Fp, Gll^Fp, Gll, Gll, Gll^Fp, Gll^Fp, Gll^Fp
