Xu, Xu, Xu, Xu, Xu, Xu, Xu, Xu, Xu, Xu, Xu, Xu, Xu, Xu, Xu, Xu, Xu, Xu, Xu, Xu, Xu, Xu, Xu, Xu, Xu, Xu, Xu, Xu, Xu, Xu, Xu, Xu, Xu, Xu, Xu, Xu, Xu, Xu, Xu, Xu, Xu, Xu, Xu, Xu, Xu, Xu, Xu, Xu, Xu, Xu, Xu, Xu
Xu, Xu, Xu, Xu, Xu, Xu, Xu, Xu, Xu, Xu, Xu, Xu, Xu, Xu, Xu, Xu, Xu, Xu, Xu, Xu, Xu, Xu, Xu, Xu, Xu, Xu, Xu, Xu, Xu, Xu, Xu, Xu, Xu, Xu, Xu, Xu, Xu, Xu, Xu, Xu, Xu, Xu, Xu, Xu, Xu, Xu, Xu, Xu, Xu, Xu, Xu, Xu
Xu, Xu, Xu, Xu, Xu, Xu, Xu, Xu, Xu, Xu, Xu, Xu, Xu, Xu, Xu, Xu, Xu, Xu, Xoa, Xu, Xu, Xu, Xoa, Xoa, Xoa, Xu, Xoa, Xu, Xoa, Xu, Xu, Xu, Xu, Xu, Xu, Xu, Xu, Xu, Xu, Xu, Xu, Xu, Xu, Xu, Xu, Xu, Xu, Xu, Xu, Xu, Xu, Xu
Xu, Xu, Xu, Xu, Xu, Xu, Xu, Xu, Xu, Xu, Xu, Xu, Xu, Xu, Xoa, Xoa, Xoa, Xoa, Xoa, Xoa, Xoa, Xoa, Xoa, Xoa, Xoa, Xoa, Xoa, Xoa, Xoa, Xoa, Xoa, Xu, Xu, Xu, Xu, Xu, Xu, Xu, Xu, Xu, Xu, Xu, Xu, Xu, Xu, Xu, Xu, Xu, Xu, Xu, Xu, Xu
Xu, Xu, Xu, Xu, Xu, Xu, Xu, Xu, Xu, Xu, Xu, Xu, Xoa, Xoa, Xoa, Xoa, Xoa, Xoa, Urb, Xoa, Xoa, Xoa, Sm, Wwf, Wwf, Xoa, Sm, Xoa, Wwf^Es, Xoa, Xoa, Xoa, Xoa, Xu, Xu, Xu, Xu, Xu, Xu, Xu, Xu, Xu, Xu, Xu, Xu, Xu, Xu, Xu, Xu, Xu, Xu, Xu
Xu, Xu, Xu, Xu, Xu, Xu, Xu, Xu, Xu, Xu, Xoa, Xoa, Xoa, Xoa, Urb, Wwf, Wwf^Es, Wwf^Es, Urb, Urb, Urb, Urb, Urb, Urb, Wwf, Sm, Urb, Wwf, Wwf, Urb, Urb, Xoa, Xoa, Xu, Xu, Xu, Xu, Xu, Xu, Xu, Xu, Xu, Xu, Xu, Xu, Xu, Xu, Xu, Xu, Xu, Xu, Xu
Xu, Xu, Xu, Xu, Xu, Xu, Xu, Xu, Xu, Xoa, Xoa, Xoa, Rb^Es, Urb, Urb, Wwf, Wwf, Urb, Urb, Urb, Urb, Urb, Urb^Ii, Urb, Urb, Urb, Urb, Wwf, Sm, Rb, Urb, Xoa, Xoa, Xoa, Xoa, Xu, Xu, Xu, Xu, Xu, Xu, Xu, Xu, Xu, Xu, Xu, Xu, Xu, Xu, Xu, Xu, Xu
Xu, Xu, Xu, Xu, Xu, Xu, Xu, Xu, Xoa, Xoa, Xoa, Urb, Rb^Es, Urb, Urb^Ii, Urb, Urb, Sm, Xoa, Urb, Rb^Es, Urb, Urb, Urb, Urb, Urb, Urb, Urb, Urb, Rb, Rb, Urb, Xoa, Xoa, Xoa, Xu, Xu, Xu, Xu, Xu, Xu, Xu, Xu, Xu, Xu, Xu, Xu, Xu, Xu, Xu, Xu, Xu
Xu, Xu, Xu, Xu, Xu, Xu, Xoa, Xoa, Xoa, Xoa, Urb, Urb, Urb, Urb, Urb, Urb, Urb, Wwf, Urb, Urb, Urb, Urb, Urb, Urb, Urb, Urb, Urb, Xoa, Urb, Urb, Urb, Urb, Rb, Xoa, Xoa, Xoa, Xoa, Xu, Xu, Xu, Xu, Xu, Xu, Xu, Xu, Xu, Xu, Xu, Xu, Xu, Xu, Xu
Xu, Xu, Xu, Xu, Xu, Xu, Xoa, Xoa, Urb, Urb, Urb, Urb, Urb, Urb, Urb, Urb, Urb, Urb, Urb, Urb, Urb, Urb, Urb, Urb, Urb, Urb, Wwf, Urb, Urb, Urb, Urb, Rb^Es, Rb, Urb, Urb, Xoa, Xoa, Xu, Xu, Xu, Xu, Xu, Xu, Xu, Xu, Xu, Xu, Xu, Xu, Xu, Xu, Xu
Xu, Xu, Xu, Xu, Xu, Xoa, Xoa, Xoa, Urb, Urb, Xoa, Urb, Urb, Rb^Es, Urb, Urb, Urb, Urb, Urb, Urb, Xoa, Urb, Urb, Urb, Urb, Urb, Urb, Wwf, Urb, Urb^Ii, Urb, Urb, Rb^Es, Urb, Urb, Xoa, Xoa, Xoa, Xoa, Xu, Xu, Xu, Xu, Xu, Xu, Xu, Xu, Xu, Xu, Xu, Xu, Xu
Xu, Xu, Xu, Xu, Xu, Xoa, Xoa, Urb, Urb, Urb, Urb, Urb, Urb, Urb, Urb, Urb, Urb, Urb, Wwf, Urb, Urb, Urb, Urb, Urb, Urb, Urb, Urb, Wwf, 2 Urb, Urb, Urb, Urb, Xoa, Urb, Urb, Urb, Xoa, Xoa, Xoa, Xu, Xu, Xu, Xu, Xu, Xu, Xu, Xu, Xu, Xu, Xu, Xu, Xu
Xu, Xu, Xu, Xu, Xu, Xoa, Xoa, Urb, Urb, Urb, Urb, Urb, Urb, Urb, Urb, Urb, Urb, Rb^Es, Rb, Urb, Urb, Urb, Urb^Ii, Urb, Urb, Urb, Urb, Urb, Urb, Urb, Urb, Urb, Urb, Urb, Urb, Urb, Xoa, Xoa, Xoa, Xu, Xu, Xu, Xu, Xu, Xu, Xu, Xu, Xu, Xu, Xu, Xu, Xu
Xu, Xu, Xu, Xu, Xu, Xoa, Xoa, Urb, Urb, Urb, Urb, Urb^Ii, Urb, Urb, Urb, Urb, Urb, Urb, Urb, Urb, Urb, Urb, Urb, Urb, Urb, Urb, Urb, Urb, Urb, Urb, Urb, Urb, Urb, Urb, Urb, Urb, Urb, Xoa, Xoa, Xoa, Xu, Xu, Xu, Xu, Xu, Xu, Xu, Xu, Xu, Xu, Xu, Xu
Xu, Xu, Xu, Xu, Xu, Xoa, Xoa, Urb, Rb^Es, Sm, Wwf, Urb, Urb, Xoa, Urb, Urb, Urb^Ii, Urb, Urb, Urb, Urb, Urb, Urb, Urb, Urb, Urb, Urb, Xoa, Urb, Urb, Urb, Urb, Urb, Urb, Urb, Urb, Urb, Xoa, Xoa, Xoa, Xu, Xu, Xu, Xu, Xu, Xu, Xu, Xu, Xu, Xu, Xu, Xu
Xu, Xu, Xu, Xu, Xoa, Xoa, Xoa, Urb, Rb^Es, Wwf, Urb, Urb, Urb, Urb, Urb, Urb, Urb, Urb, Urb, Urb, Urb, Urb, Urb, Urb, Urb, Urb, Urb, Urb, Urb, Urb, Urb, Urb, Urb, Urb, Urb, Rb, Xoa, Xoa, Xoa, Xoa, Xu, Xu, Xu, Xu, Xu, Xu, Xu, Xu, Xu, Xu, Xu, Xu
Xu, Xu, Xu, Xoa, Xoa, Xoa, Xoa, Xoa, Xoa, Sm, Sm, Urb, Urb, Urb, Urb, Urb, Urb, Urb, Rb, Xoa, Urb, Urb, Urb, Urb, Urb, Urb, Urb, Urb, Urb, Urb^Ii, Urb, Urb, Urb, Xoa, Urb, Urb, Xoa, Xoa, Xoa, Xu, Xu, Xu, Xu, Xu, Xu, Xu, Xu, Xu, Xu, Xu, Xu, Xu
Xu, Xu, Xu, Xu, Uh, Xoa, Xoa, Xoa, Xoa, Xoa, Xoa, Urb, Urb, Urb, Urb, Urb, Urb, Rb^Es, Rb, Urb, Urb, Urb, Urb, Urb, Urb, Urb, Urb, Wwf, Urb, Urb, Urb, Urb, Rb^Es, Urb, Urb, Urb, Xoa, Xoa, Xu, Xu, Xu, Xu, Xu, Xu, Xu, Xu, Xu, Xu, Xu, Xu, Xu, Xu
Xu, Xu, Xu, Uh, Uu^Tf, Uh, Xu, Xoa, Xoa, Xoa, Xoa, Urb, Urb, Urb, Urb, Urb, Urb, Urb, Urb, Urb, Urb, Urb^Ii, Urb, Urb, Urb, Urb, Urb, Urb, Urb, Urb, Urb, Urb, Urb, Rb, Urb, Urb, Xoa, Xoa, Xu, Xu, Xu, Xu, Xu, Xu, Xu, Xu, Xu, Xu, Xu, Xu, Xu, Xu
Xu, Xu, Uu^Ii, Uu, Uu, Tb^Tf, Xu, Xoa, Xoa, Xoa, Urb^Zz\, Urb, Urb, Urb, Urb, Urb, Urb, Urb, Urb, Urb, Urb, Urb, Urb, Urb, Urb, Urb, Xoa, Urb, Urb, Urb, Urb, Urb, Urb, Rb, Wwf, Urb, Xoa, Xoa, Xu, Xu, Xu, Xu, Xu, Xu, Xu, Xu, Xu, Xu, Xu, Xu, Xu, Xu
Xu, Xu, Xu, Xu, Uu^Tf, Tb^Tf, Xu, Xu, Urb, Urb^Ebme, Urb, Urb^Zz\, Urb^Zz\, Urb, Xoa, Urb, Urb, Urb, Urb, Urb, Urb, Xoa, Urb, Urb, Urb, Urb, Urb, Urb, Urb, Urb^Ii, Urb, Urb, Xoa, Sm, Wwf^Es, Sm, Xoa, Xoa, Xoa, Xu, Xu, Xu, Xu, Xu, Xu, Xu, Xu, Xu, Xu, Xu, Xu, Xu
Xu, Xu, Xoa, Xoa, Urb, Uu, Urb, Urb, Urb, Urb, Urb, Urb, Xoa, Xoa, Xoa, Xoa, Urb, Urb, Urb, Urb, Urb, Urb, Urb, Urb, Urb, Urb, Rb, Urb, Urb, Urb, Urb, Urb, Sm, Wwf, Wwf, Xoa, Xoa, Xoa, Xoa, Xoa, Xoa, Xu, Xu, Xu, Xu, Xu, Xu, Xu, Xu, Xu, Xu, Xu
Xoa, Xoa, Xoa, Uh, Urb, Urb, Uh, Urb, Urb, Urb, Xoa, Xoa, Xoa, Xoa, Xoa, Xoa, Xoa, Sm^Es, Wwf, Urb, Urb, Urb, Urb, Urb^Ii, Urb, Urb, Rb, Rb^Es, Wwf, Urb, Urb, Urb, Sm^Es, Wwf, Xoa, Xoa, Xoa, Xoa, Xu, Xoa, Xoa, Xoa, Xoa, Xu, Xu, Xu, Xu, Xu, Xu, Xu, Xu, Xu
Xoa, Xoa, Uh^Ebme, Uh, Urb, Urb, Uh, Urb, Xoa, Uh, Xu, Xoa, Xu, Xu, Xu, Xoa, Xoa, Sm^Es, Wwf^Es, Urb, Urb, Urb, Urb, Urb, Rb, Wwf^Es, Wwf, Sm, Urb, Urb, Xoa, Xoa, Xoa, Xoa, Xoa, Xoa, Urb, Xu, Xu, Xu, Xoa, Xoa, Xoa, Xoa, Xoa, Xu, Xu, Xu, Xu, Xu, Xu, Xu
Urb, Uh, Urb, Urb, Urb, Uu, Uh, Xoa, Xoa, Xoa, Xu, Xu, Xu, Xu, Xu, Xoa, Xoa, Wwf, Wwf, Sm, Urb, Xoa, Urb, Urb, Urb, Sm, Wwf, Urb, Xoa, Xoa, Xoa, Xoa, Xoa, Xoa, Urb, Urb, Urb, Urb, Urb^Eb, Xoa, Xu, Xu, Xu, Xoa, Xoa, Xoa, Xoa, Xu, Xu, Xu, Xu, Xu
Urb, 1 Urb, Urb, Urb, Uu, Uu^Tf, Xu, Xu, Xu, Xu, Xu, Xu, Xu, Xu, Xu, Xoa, Xoa, Urb, Urb, Urb, Urb, Rb, Sm, Urb, Urb, Sm^Es, Xoa, Xoa, Xoa, Xoa, Xoa, Xoa, Xu, Xu, Xu, Urb, Urb^Eb, Urb, Urb, Urb, Urb, Xu, Xoa, Xoa, Xu, Xoa, Xoa, Xoa, Xoa, Xu, Xu, Xu
Urb, Urb, Xoa, Xoa, Xoa, Xu, Xu, Xu, Xu, Xu, Xu, Xu, Xu, Xu, Xu, Xoa, Xoa, Xoa, Urb, Urb, Urb, Rb^Es, Wwf, Urb, Urb, Urb, Xoa, Xoa, Xoa, Xoa, Xoa, Xoa, Xoa, Xu, Xoa, Xoa, Xu, Urb, Urb, Urb, Urb, Urb^Eb, Urb, Xu, Xu, Xu, Xoa, Xoa, Xoa, Xoa, Xoa, Xu
Xoa, Xoa, Xoa, Xoa, Xu, Xu, Xu, Xu, Xu, Xu, Xu, Xu, Xu, Xu, Xu, Xoa, Xoa, Xoa, Xoa, Urb, Xoa, Urb, Xoa, Sm, Xoa, Xoa, Xoa, Xoa, Xu, Xu, Xu, Xoa, Xoa, Xoa, Xoa, Xu, Xu, Xu, Xoa, Urb^Eb, Urb, Urb, Urb, Urb, Urb^Eb, Xoa, Xu, Xu, Xu, Xoa, Xos^Zok, Xos^Zok
Xoa, Xoa, Xu, Xu, Xu, Xu, Xu, Xu, Xu, Xu, Xu, Xu, Xu, Xu, Xu, Xu, Xoa, Xoa, Xoa, Xoa, Xoa, Xoa, Xoa, Xoa, Xoa, Xoa, Xu, Xu, Xu, Xu, Xu, Xu, Xu, Xoa, Xoa, Xoa, Xoa, Xoa, Xu, Xu, Xu, Urb, Urb^Eb, Urb, Urb, Urb, Urb, Xu, Xos^Zok, Xos^Zok, Xu^Zok, Xos^Zok
Xu, Xu, Xu, Xu, Xu, Xu, Xu, Xu, Xu, Xu, Xu, Xu, Xu, Xu, Xu, Xu, Xu, Xu, Xu, Xoa, Xu, Xoa, Xu, Xoa, Xu, Xu, Xu, Xu, Xu, Xu, Xu, Xu, Xu, Xu, Xu, Xoa, Xoa, Xoa, Xoa, Xu, Xoa, Xoa, Xu, Urb, Urb, Urb, Urb^Zok, Urb^Zok, Urb^Zok, Xu^Zok, Xu^Zok, Xu^Zok
Xu, Xu, Xu, Xu, Xu, Xu, Xu, Xu, Xu, Xu, Xu, Xu, Xu, Xu, Xu, Xu, Xu, Xu, Xu, Xu, Xu, Xu, Xu, Xu, Xu, Xu, Xu, Xu, Xu, Xu, Xu, Xu, Xu, Xu, Xu, Xu, Xu, Xoa, Xoa, Xoa, Xoa, Xu, Xu, Xu, Xos^Zok, Urb^Zok, Urb^Zok, Urb^Zok, Urb^Zok, Urb^Zok, Urb^Zok, Xos^Zok
Xu, Xu, Xu, Xu, Xu, Xu, Xu, Xu, Xu, Xu, Xu, Xu, Xu, Xu, Xu, Xu, Xu, Xu, Xu, Xu, Xu, Xu, Xu, Xu, Xu, Xu, Xu, Xu, Xu, Xu, Xu, Xu, Xu, Xu, Xu, Xu, Xu, Xu, Xu, Xoa, Xoa, Xoa, Xos^Zok, Xos^Zok, Xu^Zok, Xu^Zok, Xu^Zok, Urb^Zok, Urb^Zok, Urb^Zok, Urb^Zok, Urb^Zok
Xu, Xu, Xu, Xu, Xu, Xu, Xu, Xu, Xu, Xu, Xu, Xu, Xu, Xu, Xu, Xu, Xu, Xu, Xu, Xu, Xu, Xu, Xu, Xu, Xu, Xu, Xu, Xu, Xu, Xu, Xu, Xu, Xu, Xu, Xu, Xu, Xu, Xu, Xu, Xu, Xu^Zok, Xos^Zok, Xos^Zok, Xos^Zok, Xos^Zok, Xu^Zok, Xos^Zok, Xos^Zok, Xu^Zok, Urb^Zok, Urb^Zok, Urb^Zok
Xu, Xu, Xu, Xu, Xu, Xu, Xu, Xu, Xu, Xu, Xu, Xu, Xu, Xu, Xu, Xu, Xu, Xu, Xu, Xu, Xu, Xu, Xu, Xu, Xu, Xu, Xu, Xu, Xu, Xu, Xu, Xu, Xu, Xu, Xu, Xu, Xu, Xu, Xu, Xu, Xu, Xu^Zok, Xu^Zok, Xos^Zok, Xos^Zok, Xos^Zok, Xos^Zok, Xu^Zok, Xu^Zok, Xu^Zok, Xos^Zok, Urb^Zok
Xu, Xu, Xu, Xu, Xu, Xu, Xu, Xu, Xu, Xu, Xu, Xu, Xu, Xu, Xu, Xu, Xu, Xu, Xu, Xu, Xu, Xu, Xu, Xu, Xu, Xu, Xu, Xu, Xu, Xu, Xu, Xu, Xu, Xu, Xu, Xu, Xu, Xu, Xu, Xu, Xu, Xu, Xu, Xu^Zok, Xu^Zok, Xos^Zok, Xos^Zok, Xos^Zok, Xos^Zok, Xos^Zok, Xu^Zok, Xu^Zok
Xu, Xu, Xu, Xu, Xu, Xu, Xu, Xu, Xu, Xu, Xu, Xu, Xu, Xu, Xu, Xu, Xu, Xu, Xu, Xu, Xu, Xu, Xu, Xu, Xu, Xu, Xu, Xu, Xu, Xu, Xu, Xu, Xu, Xu, Xu, Xu, Xu, Xu, Xu, Xu, Xu, Xu, Xu, Xu, Xu, Xu^Zok, Xu^Zok, Xos^Zok, Xos^Zok, Xos^Zok, Xos^Zok, Xu^Zok
Xu, Xu, Xu, Xu, Xu, Xu, Xu, Xu, Xu, Xu, Xu, Xu, Xu, Xu, Xu, Xu, Xu, Xu, Xu, Xu, Xu, Xu, Xu, Xu, Xu, Xu, Xu, Xu, Xu, Xu, Xu, Xu, Xu, Xu, Xu, Xu, Xu, Xu, Xu, Xu, Xu, Xu, Xu, Xu, Xu, Xu, Xu, Xu^Zok, Xu^Zok, Xos^Zok, Xos^Zok, Xos^Zok
