Xu, Xu, Xu, Xu, Xu, Xu, Xu, Xu, Xu, Xu, Xu, Xu, Xu, Xu, Xu, Xu, Xu, Xu, Xu, Xu, Xu, Xu, Xu, Xu, Xu, Xu, Xu, Xu, Xu, Xu, Xu, Xu, Xu, Xu, Xu, Xu, Xu, Xu, Xu, Xu, Xu, Xu, Xu, Xu, Xu, Xu, Xu, Xu, Xu, Xu, Xu, Xu, Xu, Xu, Xu, Xu, Xu, Xu, Xu, Xu, Xu, Xu, Xu, Xu, Xu, Xu, Xu^Zok, Xu^Zok, Xu^Zok, Xos^Zok, Xos^Zok, Xos^Zok, Xos^Zok, Xos^Zok, Urb^Zok, Urb^Zok, Urb^Zok, Urb^Zok, Urb^Zok, Urb^Zok
Xu, Xu, Xu, Xu, Xu, Xu, Xu, Xu, Xu, Xu, Xu, Xu, Xu, Xu, Xu, Xu, Xu, Xu, Xu, Xu, Xu, Xu, Xu, Xu, Xu, Xu, Xu, Xu, Xu, Xu, Xu, Xu, Xu, Xu, Xu, Xu, Xu, Xu, Xu, Xu, Xu, Xu, Xu, Xu, Xu, Xu, Xu, Xu, Xu, Xu, Xu, Xu, Xu, Xu, Xu, Xu, Xu, Xu, Xu, Xu, Xu, Xu, Xu, Xu, Xu^Zok, Xu^Zok, Xu^Zok, Xu^Zok, Xos^Zok, Xos^Zok, Xos^Zok, Xos^Zok, Urb^Zok, Urb^Zok, Urb^Zok, Urb^Zok, Urb^Zok, Urb^Zok, Xos^Zok, Xos^Zok
Xu, Xu, Xu, Xu, Xu, Xu, Xu, Xu, Xu, Xu, Xu, Xu, Xu, Xu, Xu, Xu, Xu, Xu, Xu, Xu, Xu, Xu, Xu, Xu, Xu, Xu, Xu, Xu, Xu, Xu, Xu, Xu, Xu, Xu, Xu, Xu, Xu, Xu, Xu, Xu, Uu^Ii, Xu, Uh, Xu, Xu, Xu, Xu, Xu, Xu, Xu, Xu, Xu, Xu, Xu, Xu, Xu, Xu, Xu, Xu, Xu, Xu, Xu, Xu^Zok, Xu^Zok, Xu^Zok, Xu^Zok, Xos^Zok, Xos^Zok, Xos^Zok, Xos^Zok, Urb^Zok, Urb^Zok, Urb^Zok, Urb^Zok, Urb^Zok, Urb^Zok, Xos^Zok, Xos^Zok, Xos^Zok, Xos^Zok
Xu, Xu, Xu, Xu, Xu, Xu, Xu, Xu, Xu, Xu, Xu, Xu, Xu, Xu, Xu, Xu, Xu, Xu, Xu, Xu, Xu, Xu, Xu, Xu, Xu, Xu, Xu, Xu, Xu, Xu, Xu, Xu, Uu^Uf, Xu, Uu^Ii, Xu, Uh, Xu, Xu, Xu, Urb, Uh, Uu^Uf, Uh, Xu, Xu, Xu, Xu, Xu, Xu, Xu, Xu, Xu, Xu, Xu, Xu, Xu, Xu, Xu, Xu, Xu^Zok, Xu^Zok, Xu^Zok, Xu^Zok, Xos^Zok, Xos^Zok, Xos^Zok, Xos^Zok, Urb^Zok, Urb^Zok, Urb^Zok, Urb^Zok, Urb^Zok, Urb^Zok, Xos^Zok, Xos^Zok, Xos^Zok, Xos^Zok, Xu^Zok, Xu^Zok
Xu, Xu, Xu, Xu, Xu, Xu, Xu, Xu, Xu, Xu, Xu, Xu, Xu, Xu, Xu, Xu, Xu, Xu, Xu, Xu, Xu, Xu, Xu, Xu, Xu, Xu, Xu, Xu, Xu, Xu, Xu, Uu^Uf, Uu^Uf, Xu, Uu, Uh, Uu^Uf, Uu^Uf, Wwg, Xu, Uu^Uf, Uh, Uh, Uh, Xu, Xu, Xu, Xu, Xu, Xu, Xu, Xu, Xu, Xu, Xu, Xu, Xu, Xu, Xu^Zok, Xu^Zok, Xu^Zok, Xu^Zok, Xos^Zok, Xos^Zok, Xos^Zok, Xos^Zok, Urb^Zok, Urb^Zok, Urb^Zok, Urb^Zok, Urb^Zok, Urb^Zok, Xos^Zok, Xos^Zok, Xos^Zok, Xos^Zok, Xu^Zok, Xu^Zok, Xu^Zok, Xu^Zok
Xu, Xu, Xu, Xu, Xu, Xu, Xu, Xu, Xu, Xu, Xu, Xu, Xu, Xu, Xu, Xu, Xu, Xu, Xu, Xu, Xu, Xu, Xu, Xu, Xu, Xu, Xu, Xu, Xu, Uu^Ii, Uu, Urb, Urb, Uu^Uf, Uu, Uh, Uu, Xu, Wwg^Es, Uu, Uu, Uu^Uf, Uh, Xu, Xu, Xu, Xu, Xu, Xu, Xu, Xu, Xu, Xu, Xu, Xu, Xu, Xu^Zok, Xu^Zok, Xu^Zok, Xu^Zok, Xos^Zok, Xos^Zok, Xos^Zok, Xos^Zok, Urb^Zok, Urb^Zok, Urb^Zok, Urb^Zok, Urb^Zok, Urb^Zok, Xos^Zok, Xos^Zok, Xos^Zok, Xos^Zok, Xu^Zok, Xu^Zok, Xu^Zok, Xu^Zok, Xu, Xu
Xu, Xu, Xu, Xu, Xu, Xu, Xu, Xu, Xu, Xu, Xu, Xu, Xu, Xu, Xu, Xu, Xu, Xu, Xu, Xu, Xu, Xu, Xu, Xu, Xu, Xu, Xu, Xu, Xu, Uh, Uh, Uh, Uu, Uu, Uh, Urb, Uu, Wwg, Wwg, Wwg, Xu, Uh, Xu, Xu, Xu, Xu, Xu, Xu, Xu, Xu, Xu, Xu, Xu, Xu, Xu, Xu, Xu, Xu^Zok, Xos^Zok, Xos^Zok, Xos^Zok, Xos^Zok, Urb^Zok, Urb^Zok, Urb^Zok, Urb^Zok, Urb^Zok, Urb^Zok, Xos^Zok, Xos^Zok, Xos^Zok, Xos^Zok, Xu^Zok, Xu^Zok, Xu^Zok, Xu^Zok, Xu, Xu, Xu, Xu
Xu, Xu, Xu, Xu, Xu, Xu, Xu, Xu, Xu, Xu, Xu, Xu, Xu, Xu, Xu, Xu, Xu, Xu, Xu, Xu, Xu, Xu, Xu, Xu, Xu, Xu, Xu, Xu, Xu, Xu, Xu, Uu^Uf, Uu^Uf, Uu, Wwf, Urb, Wog^Es, Wog, Wwg, Wwf^Es, Xu, Xu, Xu, Xu, Xos, Xos, Xu, Xu, Xu, Xu, Xu, Xu, Xu, Xu, Xu, Xu, Xos, Xos, Xos^Xzm/, Xos^Zok, Urb^Zok, Urb^Zok, Urb^Zok, Urb^Zok, Urb^Zok, Urb^Zok, Xos^Zok, Xos^Zok, Xos^Zok, Xos^Zok, Xu^Zok, Xu^Zok, Xu^Zok, Xu^Zok, Xu, Xu, Xu, Xu, Xu, Xu
Xu, Xu, Xu, Xu, Xu, Xu, Xu, Xu, Xu, Xu, Xu, Xu, Xu, Xu, Xu, Xu, Xu, Xu, Xu, Xu, Xu, Xu, Xu, Xu, Xu, Xu, Xu, Xu, Xu, Xu, Xu, Uu^Uf, Uh, Uu, Wwf^Es, Wwg, Wog, Wwg, Wwf, Uu, Xu, Xu, Xos, Xos, Xos, Xu, Xu, Xu, Xu, Xu, Xu, Xu, Xu, Xu, Xu, Xos, Xos^Xzm/, Xos^Xzm/, Urb^Ebme, Uh, Urb^Es, Urb^Zok, Urb^Zok, Urb^Zok, Xos^Zok, Xos^Zok, Xos^Zok, Xos^Zok, Xu^Zok, Xu^Zok, Xu^Zok, Xu^Zok, Xu, Xu, Xu, Xu, Xu, Xu, Xu, Xu
Xu, Xu, Xu, Xu, Xu, Xu, Xu, Xu, Xu, Xu, Xu, Xu, Xu, Xu, Xu, Xu, Xu, Xu, Xu, Xu, Xu, Xu, Xu, Xu, Xu, Xu, Xu, Xu, Xu, Uu^Ii, Uu, Xu, Urb, Uu, Wwg, Wwg, Wog, Wwg, Urb, Urb, Urb, Xos, Xos^Xzm/, Xos^Xzm/, Urb, Xu, Urb^Bzu, Xu, Xu, Xu, Xos, Xos, Xos, Xu, Xu, Xu, Urb, Urb, Urb, Urb, Urb^Es, Urb^Dr, Xos, Xos^Zok, Xos^Zok, Xos^Zok, Xu^Zok, Xu^Zok, Xu^Zok, Xu^Zok, Xu, Xu, Xu, Xu, Xu, Xu, Xu, Xu, Xu, Xu
Xu, Xu, Xu, Xu, Xu, Xu, Xu, Xu, Xu, Xu, Xu, Xu, Xu, Xu, Xu, Xu, Xu, Xu, Xu, Xu, Xu, Xu, Xu, Xu, Xu, Xu, Xu, Xu, Xu, Uh, Uh, Urb, Uu^Uf, Xu, Wwf^Es, Wwg, Wwg, Xu, Xos, Uu, Urb, Uu, Uu, Urb^Ebme, Uu^Dr, Urb, Urb, Uh, Uu, Xu, Xos, Xos, Xos^Xzm/, Xos, Uh, Uh, Urb, Urb, Uh, Uh, Xu, Xos, Xos, Xos, Xu, Xu^Zok, Xu^Zok, Xu^Zok, Xu, Xu, Xu, Xu, Xu, Xu, Xu, Xu, Xu, Xu, Xu, Xu
Xu, Xu, Xu, Xu, Xu, Xu, Xu, Xu, Xu, Xu, Xu, Xu, Xu, Xu, Xu, Xu, Xu, Xu, Xu, Xu, Xu, Xu, Xu, Xu, Xu, Xu, Xu, Xu, Xu, Xu, Uu, Urb, Uu^Uf, Xu, Xu, Uu, Uu^Ii, Xu, Xu, Xos, Urb, Urb, Uu, Urb, Urb, Uu^Es, Uh, Uu, Urb, Urb^Bzu, Xos, Xos, Urb^Ebme, Urb^Bzu, Urb, Urb, Urb, Urb, Xos, Xos, Xos, Xu, Xu, Xu, Xu, Xu, Xu, Xu, Xu, Xu, Xu, Xu, Xu, Xu, Xu, Xu, Xu, Xu, Xu, Xu
Xu, Xu, Xu, Xu, Xu, Xu, Xu, Xu, Xu, Xu, Xu, Xu, Xu, Xu, Xu, Xu, Xu, Xu, Xu, Xu, Xu, Xu, Xu, Xu, Xu, Xu, Xu, Xu, Xu, Xu, Uu^Ii, Uh, Uh, Uh, Xu, Xu, Xu, Xu, Xu, Xu, Urb, Urb, Urb^Es, Urb, Urb, Uu^Es, Uu, Urb^Es, Urb, Uh, Urb, Urb^Zz\, Urb^Zz\, Urb, Uh, Urb^Es, Xu, Xu, Xu, Xos, Xu, Xu, Xu, Xu, Xu, Xu, Xu, Xu, Xu, Xu, Xu, Xu, Xu, Xu, Xu, Xu, Xu, Xu, Xu, Xu
Xu, Xu, Xu, Xu, Xu, Xu, Xu, Xu, Xu, Xu, Xu, Xu, Xu, Xu, Xu, Xu, Xu, Xu, Xu, Xu, Xu, Xu, Xu, Xu, Xu, Xu, Xu, Xu, Xu, Xu, Xu, Xu, Xu, Xu, Xu, Xu, Xu, Xu, Xu, Urb^Bzu, Uu^Es, Uh, Urb, Urb, Urb, Urb, Urb, Urb, Urb, Uh, Uh, Urb, Uh, Urb^Zz\, Xos, Xos, Xos, Xu, Xu, Xu, Xu, Xu, Xu, Xu, Xu, Xu, Xu, Xu, Xu, Xu, Xu, Xu, Xu, Xu, Xu, Xu, Xu, Xu, Xu, Xu
Xu, Xu, Xu, Xu, Xu, Xu, Xu, Xu, Xu, Xu, Xu, Xu, Xu, Xu, Xu, Xu, Xu, Xu, Xu, Xu, Xu, Xu, Xu, Xu, Xu, Xu, Xu, Xu, Xu, Xu, Xu, Xu, Xu, Xu, Xos, Xos, Xos, Xu, Xos, Urb, Uh, Uu^Dr, Urb, Urb, Urb, Urb, Urb, Urb, Urb, Uu^Dr, Uh, Urb, Xos, Xos, Xos, Xos, Xu, Xu, Xu, Xu, Xu, Xu, Xu, Xu, Xu, Xu, Xu, Xu, Xu, Xu, Xu, Xu, Xu, Xu, Xu, Xu, Xu, Xu, Xu, Xu
Xu, Xu, Xu, Xu, Xu, Xu, Xu, Xu, Xu, Xu, Xu, Xu, Xu, Xu, Xu, Xu, Xu, Xu, Xu, Xu, Xu, Xu, Xu, Xu, Xu, Xu, Xu, Xu, Xu, Xu, Xu, Xu, Xos, Xos, Xos, Xos, Xos, Xos, Xos, Xos, Xos, Uh, Urb, Urb, Urb, Urb, Urb, Urb, Urb, Uu^Es, Uu, Xos, Xos, Xos, Xu, Urb^Ii, Urb, Uh, Uh, Xu, Xu, Xu, Xos, Xu, Xu, Xu, Xu, Xu, Xu, Xu, Xu, Xu, Xu, Xu, Xu, Xu, Xu, Xu, Xu, Xu
Xu, Xu, Xu, Xu, Xu, Xu, Xu, Xu, Xu, Xu, Xu, Xu, Xu, Xu, Xu, Xu, Xu, Xu, Xu, Xu, Xu, Xu, Xu, Xu, Xu, Xu, Xu, Xu, Xu, Xu, Xos, Xos, Xos^Xzm/, Xos, Xu, Xu, Xos, Xos, Uu^Dr, Xos, Uh^Ebme, Urb, Urb, Urb^Es, Urb, Uh, Uu^Es, Urb^Es, Urb^Es, Urb^Bzu, Xos, Xos, Xos, Xu, Xu, Xu, Uh, Urb, Xu, Xu, Xu, Xos, Xos, Xos, Xos, Xu, Xu, Xu, Xu, Xu, Xu, Xu, Xu, Xu, Xu, Xu, Xu, Xu, Xu, Xu
Xu, Xu, Xu, Xu, Xu, Xu, Xu, Xu, Xu, Xu, Xu, Xu, Xu, Xu, Xu, Xu, Xu, Xu, Xu, Xu, Xu, Xu, Xu, Xu, Xu, Xu, Xu, Xu, Xos, Xos, Xos^Xzm/, Xos^Xzm/, Uu^Uf, Uh, Uh, Uu^Uf, Urb, Uh, Uu, Urb, Urb, Urb, Urb, Uu, Xos, Uh, Uu^Es, Uu^Dr, Urb, Urb, Xos, Xos, Xu, Xu, Xu, Xu, Uh, Urb, Uh, Xu, Xu, Xu, Urb^Ii, Xos, Xos, Xos, Xos, Xu, Xu, Xu, Xu, Xu, Xu, Xu, Xu, Xu, Xu, Xu, Xu, Xu
Xu, Xu, Xu, Xu, Xu, Xu, Xu, Xu, Xu, Xu, Xu, Xu, Xu, Xu, Xu, Xu, Xu, Xu, Xu, Xu, Xu, Xu, Xu, Xu, Xu, Xu, Xos, Xos, Xos, Xos, Xos, Uu, Urb, Urb, Urb, Urb, Uu, Urb, Urb, Urb, Urb^Bzu, Urb^Es, Xos, Xos, Xos, Xos, Xos, Xos, Urb, Urb, Urb, Xu, Xu, Xu, Uh, Uu^Uf, Urb, Urb, Uh, Uu^Uf, Urb, Urb, Xu, Xu, Uh, Xos^Xzm\, Xu, Xu, Xu, Xu, Xu, Xu, Xu, Xu, Xu, Xu, Xu, Xu, Xu, Xu
Xu, Xu, Xu, Xu, Xu, Xu, Xu, Xu, Xu, Xu, Xu, Xu, Xu, Xu, Xu, Xu, Xu, Xu, Xu, Xu, Xu, Xu, Xu, Xu, Xu, Xu, Xu, Xos, Xuc, Xu, Uh, Urb^Pr\, Urb^Pr\, Urb, Uu^Uf, Uu^Uf, Xos, Urb, Uh, Uh, Xos, Xos, Xos, Xos, Xu, Xos, Xos, Xos, Xu, Urb, Urb, Urb, Urb, Uh, Urb, Urb, Uh, Urb, Urb, Urb, Uh, Urb, Uu^Uf, Uh, Uh, Xu, Xu, Xu, Xu, Xu, Xu, Xu, Xu, Xu, Xu, Xu, Xu, Xu, Xu, Xu
Xu, Xu, Xu, Xu, Xu, Xu, Xu, Xu, Xu, Xu, Xu, Xu, Xu, Xu, Xu, Xu, Xu, Xu, Xu, Xu, Xu, Xu, Xu, Xu, Xu, Xu, Xu, Xuc, Uh, Uh, Uu, Urb, Xos, Xos, Xos, Xos, Xu, Xos, Xos, Xos, Xos, Xos, Xu, Xu, Xu, Xu, Xu, Xu, Xos, Xos, Xos, Uh, Uh, Urb, Xu, Xu, Xu, Urb, Urb, Uh, Uh, Urb, Urb, Uu^Uf, Uu^Uf, Uh, Xu, Xu, Xu, Xu, Xu, Xu, Xu, Xu, Xu, Xu, Xu, Xu, Xu, Xu
Xu, Xu, Xu, Xu, Xu, Xu, Xu, Xu, Xu, Xu, Xu, Xu, Xu, Xu, Xu, Xu, Xu, Xu, Xu, Xu, Xu, Xu, Qxu, Qxu, Xu, Xu, Xuc, Xu, Uu^Uf, Re, Uu^Ii, Uh, Xu, Xu, Xu, Xu, Xu, Xu, Xu, Xu, Xu, Xu, Xu, Xu, Xu, Xu, Xu, Xu, Xos, Xos, Xu, Xu, Xu, Xu, Xos, Xu, Urb^Ii, Urb, Xu, Xu, Xos, Xu, Xu, Urb, Urb, Uh, Xu, Xu, Xu, Xu, Xu, Xu, Xu, Xu, Xu, Xu, Xu, Xu, Xu, Xu
Xu, Xu, Xu, Xu, Xu, Xu, Xu, Xu, Xu, Xu, Xu, Xu, Xu, Xu, Xu, Xu, Xu, Xu, Xu, Xu, Xu, Xu, Qxu, Qxu, Qxu, Xuc, Uh, Uu^Uf, Uu^Uf, Uu, Xuc, Xu, Xu, Xu, Uue, Uue^Uf, Uu^Vu, Xu, Xuc, Xuc, Xu, Xu, Qxu, Xu, Xu, Xu, Xu, Xu, Xu, Xu, Xu, Xu, Xu, Xos, Xos, Xos, Xos, Xu, Xu, Xu, Xos, Xu, Xu, Uh, Urb^Ii, Xu, Xu, Xu, Xu, Xu, Xu, Xu, Xu, Xu, Xu, Xu, Xu, Xu, Xu, Xu
Xu, Xu, Xu, Xu, Xu, Xu, Xu, Xu, Xu, Xu, Xu, Xu, Xu, Xu, Xu, Xu, Xu, Xu, Xu, Xu, Xu, Xu, Xu, Qxu, Qxu, Qxu, Uu^Uf, Uu, Uh, Uu, Xuc, Xuc, Uue^Uf, Uue^Uf, Re, Re, Uu, Uu, Re, Uu, Uu, Qxu, Qxu, Qxu, Xuc, Xu, Xu, Xu, Xu, Xu, Xu, Xu, Xu, Xu, Xu, Xos, Xos, Xu, Xu, Xu, Xu, Xu, Xu, Xu, Xos, Xos, Xos, Xu, Xu, Xu, Xu, Xu, Xu, Xu, Xu, Xu, Xu, Xu, Xu, Xu
Xu, Xu, Xu, Xu, Xu, Xu, Xu, Xu, Xu, Xu, Xu, Xu, Xu, Xu, Xu, Xu, Xu, Xu, Xu, Xu, Xu, Xu, Xu, Xu, Qxu, Qxu, Qxu, Uu^Vu, Uu, Uu, Uu, Xuc, Uue, Uue^Uf, Re, Uu, Qxu, Uu, Uh, Re^Ii, Uu, Qxu, Uue^Uf, Qxu, Uh, Xuc, Xuc, Xu, Xuc, Xu, Xuc, Xuc, Xu, Xu, Xu, Xu, Xu, Xu, Xu, Xu, Xos, Xu, Xu, Xu, Xu, Xos, Xu, Xu, Xu, Xu, Xu, Xu, Xu, Xu, Xu, Xu, Xu, Xu, Xu, Xu
Xu, Xu, Xu, Xu, Xu, Xu, Xu, Xu, Xu, Xu, Xu, Xu, Xu, Xu, Xu, Xu, Xu, Xu, Xu, Xu, Xu, Xu, Xu, Xu, Qxu, Qxu, Qxu, Uh, Uu^Ii, Re, Uu, Xu, Re, Uue, Uue, Qxe, Qxu, Qxu, Uh, Uu, Re, Uue, Uue^Uf, Uu^Uf, Uu, Uh, Xu, Xu, Xuc, Xuc, Xuc, Uue^Uf, Uue^Uf, Uue^Uf, Uue, Xu, Xu, Xu, Xu, Xu, Xos, Xos, Urb, Xu, Xu, Xu, Xu, Xu, Xu, Xu, Xu, Xu, Xu, Xu, Xu, Xu, Xu, Xu, Xu, Xu
Xu, Xu, Xu, Xu, Xu, Xu, Xu, Xu, Xu, Xu, Xu, Xu, Xu, Xu, Xu, Xu, Xu, Xu, Xu, Xu, Xu, Xu, Xu, Xu, Xu, Qxu, Xu, Uu^Uf, Uue, Re, Re, Uu, Uue, Uue, Uue, Qxe, Qxu, Uh, Uu, Uu, Re, Uue, Re, Uu, Uue, Uu^Uf, Qxu, Qxu, Xuc, Xuc, Uh, Xu, Uue^Uf, Uue, Uue, Xu, Xu, Xu, Xu, Xu, Xos, Xos, Urb, Rr, Urb, Xu, Xu, Xu, Xu, Xu, Xu, Xu, Xu, Xu, Xu, Xu, Xu, Xu, Xu, Xu
Xu, Xu, Xu, Xu, Xu, Xu, Xu, Xu, Xu, Xu, Xu, Xu, Xu, Xu, Xu, Xu, Xu, Xu, Xu, Xu, Xu, Xu, Xu, Xu, Xu, Xu, Xu, Xu, Xu, Uue, Uu, Uu, Xuc, Xuc, Xu, Xu, Xu, Uu^Uf, Uue^Uf, Uu, Uu^Ii, Re, Uu, Uu^Ii, Uue, Uue^Uf, Qxu, Qxu, Xu, Uh, Uue^Uf, Uu, Re, Uu, Uue, Uue^Uf, Xu, Xu, Xu, Xu, Xos, Xos, Urb, Rr, Urb, Xos, Xos, Xu, Xu, Xu, Xu, Xu, Xu, Xu, Xu, Xu, Xu, Xu, Xu, Xu
Xu, Xu, Xu, Xu, Xu, Xu, Xu, Xu, Xu, Xu, Xu, Xu, Xu, Xu, Xu, Xu, Xu, Xu, Xu, Xu, Xu, Xu, Xu, Xu, Xu, Xu, Xos, Xu, Xu, Uhe, Uu, Uu^Uf, Xu, Xu, Xu, Xu, Xu, Uhe, Uue^Uf, Uue, Uu, Uu, Re, Uu, Uhe, Xuc, Xuc, Uh, Uh, Uue^Uf, Uue^Uf, Uu, Re, Uu, Uu^Vu, Uhe, Xu, Xu, Xu, Xu, Xos, Xos, Urb^Xo, Rr^Xo, Urb^Xo, Xos, Xos, Xu, Xu, Xu, Xu, Xu, Xu, Xu, Xu, Xu, Xu, Xu, Xu, Xu
Xu, Xu, Xu, Xu, Xu, Xu, Xu, Xu, Xu, Xu, Xu, Xu, Xu, Xu, Xu, Xu, Xu, Xu, Xu, Xu, Xu, Xu, Xu, Xu, Xu, Xos, Xos, Xos, Xos, Uh, Uh, Xu, Xu, Xu, Xu, Xu, Xu, Uhe, Uhe, Uue, Uh, Uu, Re, Uu, Uu, Xuc, Uu, Uu^Uf, Uu, Uu, Uu, Re, Uu^Uf, Uu, Re, Uu, Xu, Xu, Xu, Xu, Xos, Xos, Urb, Rr, Urb, Xos, Xos, Xu, Xu, Xu, Xu, Xu, Xu, Xu, Xu, Xu, Xu, Xu, Xu, Xu
Xu, Xu, Xu, Xu, Xu, Xu, Xu, Xu, Xu, Xu, Xu, Xu, Xu, Xu, Xu, Xu, Xu, Xu, Xu, Xu, Xu, Xu, Xu, Xu, Xu, Xu, Xu, Xos, Xos, Xos, Xos, Xu, Xu, Xu, Xu, Xu, Xu, Uhe, Xu, Uhe, Uh, Uu, Uu, Re, Uu, Xu, Re, Uu^Ii, Re, Uu, Xuc, Xuc, Xu, Uu, Re, Uu, Urb^Bzu, Xos, Xos^Xzm\, Xu, Xos, Xos, Urb, Rr, Urb, Xos, Xos, Xu, Xu, Xu, Xu, Xu, Xu, Xu, Xu, Xu, Xu, Xu, Xu, Xu
Xu, Xu, Xu, Xu, Xu, Xu, Xu, Xu, Xu, Xu, Xu, Xu, Xu, Xu, Xu, Xu, Xu, Xu, Xu, Xu, Xu, Xu, Xu, Xu, Xu, Xu, Xu, Xu, Xu, Xos, Xos, Xos, Xos, Xu, Xu, Xu, Xu, Xu, Xu, Xu, Xu, Xu, Uh, Uu^Ii, Uu, Re, Re, Uu, Xu, Xuc, Xuc, Cte, Kte, Uu^Uf, Uu, Re, Re, Urb, Urb, Xos, Xos, Xos, Urb, Rr, Urb, Xos, Xos, Xu, Xu, Xu, Xu, Xu, Xu, Xu, Xu, Xu, Xu, Xu, Xu, Xu
Xu, Xu, Xu, Xu, Xu, Xu, Xu, Xu, Xu, Xu, Xu, Xu, Xu, Xu, Xos, Xos, Xos, Xu, Xu, Xu, Xu, Xu, Xu, Xu, Xu, Xu, Xu, Xu, Xos, Xos, Xos, Xos, Xos, Xos, Xu, Xu, Xu, Xu, Xu, Xu, Xu, Xu, Xu, Uu, Uu, Re, Uu^Vu, Uu, Xu, Xu, Xu, Uh, Cte, Cte, Xu, Uu, Urb, Urb, Urb, Urb, Xos, Xos, Urb, Rr, Urb, Xos, Xos, Xu, Xu, Xu, Xu, Xu, Xu, Xu, Xu, Xu, Xu, Xu, Xu, Xu
Urb, Xu, Xol, Xu, Xos, Xu, Xu, Xu, Xu, Xu, Qxu, Xu, Xos, Xos, Xos, Xos, Xos, Xos, Xos, Xu, Xu, Xu, Xu, Xu, Xu, Xu, Xos, Xos, Xos, Xos, Wwb, Xos, Xos, Xos, Xos, Xu, Xu, Xu, Xu, Xu, Xu, Xu, Xu, Xu, Xu, Uh, Xu, Xu, Xu, Xu, Xu, Uh, Xu, Uue, Xu, Xu, Xos, Urb, Xos, Xos, Xos, Xos, Urb, Rr, Urb, Xos, Xos, Xu, Xu, Xu, Xu, Xu, Xu, Xos, Xos, Xu, Xu, Xu, Xu, Xu
Rr, Urb, Urb, Xol, Xu, Xu, Xuc, Xuc, Qxe, Qxu, Qxu, Xu, Xu, Xos, Xos, Xos, Xos, Xos, Wog, Wog, Xos, Xu, Xu, Xu, Xos, Xos, Xos, Xos, Wwb, Wwb, Xos, Xos, Wwb, Xos, Xos, Xos, Xos, Xu, Xu, Xu, Xu, Xu, Xu, Xu, Xu, Xu, Xu, Xu, Xu, Xu, Xu, Xu, Xu, Xu, Xu, Xu, Xos, Xos, Xos, Xos, Xos, Urb^Bzu, Urb, Rr, Urb, Xos, Xos, Xu, Xu, Xu, Xos, Xu, Xu, Xos, Xos, Xos, Xos, Xu, Xu, Xu
Urb, Re, Re, Urb, Urb, Xu, Uh, Xuc, Uhe, Qxe, Xu, Xu, Xu, Xu, Xu, Xos, Wog, Wog, Xos, Xos, Xos, Xos, Xos, Xos, Xos, Xos, Xos, Wwb, Xos, Xos, Wwb, Wwb, Xos, Xos, Wwb, Xos, Xos, Xos, Xos, Xu, Xos, Xos, Xos, Xu, Xu, Xu, Xu, Xu, Xu, Xu, Xu, Xu, Xu, Xu, Xos, Xos, Xos, Xos, Xos, Xos, Xos, Xos, Cud, Rr, Urb, Xos, Xos, Xu, Xos, Xos, Xos, Xos, Xos, Xu, Uh, Xos, Xos, Xos, Xos, Xu
Xu, Re, Urb, Re^Es, Rr, Re, Uh, Uu^Uf, Uue^Es, Qxe, Qxe, Xu, Xu, Xu, Xu, Xu, Wog, Xos, Xos, Xos, Xos, Xos, Xos, Xos, Xos, Xos, Xos, Wwb, Xos, Wwb, Xos, Xos, Wwb, Wwb, Xos, Xos, Xos, Xos, Xos, Xos, Xos, Xos, Xos, Xos, Xos, Xu, Xu, Xu, Xu, Xu, Xu, Xu, Xos, Xos, Xos, Xos, Qxv, Xos, Xos, Xos, Xos, Xos, Cud, Cud, Xos, Xos, Xos, Xos, Xu, Xu, Xu, Xos, Xol^Xzm\, Xol, Uh, Xu, Xu, Xos, Xos, Xu
Xu, Xu, Xu, Re, Re, Rr, Re, Uue, Uue, Uhe, Xuc, Xuc, Xu, Xu, Xom, Uh, Wog^Xo, Xu, Xu, Xos, Xos, Xos, Xos, Xos, Xos, Xos, Xos, Wwb, Xos, Wwb, Xos, Wwb^Xo, Xos, Xos, Xos, Xos, Xos, Xos, Xos, Xos, Qxv, Qxv, Qxv^Xo, Xos, Xos, Xos, Xos, Xu, Xu, Xu, Xos, Xos, Xos, Xos, Qxv, Qxv, Qxv, Qxv, Xos, Xos, Xos, Xos, Cud, Cud, Xos, Xos, Xos, Xos, Xol, Xu, Uu^Uf, Uu^Uf, Uu, Uh, Uu^Uf, Uu^Uf, Uu^Uf, Xos, Xos, Xu
Xu, Xu, Xu, Uh, Xu, Uh, Re, Re^Es, Ur, Uu^Em, Uu^Dr, Xuc, Xu, Xom, Xom, Xom, Wwg, Xu, Xuc, Xu, Xu, Xos, Xos, Xos, Xos, Xos, Xos, Wwb, Xos, Wwb^Xo, Xos, Wwb, Wwb, Xos, Xos, Xos, Xos, Xos, Xu, Xu, Xu, Qxv^Xo, Qxv, Qxv, Qxv, Xos, Xos, Xos, Xos, Xos, Xos, Xos, Qxv^Xo, Qxv, Qxv, Qxv, Xos, Xos, Xos, Xos, Cud, Cud, Cud, Cud, Xos, Xos, Xos, Xol, Uh, Xu, Uu^Uf, Uu^Uf, Urb, Uh, Uh, Uu^Uf, Uu^Uf, Xos, Xos, Xu
Xos, Xos, Xos, Xu, Qxu, Xuc, Uh, Rb, Uu^Em, Rr^Em, Wwf, Wwf, Wwf^Es, Xuc, Xuc, Uu, Wwg, Uu^Uf, Uu^Emf, Xuc, Xu, Xu, Xos, Xos, Xos, Xos, Xos, Wwb^Xo, Xos, Wwb, Wwb, Xos, Xos, Wwb, Yhr, Xos, Xos, Xos, Xos, Xu, Xu, Xu, Uh, Qxv, Qxv, Qxv, Qxv, Xos, Xos, Xos, Qxv, Qxv, Qxv, Qxv^Xo, Xos, Xos, Xos, Xos, Xos, Cud, Cud, Cud, Xos, Xos, Xos, Xos, Xu, Xu, Uh, Uu, Uh, Uu^Vud, Urb, Xos, Urb, Uu, Uu^Vud, Xos, Xos, Xos
Xos, Xos, Xos, Qxu, Qxu, Qxu, Uh, Uh, Xu, Uu^Emf, Wwf^Es, Wwf, Rr^Xo, Wwg^Xo, Wwg, Wwg, Wwg, Uu^Em, Uu^Ii, Uh, Xuc, Xu, Xu, Xos, Xos, Xos, Xos, Wwb, Wwb, Xos, Xos, Wwb, Yhr, Xos, Xos, Yhr, Yhr, Xos, Xos, Xos, Uh, Xu, Yhl^Ii, Uh, Yhl, Qxv, Qxv, Qxv, Qxv, Qxv, Qxv, Qxv, Yhl, Xol, Xol, Xos, Xos, Xos, Xos, Cud, Cud, Xos, Xos, Xos, Xu, Xu, Xu, Xu, Xu, Uh, Urb, Urb, Cte, Urb, Urb, Urb, Uu, Uu^Uf, Xos, Xos
Xos, Xos, Xos, Qxu, Qxu, Xu, Xu, Uh, Xos, Xu, Xu, Urb^Xo, Wwf, Wwg, Wwf, Wwg, Uu, Uu^Ii, Uue^Ii, Uh, Xuc, Xuc, Xom, Xu, Xos, Xos, Xos, Xos, Xos, Wwb, Yhr, Xos, Xos, Yhr, Yhl, Xos, Xos, Yhl, Yhl, Xos, Uu^Uf, Uu^Vu, Yhl, Yhl, Yhl, Yhl, Yhl^Ii, Qxv, Qxv, Qxv, Yhl, Yhl, Yhl, Yhl, Yhl^Xp, Xos, Xol, Xos, Xos, Cud, Cud, Xos, Xos, Xu, Xu, Xu, Xos, Xos, Uh, Uu^Vud, Urb, Cte, 7 Kte, Cte, Urb, Urb, Uu^Uf, Uu^Uf, Xos, Xos
Xos, Xos, Xos, Qxu, Xos, Xu, Xu, Xu, Xu, Xu, Wwg, Wwg^Es, Wwf, Uu, Wwf, Uu, Uu, Uue, Uhe, Uu^Em, Uh, Uh, Xom, Xom, Xos, Xos, Xos, Xos, Xos, Xos, Xos, Yhr, Yhr, Xos, Xos, Yhl, Yhl^Ii, Xos, Uh, Yhl, Yhl, Yhl, Cte, Cte, Xu, Yhl, Yhl, Yhl, Yhl, Yhl, Yhl, Yhl, Yhl, Yhl, Xos, Yhl, Yhl^Z/, Xol, Xos, Cud, Cud, Xos, Xos, Xu, Xos, Xos, Xos, Xos, Uh, Uu, Xos, Cte, Rr, Cte, Xos, Uu^Vud, Uu, Uu^Uf, Xos, Xos
Xos, Xos, Xos, Xos, Xos, Xos, Xu, Xu, Xu, Xu, Qxu, Wwg^Es, Xu, Xuc, Wwf, Uu, Uu, Re, Re, Uue^Dr, Uue, Xu, Xu, Xos, Xos, Xos, Xos, Xos, Xos, Xos, Xos, Xos, Xos, Yhr, Yhr, Xos, Xos, Yhl, Yhl, Yhl, Yhl, Cte, Cte, 3 Kte, Yhl, Xu, Yhl, Yhl, Xos, Yhl, Yhl^Xp, Yhl, Xol, Yhl^Xp, Yhl^Z/, Xol, Xol, Yhl, Cud, Cud, Cud, Xos, Xos, Xos, Xos, Xos, Xos, Xos, Xu, Uu, Urb, Urb^Bz, Rr, Urb^Bz, Urb, Uu, Uu^Uf, Uh, Xos, Xos
Xos, Xos, Xos, Xos, Xos, Xos, Xu, Xu, Xu, Xu, Qxu, Qxu, Xu, Xu, Uh, Wwf, Uhe, Uue, Uue, Re, Uue, Xu, Uh, Xos^Efs, Xos^Efs, Xos, Xos, Xos, Xos, Xos, Xos, Xos, Xos, Xos, Xos, Yhl, Yhl, Yhl, Uu^Vu, Yhl, Yhl, Cte, Cte, Yhl, Yhl, Yhl^Xp, Yhl^Xp, Yhl^Ii, Xos, Xos, Xos, Yhl, Yhl^Z/, Xol, Xos, Yhl, Cud, Cud, Cud, Cud, Xos, Xos, Xos, Xos, Xu, Xu, Xos, Xos, Xos, Xos, Xos, Urb, Rr, Urb, Xos, Xos, Xu, Xu, Xu, Xu
Xos, Xos, Xos, Xos, Xos, Xos, Xu, Xu, Qxu, Qxu^Xo, Qxu^Xo, Qxu, Uh, Uu^Ii, Uu^Ii, Wwf, Uue, Uue^Em, Uue, Uhe, Uu, Ur, Ur, Uh, Urb, Xos, Xos^Efs, Xos, Xos, Xos, Xos, Xos, Xos, Xos, Yhr, Yhr, Xu, Uh, Uh, Uu^Uf, Yhl^Ii, Yhl, Xu, Xu, Yhl^Xp, Yhl^Xp, Wog^Es, Yhl, Yhl, Xol, Xol, Xos, Xos, Yhl, Cud, Cud, Cud, Cud, Xos, Xos, Xos, Xos, Xu, Xu, Xu, Xu, Xos, Xos, Xol, Xol, Urb, Cud, Cud, Urb, Xos, Xos, Xu, Xu, Xu, Xu
Xos, Xos, Xos, Xos, Xos, Xos, Xu, Xu, Qxu, Qxu, Xu, Xu, Xu, Uu^Ii, Wog, Wwg, Uhe, Uue, Uue^Dr, Xu, Xu, Uh, Urb, Rr, Rr, Urb, Urb, Xos^Efs, Xos, Xos, Xos, Xos, Yhr, Yhr, Xos, Xu, Xu, Xu, Xu, Uu^Uf, Uu, Yhl, Uu^Uf, Xu, Xu, Yhl, Wog, Wwg, Wwg, Yhl, Xos, Xos, Xos, Cud, Cud, Cud, Xos, Xos, Xos, Xos, Xu, Xu, Xu, Xu, Xos, Xos, Xos, Xos, Urb, Urb, Rr, Rr, Urb, Cud, Xos, Xos, Xu, Xu, Xu, Xu
Xos, Xos, Xos, Xos, Xos, Xos, Xu, Xu, Xu, Xu, Xu, Xu, Xu, Wog, Wog, Xuc, Xuc, Uh, Xu, Qxu, Xu, Xos, Xos, Urb, Urb, Rr, Rr, Urb, Cud, Xos^Efs, Xos^Efs, Xos, Yhr^Xo, Xos, Xos, Xu, Xu, Xu, Xu, Xu, Xu, Yhl, Xu, Xu, Xu, Xu, Uu^Vu, Wog, Wwg^Es, Wwg^Es, Xos, Xos, Xu, Cud, Cud, Cud, Xos, Xos, Xu, Xu, Xu, Xu, Xos, Xos, Xol, Xol, Urb^Ebur, Urb, Rr, Rr, Urb, Urb, Xos, Xos, Xos, Xos, Xu, Xu, Xu, Xu
Xos, Xos, Xos, Xos, Xos, Xos, Xos, Xu, Xu, Xu, Xos, Xu, Xos, Wog^Xo, Wog^Xo, Xuc, Xos, Xu, Xu, Xu, Xos, Xos, Xos, Xos, Xos, Urb, Cud, Kud, Rr, Urb, Urb, Xos, Yhr^Xp, Xos, Xos, Xu, Xu, Xu, Xu, Xu, Xu, Yhr, Xu, Xu, Xu, Xu, Xu, Wog, Xos, Xos, Xos, Xos, Xu, Cud, Cud, Cud, Xu, Xu, Xu, Xu, Xos, Xos, Xos, Xos, Urb^Ebur, Urb, Rr, Rr, Urb, Urb, Xos, Xos, Xos, Xos, Xu, Xu, Xu, Xu, Xu, Xu
Xos, Xos, Xos, Xos, Xos, Xos, Xos, Xos, Xos, Xos, Xos, Xos, Xos, Wog, Wog, Xos, Xos, Xos, Xos, Xos, Xos, Xos, Xos, Xos, Xos, Xos, Xos, Urb, Urb, Rr, Rr, Urb, Urb, Xoc, Xoc, Xoc, Xoc, Xu, Xoc, Xu, Xoc, Yhr^Xo, Xoc, Xoc, Xoc, Xoc, Xoc, Xu, Xoc, Xos, Xoc, Xoc, Xoc^Efs, Cud^Xo, Cud^Xo, Cud^Xo, Xoc, Xu, Xos, Xos, Xol, Xos, Urb, Urb, Rr, Rr, Rr, Urb, Urb^Bz, Xos, Xoi, Xos, Xos, Xu, Xu, Xu, Xu, Xu, Xu, Xu
Xos, Xos, Xos, Xos, Xos, Xos, Xos, Xos, Xos, Xos, Xos, Xos, Xos, Xos, Xos, Wog, Wog, Xos, Xos, Xos, Xos, Xos, Xos, Xos, Xos, Xos, Xos, Xos, Xos, Urb, Urb, Rr, Rr, Urb, Urb, Xoc^Efs, Xoc^Efs, Xoc, Xoc^Efs, Xoc, Xoc, Yhr, Xoc^Efs, Xoc, Xoc, Xoc, Xoc^Efs, Xoc, Xoc, Xoc, Xoc, Xoc^Efs, Cud, Cud, Cud, Cud, Xoc, Xos, Xos, Xol, Urb, Urb, Rr, Rr, Urb, Urb, Urb^Bz, Rr, Xu, Xoi, Rrc, Xoi^Efs, Xoi^Efs, Xos, Xos, Xu, Xu, Xu, Xu, Xu
Xos, Xos, Xos, Xos, Xos, Xos, Xos, Xos, Xos, Xos, Xos, Xos, Xos, Xos, Xos, Xos, Xos, Wog, Wog, Xos, Xos, Xos, Xos, Xos, Xos, Xos, Xos, Xos, Xos, Xos, Yhr, Urb, Urb, Rr, Rr^Zz/, Urb^Zz/, Urb, Xoc, Xoc^Efs, Xoc, Urb, Urb, Urb, Xoc^Efs, Xoc, Xoc^Efs, Cud^Xo, Cud^Ebur, Cud, Cud^Ebur, Cud, Cud, Cud, Cud, Xoc, Xoc, Xoc, Xos, Xos, Urb, Rr, Rr, Urb, Urb, Urb, Urb, Xos, Xoi, Rrc, Rrc, 1 Rrc, Rrc, Rrc, Xoi, Xos, Xos, Xos, Xu, Xu, Xu
Xos, Xos, Xos, Xos, Xos, Xos, Xos, Xos, Xos, Xos, Xos, Xos, Xos, Xos, Xos, Xos, Xos, Xos, Wog, Xos, Xos, Xos, Xos, Xos, Xos, Xos, Xos, Xos, Yhl^Xo, Yhr^Xp, Xoc, Xoc, Xoc, Urb^Zz/, Urb, Rr, Rr, Urb, Urb, Cud, Urb, Xoc^Efs, Urb, Cud, Urb, Urb, Cud^Xo, Cud, Cud, Kud, Cud, Kud, Cud, Xoc, Xoc, Xoc, Xol, Xos, Xos, Urb, Rr, Urb, Xol, Xos, Wwg, Urb, Xos, Xoi, Xoi, Rrc, Rrc, Rrc, Xoi, Xoi, Xos, Xos, Xu, Xu, Xu, Xu
Xos, Xos, Xos, Xos, Xos, Xos, Xos, Xos, Xos, Xos, Xos, Xos, Xos, Xos, Xos, Xos, Xos, Xos, Wog, Xos, Xos, Xos, Xos, Xos, Xos, Xos, Xos, Yhl, Xos, Xos, Xos, Xoc, Xoc, Xoc, Xoc, Urb, Urb, Rr, Rr, Urb, Urb, Urb, Wwg, Urb, Urb, Cud^Xo, Cud^Xo, Cud, Kud, Cud, Cud, Cud, Cud, Xoc, Xoc, Xol, Xu, Xu, Xos, Urb, Rr, Urb, Urb, Xol, Wwg, Wwg, Xos, Xos, Xos, Xoi, Xoi, Xoi, Xos, Xos, Xu, Xu, Xu, Xu, Xu, Xu
Xos, Xos, Xos, Xos, Xos, Xos, Xos, Xos, Xos, Xos, Xos, Xos, Xos, Xos, Xos, Xos, Xos, Xos, Wog, Xos, Xos, Xos, Xos, Xos, Xos, Xos, Yhl, Yhl, Xos, Xos, Xos, Xol, Xoc, Xoc, Xoc, Urb, Urb, Urb, Urb, Urb, Wwg, Wwg, Wwg, Wwg, Urb, Urb, Urb, Cud^Xo, Cud^Xo, Cud, Kud, Cud, Cud^Xo, Xoc^Efs, Xoc^Efs, Xol, Xu, Xu, Xos, Urb, Urb, Rr, Rr, Urb, Urb, Wwg, Xol, Xos, Xos, Xos, Xos, Xos, Xu, Xu, Xu, Xu, Xu, Xu, Xu, Xu
Wwg, Xos, Xos, Xos, Xos, Xos, Xos, Xos, Xos, Xos, Xos, Xos, Xos, Xos, Xos, Xos, Xos, Xos, Wog, Xos, Xos, Xos, Xos, Xos, Yhl, Yhl, Xos, Xos, Yhl, Xos, Xos, Xoc^Efs, Xoc, Xoc, Xoc, Urb, Urb, Urb, Urb, Wwg, Wwg, Wwg, Urb, Urb, Rr, Rr, Rr, Urb, Urb, Cud^Xo, Cud^Xo, Cud^Xo, Urb, Cud^Xo, Xoc, Xoc, Yhr, Yhr, Uh, Xos, Xos^Xzm\, Urb, Urb, Rr, Rr, Urb, Urb, Xol, Xos, Xos, Xos, Xu, Xu, Xu, Xu, Xu, Xu, Xu, Xu, Xu
Xos, Wwg, Wwg, Xos, Xos, Xos, Xos, Xos, Xos, Xos, Xos, Xos, Xos, Xos, Xos, Xos, Wog, Wog, Xos, Xos, Xos, Xos, Xos, Xos, Yhl, Xos, Yhl, Yhl, Xos, Yhl, Yhl, Xoc^Efs, Yhr^Xo, Xoc, Xoc^Efs, Cud, Urb, Urb, Urb, Urb, Urb, Urb, Rr, Rr, Rr, Rr, Rr, Rr, Urb, Urb, Urb, Urb, Xoc^Efs, Urb, Urb, Yhr, Xoc, Yhr, Uu^Uf, Uu^Uf, Yhl, Xos^Xzm\, Xos, Urb, Urb, Rr, Rr, Urb, Urb^Bzu, Xos, Xos, Xu, Xos, Xos, Xos, Xu, Xu, Xu, Xu, Xu
Xos, Xos, Xos, Wwg, Wwg, Wwg, Wwg, Xos, Xos, Xos, Xos, Xos, Xos, Xos, Xos, Wog, Xos, Xos, Xos, Xos, Xos, Yhl^Xp, Yhl^Xp, Xos, Yhl, Xos, Yhl, Xos, Xos, Xos, Xos, Yhl, Xoc, Yhr^Xp, Urb, Urb, Xoc^Efs, Urb, Urb, Urb, Wwg, Urb, Urb, Rr, Rr, Rr, Urb, Urb, Wwg, Wwg, Wwg, Urb, Urb, Urb, Xoc, Xoc, Xoc, Yhl, Yhl, Yhl, Yhl, Xu, Xu, Xos, Xos, Urb, Urb, Rr, Urb, Xos, Xos, Xos, Xos, Xos, Yhr, Xu, Xos, Xu, Xu, Xu
Xos, Xos, Xos, Xos, Xos, Xos, Xos, Wwg, Wwg, Xos, Xos, Xos, Xos, Xos, Xos, Wog, Xos, Xos, Yhl^Xp, Xos, Xos, Xos, Yhl, Yhl, Xos, Xos, Yhl, Xos, Xos, Xos, Xos, Xoc, Xoc, Xoc, Xoc, Urb, Urb, Urb, Urb, Wwg, Wwg, Wwg, Wwg, Urb, Urb, Urb, Wwg, Wwg, Wwg, Wwg, Urb, Urb, Urb, Cud, Xoc, Xoc, Xoc, Uu^Vu, Uu^Uf, Cte, 8 Kte, Yhl, Xu, Xu, Xos, Xos, Urb, Rr, Urb, Xos, Xos, Xos, Yhr^Xo, Yhr, Xos, Xos, Yhr, Xu, Xos, Xu
Xos, Xos, Xos, Xos, Xos, Xos, Xos, Xos, Wwg, Xos, Xos, Xos, Xos, Xos, Xos, Wog, Yhl, Yhl, Xos, Yhl, Yhl, Yhl, Yhl, Yhl, Yhl, Yhl, Xos, Xos, Xos, Xos, Xos, Xoc, Xoc, Xoc, Xoc, Cud, Urb, Urb, Urb, Urb, Urb, Wwg, Wwg, Wwg, Urb, Urb, Urb, Wwg, Urb, Urb, Urb, Urb, Xoc, Xoc, Xoc, Xoc, Xu, Uh, Uu, Cte, Yhl, Yhl, Uu^Vu, Uh, Xos, Xos, Urb^Bz, Rr, Rr, Urb, Urb, Yhr, Xos, Xos, Yhr^Xo, Yhr, Xos, Xos, Yhr, Xu
Xos, Xos, Xos, Xos, Xos, Xos, Xos, Xos, Wwg, Xos, Xos, Xos, Xos, Xos, Wwg, Wwg, Xos, Xos, Xos, Xos, Yhl, Yhl, Yhl, Yhl, Yhl, Xos, Xos, Xos, Xos, Xos, Xos, Xol, Xoc, Xoc, Xoc^Efs, Urb, Urb, Urb, Rr, Rr, Urb, Urb, Urb, Urb, Urb, Urb, Urb, Urb, Rr, Urb, Urb, Xoc^Efs, Xoc^Efs, Xoc, Xoc, Xoc, Xoc, Xu, Xu, Uu^Uf, Uu^Uf, Yhl, Uh, Xu, Xu, Xos, Xos, Urb, Rr, Rr, Rr, Urb, Urb, Yhr, Xos, Xos, Yhr^Xo, Yhr, Xos, Xos
Xos, Xos, Xos, Xos, Xos, Xos, Xos, Xos, Wwg, Wwg, Wwg, Xos, Wwg, Wwg, Yhl^Xp, Xos, Xos, Xos, Yhl, Yhl^Z\, Xos, Xos, Yhl, Xos, Yhl, Xos, Xos, Xos, Xos, Xos, Xos, Xoc, Xoc, Xoc^Efs, Urb, Urb, Rr, Rr, Urb, Urb, Urb, Xoc^Efs, Urb, Urb, Urb, Urb, Urb, Urb, Urb, Rr, Rr, Urb, Cud, Xoc, Xoc^Efs, Xoc, Xoc, Xu, Xu, Uu^Uf, Xu, Uu, Uu^Uf, Xu, Xos, Xos, Xoc^Efs, Urb, Rr, Urb, Urb, Rr, Rr, Urb, Urb, Yhr, Xos, Xos, Xos, Xos
Xos, Xos, Xos, Xos, Xos, Xos, Wwg, Wwg, Xos, Xos, Xos, Wwg, Yhl^Xp, Yhl, Yhl, Yhl, Yhl, Yhl, Xos, Xos, Xos, Xos, Yhl, Xos, Yhr, Xos, Xos, Xos, Xos, Xos, Xoc^Efs, Xoc^Efs, Urb, Cud, Cud, Rr, Urb, Urb, Xoc, Cud, Xoc, Urb, Xoc, Cud, Xoc, Urb, Xoc, Xoc, Xoc, Urb, Cud, Cud, Rr, Urb, Urb, Xoc^Efs, Xoc, Xos, Xu, Xu, Xu, Xu, Xoc, Xos, Xoc, Xoc^Efs, Urb^Ebur, Urb, Rr, Urb, Xoc, Urb, Urb, Rr, Rr, Urb, Urb, Xos, Xos, Xos
Xos, Xos, Xos, Xos, Xos, Xos, Wwg, Xos, Xos, Xos, Xos, Xos, Xos, Yhl, Yhl^Xp, Yhl, Yhl^Xp, Yhl^Xp, Xos, Xos, Xos, Xos, Yhr, Xos, Xos, Yhr, Yhr^Xo, Xos, Xos, Xos, Urb^Xo, Urb, Rr, Rr, Urb, Cud, Xoc, Xoc, Xoc, Xoc, Xoc, Yhr^Xp, Xoc^Efs, Xoc, Xoc, Xoc, Xoc, Xoc, Xoc, Xoc, Xoc, Urb, Urb, Rr, Rr, Urb, Urb, Xoc^Efs, Xoc^Efs, Xos, Xos, Xos, Xoc^Efs, Xoc, Cud, Urb^Ebur, Rr, Rr, Urb, Urb, Xoc, Xoc, Xoc, Urb, Urb, Rr, Rr^Xo, Urb^Xo, Urb, Xos
Xos, Xos, Wwg, Xos, Wwg, Wwg, Xos, Yhl^Xp, Yhl, Xos, Xos, Xos, Yhl^Xp, Yhl, Xos, Yhl^Xp, Xos, Xos, Xos, Xos, Xos, Xos, Xos, Yhr, Yhr^Xo, Xos, Xos, Yhr, Urb, Urb, Rr, Rr^Xo, Urb^Xo, Urb, Xoc, Xoc, Xos, Xoc, Xos, Xoc, Xoc, Yhr^Xo, Yhl^Xp, Xoc^Efs, Xoc, Xos, Xoc, Xoc, Xoc, Xoc, Xoc, Xoc, Xoc, Urb, Urb, Rr, Cud, Cud, Urb, Xoc, Xoc, Xoc^Efs, Urb^Ebur, Urb^Ebur, Rr, Kud, Cud, Urb, Xoc, Xoc, Xos, Xos, Xos, Xos, Xos, Urb^Xo, Urb, Rr, Rr, Urb
Wwg, Wwg, Xos, Wwg, Xos, Yhl^Xp, Yhl, Xos, Yhl, Xos, Xos, Xos, Yhl, Yhl, Xos, Xos, Xos, Xos, Xos, Xos, Xos, Xos, Xos, Xos, Xos^Efs, Yhr, Urb, Cud, Cud, Rr, Urb, Urb, Xos, Xos, Xos, Xos, Xos, Xos, Xos, Xos, Xos, Xoc, Xoc, Yhl, Yhl, Xos, Xoc, Xoc, Xoc, Xoc, Xoc, Xoc, Xoc, Xoc, Xoc, Cud, Urb, Rr, Rr, Urb, Urb, Urb, Rr, Rr, Urb, Urb, Xoc, Xoc, Xos, Xos, Xu, Xu, Xu, Xos, Xos, Xos, Xos, Urb, Urb, Rr
Xos, Xos, Xos, Xos, Xos, Xos, Yhl^Xp, Xos, Yhl, Yhl, Yhl, Yhl^Z\, Xos, Yhl, Xos, Xos, Xos, Xos, Xos, Xos, Xos, Xos, Xos, Xos^Efs, Urb, Urb, Rr, Rr, Urb, Cud, Xos, Xos, Xos, Xos, Xos, Xos, Xos, Xos, Xos, Xos, Xos, Xos, Xos, Xoc, Yhl^Xp, Xos, Xoc, Xoc, Xoc, Xoc, Xoc, Xoc, Xoc, Xoc, Xoc, Xoc, Xoc, Urb, Urb, Rr, Rr, Rr, Urb, Urb, Xoc, Xoc, Xos, Xos, Xu, Xu, Xu, Xu, Xu, Xu, Xu, Xos, Xos, Xos, Xos, Urb
Xos, Xos, Xos, Xos, Xos, Xos, Yhl, Yhl, Xos, Yhl, Xos, Xos, Yhl, Yhl, Xos, Xos, Xos, Xos, Xos, Xos, Xos^Efs, Xos^Efs, Urb, Urb, Rr, Rr, Urb, Urb, Xos, Xos, Xos, Xos, Xos, Xos, Xos, Xos, Xos, Xos, Xos, Xos, Xos, Xos, Xos, Xos, Yhl, Xos, Xos, Xoc, Xoc, Xoc, Xoc, Xoc, Xoc, Xoc, Xoc, Xoc, Xoc, Xoc, Xoc, Urb, Urb, Rr, Rr, Urb, Urb, Xoc, Xoc, Xos, Xos, Xu, Xu, Xu, Xu, Xu, Xu, Xu, Xu, Xos, Xos, Xos
Xos, Xos, Xos, Xos, Yhl, Yhl, Xos, Xos, Xos, Xos, Yhl, Yhl, Xos, Xos, Xos, Xos, Xos, Xos, Xos, Xos, Urb, Urb, Rr, Rr, Urb, Urb, Xos, Xos, Xos, Xos, Xos, Xos, Xos, Xos, Xos, Xos, Xos, Xos, Xos, Xos, Xos, Xos, Xos, Xol, Yhl, Xos, Xos, Xos, Xoc, Xoc, Xoc, Xoc, Xoc, Xoc, Xoc, Xoc, Xoc, Xoc, Xoc, Xoc, Xoc, Urb, Urb, Rr, Cud, Cud, Urb, Xoc, Xos, Xos, Xu, Xu, Xu, Xu, Xu, Xu, Xu, Xu, Xu, Xos
