border_size=1
usage=map

Rr, Gs, Gs, Gs, Gs^Fdw, Gs^Fdw, Gd^Dr, Gd^Fdw, Gs, Cud, Xos, Xos, Xu, Xu, Xu, Xu, Xu, Xu, Xos, Xos, Xos, Xu, Xu, Xu, Xu, Xu, Xu, Xu, Xos, Xos, Xos, Xos, Xos, Xu, Xu, Xu, Xu, Xu, Xu, Xu, Xu, Xu, Xu, Xu, Xu, Xu, Xu, Xu, Xu, Xu, Xu, Xu, Xu, Xu, Xu, Xu, Xu, Xu, Xu, Xu, Xu, Xu, Xu, Xu, Xu, Xos, Xos, Xos, Xu, Xu, Xu, Xu, Xu, Xu, Xu, Xu, Xu, Xu, Xu, Xu
Rr, Rp, Rr, Cud, Gs, Re^Fdw, Re^Es, Gd^Es, Gd, Cud, Xos, Xos, Xu, Xu, Xu, Xu, Xos, Xos, Xol, Xol, Xu, Xu, Xu, Xu, Cud, Xu, Urb, Xu, Xos, Xos, Cud, Xol, Xol, Xos, Xos, Xu, Xu, Xu, Xu, Xu, Xu, Xu, Xu, Xu, Xu, Xu, Xu, Xu, Xu, Xu, Xu, Xu, Xu, Xu, Xu, Xu, Xu, Xu, Xu, Xu, Xu, Xu, Xu, Xu, Xu, Xos, Xos, Xos, Xu, Xu, Xu, Xu, Xu, Xu, Xu, Xu, Xu, Xu, Xu, Xu
Rp, 1 Rr, Rr, Rr, Rp, Gs, Cud, Re, Gd, Cud, Xos, Xos, Xu, Xu, Xos, Xos, Xos, Xos, Cud, Cud, Urb, Urb, Urb, Urb, Urb, Urb, Urb, Urb, Cud, Iwr, Iwr, Iwr, Cud, Xos, Xos, Xu, Xu, Xu, Xu, Xu, Xu, Xu, Xu, Xu, Xu, Xu, Xu, Xu, Xu, Xu, Xu, Xu, Xu, Xu, Xu, Xu, Xu, Xu, Xu, Xu, Xu, Xu, Xu, Xu, Xu, Xos, Xos, Xu, Xu, Xu, Xu, Xu, Xu, Xu, Xu, Xu, Xu, Xu, Xu, Xu
Gd, Rp, Rr, Rr, Rr, Rp, Rp, Gs, Gs, Cud, Xos, Xos, Xu, Xu, Xos, Xos, Xos, Xos, Cud, Urb, Urb, Urb^Ii, Urb, Urb, Urb, Urb, Xu, Xos, Xos, Iwr, Iwr, Iwr, Cud, Xos, Xos, Xu, Xu, Xu, Xu, Xu, Xu, Xu, Xu, Xu, Xu, Xu, Xu, Xu, Xu, Xu, Xu, Xu, Xu, Xu, Xu, Xu, Xu, Xu, Xu, Xu, Xu, Xu, Xu, Xu, Xos, Xos, Xos, Xu, Xu, Xu, Xu, Xu, Xu, Xu, Xu, Xu, Xu, Xu, Xu, Xu
Re^Es, Gs, Cud, Rr, Rp, Rr, Rr, Rp, Rr, Cud, Xol, Xos, Xu, Xu, Xos, Xos, Xos, Xos, Xos, Cud, Xu, Urb, Xu, Cud, Xu, Xu, Xu, Xu, Xos, Xos, Cud, Xos, Xol, Xos, Xos, Xu, Xu, Xu, Xu, Xu, Xu, Xu, Xu, Xu, Xu, Xu, Xu, Xu, Xu, Xu, Xu, Xu, Xu, Xu, Xu, Xu, Xu, Xu, Xu, Xu, Xu, Xu, Xos, Xos, Xos, Xos, Xu, Xu, Xu, Xu, Xu, Xu, Xu, Xu, Xu, Xu, Xu, Xu, Xu, Xu
Gd^Fdw, Gs, Gd, Gs, Gs, Rr, Rr, Rr, Rr, Urb, Urb, Xol, Xu, Xu, Xos, Xos, Xos, Xos, Xos, Xos, Xos, Xu, Xu, Xu, 4 Kud, Xu, Xu, Xu, Xol, Xol, Urb, Xol, Urb, Xu, Urb, Xu, Xos, Xos, Xos, Xu, Xu, Xu, Xu, Xu, Xu, Xu, Xu, Xu, Xu, Xu, Xu, Xu, Xu, Xu, Xu, Xu, Xu, Xu, Xu, Xu, Xos, Xos, Xos, Xos, Urb, Xu, Xu, Xu, Xu, Xu, Xu, Xu, Xu, Xu, Xu, Xu, Xu, Xu, Xu, Xu
Gd^Dr, Re^Es, Re, Gs^Fdw, Cud, Cud, Xos, Urb, Urb, Rr, Rr, Urb, Urb^Bz, Xu, Xos, Xos, Xos, Xos, Xos, Xos, Xos, Xu, Xu, Cud, Cud, Cud, Xu, Xu, Urb, Urb, Urb, Urb, Urb, Urb, Urb, Urb, Urb, Xos, Xos, Xos, Xos, Xu, Xu, Xu, Xu, Xu, Xu, Xu, Xu, Xu, Xu, Xu, Xu, Xu, Xu, Xu, Xu, Xu, Xu, Xu, Xos, Xos, Urb, Urb, Urb, Urb, Xu, Xu, Xu, Xu, Xu, Xu, Xu, Xu, Xu, Xu, Xu, Xu, Xu, Xu
Gs, Re, Cud, Cud, Xos, Xos, Xos, Xos, Xu, Urb, Urb, Rr, Rr, Urb, Xos, Xos, Xos, Xos, Xos, Xos, Xos, Xu, Xu, Cud, Urb, Urb, Urb, Urb^Bz, Urb, Urb, Xu, Urb, Xos, Urb, Xos, Xos, Xos, Cud, Iwr, Xol, Xol, Xos, Xu, Xu, Xu, Xu, Xu, Xu, Xu, Xu, Xu, Xu, Xu, Xu, Xu, Xu, Xu, Xu, Xu, Xu, Xos, Xos, Xu, Urb, Urb, Xu, Xu, Xu, Xu, Xu, Xu, Xu, Xu, Xu, Xu, Xu, Xu, Xu, Xu, Xu
Cud, Cud, Xos, Xos, Xos, Xos, Xos, Xos, Xu, Xu, Xu, Urb, Rr, Urb, Xol, Xos, Xos, Xos, Xos, Xos, Xos, Xu, Xu, Xu, Urb^Bz, Urb, Urb, Urb, Xu, Xu, Xos, Xos, Xol, Cud, Xol, Xos, Xos, Iwr, Iwr, Iwr, Xos, Xos, Xu, Xu, Xu, Xu, Xu, Xu, Xu, Xu, Xu, Xu, Xu, Xu, Xu, Xu, Xu, Xu, Xu, Xu, Xos, Xos, Urb, Urb, Urb, Xu, Xu, Xu, Xu, Xu, Xu, Xu, Xu, Xu, Xu, Xu, Xu, Xu, Xu, Xu
Xos, Xos, Xos, Xos, Xu, Xu, Xos, Xos, Xos, Xu, Xu, Urb, Rr, Urb, Urb, Xol, Xos, Xos, Xos, Xos, Xol, Xol, Xu, Xu, Urb, Urb, Xu, Xu, Xu, Xos, Xos, Xol, Iwr, Iwr, Iwr, Xol, Xos, Xos, Iwr, Iwr, Xos, Xos, Xu, Xu, Xu, Xu, Xu, Xu, Xu, Xu, Xu, Xu, Xu, Xu, Xu, Xu, Xu, Xu, Xu, Xu, Xos, Xos, Urb, Urb, Urb, Xu, Xu, Xu, Xu, Xu, Xu, Xu, Xu, Xu, Xu, Xu, Xu, Xu, Xu, Xu
Xos, Xos, Xu, Xu, Xu, Xu, Xos, Xos, Xos, Xos, Xos, Urb, Urb, Rr, Rr, Urb, Urb, Xol, Xol, Xos, Cud, Cud, Urb, Xu, Urb^Zz\, Urb, Xu, Xu, Xu, Xos, Xos, Xos, Iwr, Iwr, Iwr, Xos, Xos, Xos, Xos, Xos, Xos, Xos, Xu, Xu, Xu, Xu, Xu, Xu, Xu, Xu, Xu, Xu, Xu, Xu, Xu, Xu, Xu, Xu, Xu, Xu, Xos, Xos, Urb, Urb, Urb, Xu, Xu, Xu, Xu, Xu, Xos, Xu, Xu, Xu, Xu, Xu, Xu, Xu, Xos, Xos
Xu, Xu, Xu, Xu, Xu, Xu, Xos, Xos, Xos, Xos, Xos, Xos, Xos, Urb, Urb^Bz, Rr, Rr, Urb, Urb, Cud^Ebur, Urb, Urb, Rr, Urb, Urb, Urb^Zz\, Xu, Xu, Xu, Xos, Xos, Xos, Xos, Iwr, Xos, Xos, Xos, Xos, Xos, Xos, Xu, Xu, Xu, Xu, Xu, Xu, Xu, Xu, Xu, Xu, Xos, Xu, Xu, Xu, Xu, Xu, Xu, Xu, Xu, Xu, Xos, Xos, Urb, Urb, Urb, Urb, Urb, Xu, Xu, Xu, Xos, Xos, Xu, Xu, Xu, Xu, Xos, Xos, Xos, Xos
Xu, Xu, Xu, Xu, Xu, Xu, Xu, Xos, Xos, Xos, Xos, Xos, Xos, Xol, Xol, Urb, Urb, Rr, Rr, Urb, Rr, Rr, Rr, Rr, Rr, Urb, Urb, Xu, Xu, Xos, Xos, Xos, Xos, Xos, Xos, Xos, Xos, Xos, Xu, Xu, Xu, Xu, Xu, Xu, Xu, Xu, Xu, Xu, Xos, Xos, Xos, Xos, Xu, Xu, Xu, Xu, Xu, Xu, Xu, Xu, Xos, Xos, Xos, Urb, Urb, Urb, Urb, Urb, Urb, Xu, Xos, Xos, Xu, Xu, Xos, Xos, Xos, Xos, Urb, Urb
Xu, Xu, Xu, Xu, Xu, Xu, Xu, Xu, Xos, Xos, Xos, Xos, Xos, Xol, Cud, Cud, Urb, Urb, Rr, Rr, Rr, Rr, Rr, Rr, Rr, Rr, Urb, Urb, Cud, Xos, Xos, Xos, Xos, Xos, Xos, Xos, Xu, Xu, Xu, Xu, Xos, Xos, Xos, Xu, Xu, Xu, Xos, Xos, Xos, Xos, Xu, Xu, Xos, Xos, Xu, Xu, Xu, Xu, Xu, Xu, Xu, Xos, Xos, Xos, Xos, Urb, Urb, Urb, Urb, Urb, Xos, Xos, Xos, Xos, Xos, Xos, Urb, Urb, Urb, Urb
Xu, Xu, Xu, Xu, Xu, Xu, Xos, Xos, Xol, Xos, Xos, Xos, Xu, Xu, Xu, Urb, Urb, Rr, Rr, Rr, Rr, Rr, Rr, Rr, Urb, Urb, Urb, Cud, Xos, Xos, Xos, Xos, Xos, Xos, Xu, Xu, Xu, Xu, Xu, Xu, Xu, Xos, Xos, Xos, Xos, Xos, Xos, Xos, Urb, Urb, Xos, Xos, Xu, Xu, Xos, Xos, Xu, Xu, Xu, Xu, Xu, Xu, Xu, Xos, Xos, Xos, Xos, Urb, Urb, Urb, Xos, Xos, Xos, Xos, Urb, Urb, Urb, Urb, Urb, Urb
Xu, Xu, Xu, Xu, Xos, Xos, Xol, Xol, Iwr, Xu, Xos, Xos, Xu, Xu, Urb, Cud, Cud, Urb, Urb, Rr, Rr, Rr, Urb, Rr, Rr, Urb, Urb^Zz/, Xol, Xol, Xos, Xos, Xos, Xos, Xos, Xu, Xu, Xu, Xu, Xu, Xu, Urb, Urb, Urb^Zz/, Xol, Xol, Xol, Urb^Zz\, Urb, Xos, Xos, Urb, Urb, Xos, Xos, Xu, Xu, Xos, Xos, Xu, Xu, Xu, Xu, Xu, Xu, Xu, Xos, Xos, Urb, Rr, Urb, Xos, Xos, Urb, Urb, Urb, Urb, Urb, Urb, Xos, Xos
Xu, Xu, Xu, Xu, Xu, Xol, Xu, Iwr, Iwr, Iwr, Xos, Xos, Xu, Urb^Bz, Urb, Urb, Xu, Xu, Xu, Urb, Urb, Urb, Cud, Urb, Urb^Zz/, Rr^Zz/, Rr, Urb, Urb, Xos, Xol, Xol, Urb^Zz\, Urb, Urb, Xu, Xos, Xu, Urb, Urb, Xos, Xos, Xol, Urb, Urb, Urb, Urb, Xos, Urb^Zz\, Urb, Xos, Xos, Urb, Urb, Xos, Xos, Xu, Xu, Xu, Xu, Xu, Xu, Xu, Xu, Xu, Xos, Xos, Urb, Rr, Urb, Urb, Urb, Urb, Urb, Urb, Urb, Xos, Xos, Xos, Xos
Xu, Xu, Xu, Xu, Xu, Xu, Xu, Iwr, Iwr, Iwr, Iwr, Xu, Xu, Urb, Urb, Xu, Xu, Xu, Xu, Xu, Xu, Cud, Xos, Xos, Xos, Urb, Urb, Rr, Kud, Cud, Urb, Urb, Urb, Urb^Zz\, Xos, Xos, Xol, Xol, Urb, Xos, Xos, Xol, Urb, Urb, Rr, Rr, Rr, Urb, Urb, Xos, Urb^Zz\, Urb, Xos, Xos, Xu, Xu, Xu, Xu, Xu, Xu, Xu, Xu, Xu, Xu, Xu, Xos, Xos, Urb, Rr, Urb, Urb, Urb, Urb, Urb, Xos, Xos, Xos, Xos, Xu, Xu
Xu, Xu, Xu, Xu, Urb, Xu, Xu, Xu, Xu, Xu, Xu, Urb, Urb, Urb, Urb, Xu, Xu, Xos, Xos, Xu, Xos, Xos, Xos, Xos, Xos, Xos, Xol, Cud, Urb, Rr, Rr, Urb, Cud, Xol, Xol, Xos, Xos, Urb, Xos, Xos, Xos, Urb, Rr, Rr, Urb, Urb, Urb, Rr, Rr, Urb, Xos, Xos, Xu, Xu, Xu, Xu, Xos, Xos, Xu, Xu, Xu, Xu, Xu, Xu, Xu, Xos, Xos, Urb, Rr, Urb, Urb, Urb, Xos, Xos, Xos, Xos, Xu, Xu, Xu, Xu
Xu, Xu, Xu, Xu, Urb, Cud, Urb, Xu, Cud, Xu, Urb, Urb, Urb, Urb, Urb, Xu, Xu, Xol, Xol, Xos, Xos, Xos, Xos, Xos, Xos, Xol, Urb^Zz\, Urb, Urb, Urb, Cud, Kud, Rr, Urb, Xu, Xos, Xos, Urb, Xos, Xos, Xos, Urb, Rr, Urb, Xos, Xos, Xos, Urb, Rr, Urb, Wwg, Wwg^Es, Wwg, Uh, Uu, Xu, Xos, Xos, Xu, Xu, Xu, Xu, Xu, Xu, Xos, Xos, Xos, Urb, Rr, Urb, Xos, Xos, Xos, Xos, Xu, Xu, Xu, Xu, Xu, Xu
Xu, Xu, Xu, Xu, Xu, Urb, Urb, Urb, Urb, Urb, Urb, Urb, Xu, Xu, Xu, Iwr, Iwr, Iwr, Iwr, Xol, Xos, Xos, Xos, Xos, Xu, Urb, Urb, Urb^Zz\, Xos, Xos, Xos, Urb, Rr, Urb, Xol, Xol, Urb, Urb^Zz\, Xos, Xos, Xol, Urb, Rr, Urb, Xos, Xos, Xos, Urb, Rr, Urb, Wwg, Wwg, Wog, Wog, Wog^Es, Wog, Xos, Xos, Xu, Xu, Xu, Xu, Xos, Xos, Xos, Xos, Urb, Urb, Rr, Urb, Xos, Xos, Xu, Xu, Xu, Xu, Xu, Xu, Xu, Xu
Xu, Xu, Xu, Xu, Xu, Cud, Urb, Urb, Xos, Urb, Xos, Urb, Xos, Xu, Xu, Xos, Iwr, Iwr, Iwr, Xu, Xos, Xos, Xos, Xu, Xu, Xu, Xos, Xos, Xos, Xos, Xos, Urb, Rr, Urb, Urb, Urb, Xol, Xos, Xos, Xol, Urb, Cud, Kud, Urb, Xos, Xos, Xos, Urb, Rr, Urb, Wwg, Wog, Wog, Wog, Uh, Xu, Xos, Xos, Xos, Xu, Xos, Xos, Xos, Xos, Urb, Urb, Rr, Rr, Urb, Urb, Xos, Xos, Xu, Xu, Xu, Xu, Xu, Xu, Xu, Xu
Xu, Xu, Xu, Xu, Xu, Urb, Xos, Xos, Xol, Cud, Xos, Cud, Xos, Xos, Xos, Xos, Xu, Iwr, Xos, Xos, Xos, Xos, Xu, Xu, Xu, Xu, Xu, Xos, Xu, Xos, Xos, Urb, Urb, Rr, Rr, Urb, Urb, Xol, Urb, Urb, Rr, Rr, Urb, Cud, Xos, Xos, Xos, Urb, Rr, Urb, Xu, Uh, Uu^Uf, Wog, Xu, Xos, Xos, Xos, Xos, Xos, Xos, Xos, Urb, Urb, Rr, Rr, Urb, Urb, Xos, Xos, Xos, Xos, Xu, Xu, Xu, Xu, Xu, Xu, Xu, Xu
Xu, Xu, Xu, Xu, Xos, Xos, Xos, Xol, Iwr, Iwr, Iwr, Iwr, Xu, Xos, Xos, Xos, Xos, Xos, Xos, Xos, Xu, Xu, Xu, Xu, Xu, Xu, Xu, Xu, Xu, Xos, Xos, Xu, Urb, Urb, Urb, Rr, Rr, Cud, Rr, Rr, Urb, Urb, Xos, Xos, Xos, Xos, Xol, Urb, Rr, Urb, Xu, Xu, Xu, Xu, Xu, Xos, Xos, Xos, Xos, Xos, Urb, Urb, Rr, Rr, Urb, Urb, Xos, Xos, Xos, Xos, Xu, Xu, Xu, Xu, Xu, Xu, Xu, Xu, Xu, Xu
Xu, Xu, Xos, Xos, Xos, Xos, Xu, Cud, Iwr, Iwr, Iwr, Iwr, Xu, Xu, Xos, Xos, Xos, Xos, Xos, Xos, Xu, Xu, Xu, Xu, Xu, Xu, Xu, Xu, Xos, Xos, Xol, Xol, Urb, Xu, Xu, Urb, Urb, Kud, Urb, Urb, Xos, Xos, Xos, Xu, Xu, Xol, Urb, Urb, Rr, Urb, Xu, Xu, Xu, Xu, Xu, Xos, Xos, Xos, Urb, Urb, Rr, Rr, Urb, Urb, Xos, Xos, Xos, Xos, Xu, Xu, Xu, Xu, Xu, Xu, Xu, Xu, Xu, Xu, Xu, Xu
Xos, Xos, Xos, Xos, Xos, Xu, Xu, Xu, Xos, Xos, Xos, Cud, Urb^Bz, Xu, Xos, Xos, Xol, Xu, Urb, Xu, Xu, Xu, Xos, Xu, Xu, Xu, Xu, Xu, Xos, Xos, Urb, Urb^Zz\, Xos, Xos, Xos, Xu, Xu, Cud, Xos, Xos, Xos, Xos, Xu, Xu, Urb, Urb, Rr, Rr, Urb, Urb, Xos, Xu, Xu, Xu, Xu, Xos, Xos, Urb, Rr, Rr, Urb, Urb, Xos, Xos, Xos, Xos, Xu, Xu, Xu, Xu, Xu, Xu, Xu, Xu, Xu, Xu, Xu, Xu, Xu, Xu
Xos, Xos, Xu, Xos, Xos, Xos, Xos, Xos, Xos, Xos, Xos, Urb, Urb, Xu, Urb, Xol, Urb, Urb, Cud, Urb, Urb, Xos, Xos, Xu, Xu, Xu, Xu, Xu, Xos, Xos, Urb, Xos, Xos, Xos, Xos, Xos, Xos, Xos, Xos, Xos, Xol, Xol, Urb, Urb, Rr, Rr, Urb, Urb, Xos, Xos, Xos, Xos, Xu, Xu, Xu, Xos, Xos, Urb, Rr, Urb, Xos, Xos, Xos, Xos, Xu, Xu, Xu, Xu, Xu, Xu, Iwr, Iwr, Cud, Xu, Xu, Xu, Xu, Xu, Xu, Xu
Xu, Xu, Xu, Xu, Xu, Xos, Xos, Xos, Xu, Xos, Xos, Urb, Urb, Urb, Urb, Urb, Urb, Cud, 5 Kud, Cud, Urb, Xos, Xos, Xu, Xu, Xu, Xu, Xu, Urb, Urb, Xos, Xos, Xos, Xu, Xu, Xos, Xos, Xos, Xos, Xos, Xos, Urb, Rr, Rr, Urb, Urb, Xos, Xos, Xos, Xos, Xu, Xu, Xu, Xu, Xu, Xos, Xos, Urb, Rr, Urb, Xos, Xos, Xu, Xu, Xu, Xu, Xu, Xu, Iwr, Iwr, Kud, Cud, Rr, Cud, Kud, Xu, Xu, Xu, Xu, Xu
Xu, Xu, Xu, Xu, Xu, Xu, Xu, Xu, Xu, Xos, Xos, Xu, Urb^Bz, Urb, Urb, Urb, Urb, Cud, Cud, Cud, Urb, Xos, Xos, Xu, Xu, Xu, Xu, Xu, Xos, Xos, Xos, Xos, Xu, Xu, Xu, Xu, Xu, Urb, Urb, Xol, Xol, Urb, Rr, Urb, Xu, Xos, Xos, Xos, Xu, Xu, Xu, Xu, Xu, Xu, Xu, Xos, Xos, Urb, Rr, Urb, Xos, Xos, Xu, Xu, Xu, Xu, Iwr, Iwr, Kud, Cud, Rp, Rp, Rp, Rp, Rp, Cud, Cud, Xu, Xu, Xu
Xu, Xu, Xu, Xu, Xu, Xu, Xu, Xu, Xu, Xos, Xos, Xos, Xos, Xu, Xu, Urb, Xos, Urb, Urb, Urb, Xu, Xos, Xu, Xu, Xu, Xu, Xu, Xu, Xos, Xos, Xu, Xu, Xu, Xu, Xu, Xu, Xu, Xu, Xu, Urb^Zz/, Urb, Urb, Rr, Urb, Xu, Xu, Xos, Xu, Iwr, Xu, Xu, Xu, Xu, Xu, Xos, Xos, Xos, Urb, Rr, Urb, Xos, Xos, Xu, Xu, Iwr, Iwr, Kud, Cud, Rr, Rp, Rp, Rp, Rr, Rp, Kud, Cud, Iwr, Iwr, Xu, Xu
Xu, Xu, Xu, Xu, Xu, Xu, Xu, Xu, Xu, Xu, Xu, Xos, Xos, Xos, Xos, Xu, Xu, Xu, Xu, Xu, Xu, Xu, Xu, Xu, Xu, Xu, Xu, Xu, Xu, Xu, Xu, Xu, Xu, Xu, Xu, Xu, Xu, Xu, Xu, Xu, Xol, Urb, Rr, Urb, Xu, Xu, Xol, Iwr, Iwr, Iwr, Xu, Xu, Xu, Xos, Xos, Xos, Urb, Urb, Rr, Urb, Xos, Xos, Xos, Xu, Xu, Cud, Rp, Rr, Rp, Rp, Rp, Rp, Kud, Cud, Iwr, Iwr, Xu, Xu, Xu, Xu
Xu, Xu, Xu, Xu, Xu, Xu, Xu, Xu, Xu, Xu, Xu, Xu, Xu, Xos, Xos, Xu, Xu, Xu, Xu, Xu, Xu, Xu, Xu, Xu, Xu, Xu, Xu, Xu, Xu, Xu, Xu, Xu, Xu, Xu, Xu, Xu, Xu, Xu, Xos, Xol, Urb, Urb, Rr, Urb, Urb, Xol, Cud, Iwr, Iwr, Iwr, Xos, Xu, Xu, Xos, Xos, Urb, Rr, Rr, Urb, Urb, Xos, Xos, Xos, Xos, Xu, Xu, Rp, Rr, Rp, Rr, Kud, Cud, Iwr, Iwr, Xu, Xu, Xu, Xu, Xu, Xu
Xos, Xu, Xu, Xu, Xu, Xu, Xu, Xu, Xu, Xu, Xu, Xu, Xu, Xu, Xu, Xu, Xu, Xu, Xu, Xu, Xu, Xu, Xu, Xu, Xu, Xu, Xu, Xu, Xu, Xu, Xu, Xu, Xu, Xu, Xu, Xu, Xos, Xos, Urb, Urb^Zz\, Xos, Urb, Urb, Rr, Rr, Urb, Urb, Xol, Xol, Xos, Xos, Xos, Xos, Xos, Xos, Urb, Rr, Urb, Xos, Xos, Xos, Xos, Uh, Xu, Xu, Rp, Xu, Xu, Xu, Cud, Iwr, Iwr, Xu, Xu, Xu, Xu, Xu, Xu, Xu, Xu
Xos, Xos, Xos, Xu, Xu, Xu, Xu, Xu, Xu, Xu, Xu, Xu, Xu, Xu, Xu, Xu, Xu, Xu, Xu, Xu, Xu, Xu, Xu, Xu, Xu, Xu, Xu, Xu, Xu, Xu, Xu, Xu, Xos, Xu, Xos, Xos, Xu, Urb, Xos, Xos, Xu, Xos, Cud, Urb, Urb, Rr, Rr, Urb, Urb, Xos, Xos, Xos, Xos, Xos, Xos, Urb, Rr, Urb, Xos, Xos, Xu, Xu, Uu^Uf, Uh, Uu^Uf, Xu, Xos, Xu, Xu, Xu, Xu, Xu, Xu, Xu, Xu, Xu, Xu, Xu, Xu, Xu
Urb, Xos, Xos, Xos, Xos, Xu, Xu, Xu, Xu, Xu, Xu, Xu, Xu, Xu, Xu, Xu, Xu, Xu, Xu, Xu, Xu, Xu, Xu, Xu, Xu, Xu, Xu, Xu, Xu, Xu, Xos, Xos, Xos, Urb, Xos, Xos, Xos, Xos, Xu, Xu, Iwr, Iwr, Iwr, Xos, Xos, Urb, Urb, Rr, Rr, Urb, Xos, Xos, Xos, Xos, Xos, Urb, Rr, Urb, Xos, Xos, Uh, Uh, Uu^Uf, Uu^Em, Uu^Emf, Uu^Uf, Xos, Xos, Xu, Xu, Xu, Xu, Xu, Xu, Xu, Xu, Xu, Xu, Xu, Xu
Rr, Urb, Urb, Xos, Xos, Xos, Xos, Xu, Xu, Xu, Xu, Xu, Xu, Xu, Xu, Xu, Xu, Xu, Xu, Xu, Xu, Xu, Xu, Xu, Xu, Xu, Xu, Xu, Xu, Xos, Xos, Xos, Xos, Urb^Zz\, Xos, Xos, Xos, Xos, Xu, Xu, Iwr, Iwr, Iwr, Xu, Xu, Xos, Urb, Urb, Rr, Urb, Xos, Xos, Xu, Xos, Xos, Urb, Rr, Urb, Xos, Xos, Xu, Xu, Uu, Urb^Ii, Uu, Uh, Xos, Xos, Xu, Xu, Xu, Xu, Xu, Xu, Xu, Xu, Xu, Xu, Xu, Xu
Urb, Rr, Rr, Urb, Urb, Xos, Xos, Xos, Xos, Xu, Xu, Xu, Xu, Xu, Xu, Xu, Xu, Xu, Xu, Xu, Xu, Xu, Xu, Xu, Xu, Xu, Xos, Xos, Xos, Urb, Urb^Zz/, Xol, Xol, Urb, Xol, Xol, Urb^Zz\, Urb, Xos, Xu, Xu, Iwr, Xu, Xu, Urb, Urb, Rr, Rr, Urb, Urb, Xos, Xos, Xu, Xu, Xu, Urb, Rr, Urb, Xos, Xos, Xu, Xu, Xu, Urb, Xu, Uu^Uf, Xos, Xos, Xu, Xu, Xu, Xu, Xu, Xu, Xu, Xu, Xu, Xu, Xu, Xu
Xos, Urb, Urb, Rr, Rr, Urb, Urb, Xos, Xos, Xos, Xos, Xu, Xu, Xu, Xu, Xu, Xu, Xu, Xu, Xu, Xu, Xu, Xu, Xu, Xu, Xu, Xu, Xos, Xos, Xos, Xol, Urb, Urb, Urb, Urb, Urb, Xol, Xos, Xos, Xos, Xos, Xu, Xu, Xu, Urb, Rr, Urb, Urb, Xu, Xu, Xos, Xos, Xu, Xu, Xu, Urb^Xo, Rr^Xo, Urb, Xu, Xu, Xu, Xu, Xu, Urb, Xu, Xu, Xu, Xos, Xu, Xu, Xu, Xu, Xu, Xu, Xu, Xu, Xu, Xu, Xu, Xu
Xos, Wwg, Wwg, Urb, Urb, Rr, Rr, Urb, Urb, Xos, Xos, Xos, Xos, Xu, Xu, Xu, Xu, Xu, Xu, Xu, Xu, Xu, Xu, Xu, Xu, Xos, Xos, Xu, Xu, Xol, Urb, Urb, Rr, Rr, Rr, Urb, Urb, Xol, Xu, Xu, Xos, Xos, Xol, Xu, Urb, Rr, Urb, Xu, Xu, Xu, Xos, Urb, Urb^Xo, Xu, Xu, Urb, Rr, Urb^Xo, Xu, Xu, Xu, Xu, Xu, Uu, Xu, Xu, Xu, Xu, Xu, Xu, Xu, Xu, Xu, Xu, Xu, Xu, Xu, Xu, Xu, Xu
Xos, Xos, Xos, Xos, Wwg, Urb, Urb, Rr, Rr, Urb, Urb, Xos, Xos, Xos, Xos, Xu, Xu, Xu, Xu, Xu, Xu, Xu, Xu, Xu, Xu, Xu, Xu, Xos, Urb, Urb, Rr, Rr, Urb, Urb, Urb, Rr, Rr, Urb, Urb, Xu, Urb, Xol, Urb, Xu, Urb, Rr, Urb, Xu, Xos, Xos, Xos, Rr, Rr^Xo, Urb, Urb, Urb, Rr, Urb, Xu, Xu, Xos, Xu, Xu, Xu^Uov, Xu, Xu, Xu, Xu, Xu, Xu, Xu, Xu, Xu, Xu, Xu, Xu, Xu, Xu, Xu, Xu
Wwg, Xos, Xos, Xos, Xos, Wwg, Xos, Urb, Urb, Rr, Rr, Urb, Urb, Xos, Xos, Xos, Xos, Xu, Xu, Xu, Xu, Xu, Xu, Xu, Xos, Xos, Xol, Urb, Rr, Rr, Urb, Urb, Xos, Xos, Xos, Urb, Urb, Rr, Rr, Urb, Urb, Urb, Urb, Urb, Rr, Rr, Urb, Xos, Xos, Xos, Xos, Urb, Urb^Xo, Rr, Rr, Urb, Rr, Urb, Xu, Xu, Xos, Xos, Xu, Xu^Uov, Xu, Xu, Xu, Xu, Xu, Xu, Xu, Xu, Xu, Xu, Xu, Xu, Xu, Xu, Xu, Xu
Urb, Xos, Wwg, Xos, Xos, Xos, Wwg, Xos, Urb, Urb, Rr, Rr, Rr, Urb, Urb, Xol, Xol, Xos, Xos, Xu, Xu, Xu, Xos, Xos, Xos, Xol, Urb, Urb, Rr, Urb, Xu, Xu, Xu, Xos, Xu, Xu, Xos, Urb, Urb, Rr, Rr, Rr, Rr, Rr, Urb, Urb, Xu, Xos, Xos, Xos, Xos, Xos, Xos, Urb, Urb, Rr, Rr, Urb, Urb, Xu, Xol, Xos, Xu, Xu^Uov, Xu, Xos, Xos, Xu, Xu, Xu, Xu, Xu, Xu, Xu, Xu, Xu, Xu, Xu, Xu, Xu
Rr, Urb, Urb, Wwg, Xos, Wwg, Urb, Urb, Rr, Rr, Urb, Urb, Urb, Rr, Rr, Urb, Urb, Xol, Xos, Xos, Xos, Xos, Xol, Xol, Urb, Urb, Rr, Rr, Urb, Urb, Xos, Xu, Xu, Xu, Xu, Xu, Xos, Xos, Xos, Urb, Urb, Urb, Urb, Urb, Xos, Xos, Xu, Xos, Xos, Xos, Xos, Xos, Xol, Xol, Urb, Urb, Rr, Rr, Rr, Urb, Urb, Xol, Xu, Xu^Uov, Xu, Xos, Xos, Xos, Xos, Xu, Xu, Xu, Xu, Xu, Xu, Xu, Xu, Xu, Xu, Xu
Urb, Rr, Rr, Urb, Urb, Urb, Rr, Rr, Urb, Urb, Xos, Xos, Xos, Urb, Urb, Rr, Rr, Urb, Urb^Xo, Xol, Xol, Xos, Urb, Urb, Rr, Rr, Urb, Urb, Xos, Xos, Xos, Xu, Xu, Xu, Xu, Xu, Xu, Xos, Xos, Xu, Xos, Xos, Xos, Xu, Xos, Xos, Xu, Xu, Xos, Xos, Xos, Xos, Urb, Urb, Rr, Rr, Urb, Urb, Urb, Rr, Rr, Urb, Urb, Xu^Uov, Xu, Xos, Xos, Xos, Xos, Xos, Xos, Xu, Xu, Xu, Xu, Xu, Xu, Xu, Xu, Xu
Xos, Urb, Urb, Rr, Rr, Rr, Urb, Urb, Xos, Xos, Xos, Xos, Xos, Xos, Xos, Urb, Urb^Xo, Rr^Xo, Rr, Urb, Urb, Urb, Rr, Rr, Urb, Urb, Xos, Xos, Xos, Xos, Xu, Xu, Xu, Xu, Xu, Xu, Xu, Xu, Xu, Xu, Xu, Xos, Xu, Xu, Xos, Xos, Xos, Xos, Xol, Xol, Urb, Urb, Rr, Rr, Urb, Urb, Xos, Xos, Xos, Urb, Urb, Rr, Rr, Urb, Urb, Xos, Xos, Xos, Xos, Xos, Xos, Xos, Xos, Xu, Xu, Xu, Xu, Xu, Xu, Xu
Xos, Xos, Xos, Urb, Urb, Rr, Urb, Xos, Xos, Xos, Xu, Xu, Xu, Xos, Xos, Xos, Xos, Urb, Urb, Rr, Rr, Urb, Rr, Urb, Xos, Xos, Xos, Xos, Xu, Xu, Xu, Xu, Xu, Xu, Xu, Xu, Xu, Xu, Xu, Xu, Xu, Xu, Xu, Xu, Xu, Xos, Xos, Xos, Urb, Urb, Rr, Rr, Urb, Urb, Xos, Xos, Xos, Xos, Xu, Xu, Xu, Urb, Urb, Rr, Urb, Xu, Xu, Xu, Xu, Xu, Xu, Xu, Xu, Xu, Xu, Xu, Xu, Xu, Xu, Xu
Xu, Xos, Xos, Xos, Urb, Rr, Urb, Xos, Xos, Xu, Xu, Xu, Xu, Xu, Xu, Xos, Xos, Xos, Xos, Urb, Urb, Rr, Rr, Urb, Urb, Xol, Xol, Xos, Xos, Xu, Xu, Xu, Xu, Xu, Xu, Xu, Xu, Xu, Xu, Xu, Xu, Xu, Xu, Xu, Xu, Xos, Xos, Urb, Rr, Rr, Urb, Urb, Wwf^Es, Xos, Xos, Xos, Xu, Xu, Xu, Xu, Xu, Xu, Urb, Rr, Urb, Xu, Xu, Xu, Xu, Xu, Xu, Xu, Xu, Xu, Xu, Xu, Xu, Xu, Xu, Xu
Xu, Xu, Xos, Xos, Urb, Rr, Urb, Xos, Xos, Xu, Xu, Xu, Xu, Xu, Xos, Xos, Xos, Xos, Urb, Urb, Rr, Rr, Urb, Rr, Rr, Urb, Urb, Xos, Xol, Xos, Xos, Xu, Xu, Xu, Xu, Xu, Xu, Xu, Xu, Xu, Xu, Xu, Xu, Xu, Xu, Xos, Xos, Urb, Rr, Urb, Wwg, Wwf^Es, Wwg, Xos, Xos, Xu, Xu, Xu, Xu, Xu, Xu, Xu, Urb, Rr, Urb, Xu, Xu, Xu, Xu, Xu, Xu, Xu, Xu, Xu, Xu, Xu, Xu, Xu, Xu, Xu
Xu, Xu, Xos, Xos, Urb, Rr, Urb, Xos, Xos, Xos, Xos, Xu, Xos, Xos, Xos, Xos, Urb, Urb^Xo, Rr^Xo, Rr, Urb, Urb, Xos, Urb, Urb, Rr, Rr, Urb, Urb, Xol, Xos, Xu, Xu, Xu, Xu, Xu, Xu, Xu, Xu, Xu, Xu, Xu, Xu, Xu, Xu, Xos, Xos, Urb, Rr, Urb, Wwg, Wwg, Wog, Xos, Xos, Xos, Xos, Xu, Xu, Xu, Xu, Xu, Urb, Rr, Rr, Urb, Urb, Xu, Xu, Xu, Xu, Xu, Xu, Xu, Xu, Xu, Xu, Xu, Xu, Xu
Xu, Xu, Xos, Xos, Urb, Rr, Rr, Urb, Urb, Xos, Xos, Xos, Xos, Xos, Urb, Urb, Rr, Rr, Urb, Urb^Xo, Xos, Xos, Xos, Xos, Xos, Urb, Urb, Rr, Urb, Xos, Xos, Xu, Xu, Xu, Xu, Xu, Xu, Xu, Xu, Xu, Xu, Xu, Xu, Xu, Xu, Xos, Xos, Urb, Rr, Urb, Wwf^Es, Wwg, Xos, Wog^Xo, Wog, Xos, Xos, Xos, Xos, Xu, Xu, Xu, Xu, Urb, Urb, Rr, Rr, Urb, Urb^Bz, Xu, Xos, Xos, Xos, Xu, Xu, Xu, Xu, Xu, Xu, Xu
Xu, Xu, Xos, Xos, Xos, Urb, Urb, Rr, Rr, Urb, Urb, Xos, Urb, Urb, Rr, Rr, Urb, Urb, Xos, Xos, Xos, Xos, Xu, Xos, Xu, Xu, Urb, Rr, Urb, Xos, Xol, Xos, Xos, Xu, Xu, Xu, Xu, Xu, Xu, Xu, Xu, Xu, Xu, Xu, Xu, Xos, Xos, Urb, Rr, Urb, Xos, Xos, Xos, Xos, Xos, Wog, Wog, Xos, Xos, Xos, Xos, Xu, Xu, Xu, Xu, Urb, Urb^Bz, Rr, Rr, Xos, Rrc, Xol, Xol, Xos, Xos, Xu, Xu, Xu, Xu, Xu
Xu, Xu, Xu, Xos, Xos, Xos, Xos, Urb, Urb, Rr, Rr, Urb, Rr, Rr, Urb, Urb, Xos, Xos, Xos, Xos, Xu, Xu, Xu, Xu, Xu, Xu, Urb, Rr, Rr, Urb, Urb, Xol, Xos, Xu, Xu, Xu, Xu, Xu, Xu, Xu, Xu, Xu, Xu, Xu, Xu, Xos, Xos, Urb, Rr, Urb, Xos, Xos, Xu, Xos, Xos, Xos, Xos, Wog, Wog, Xos, Xos, Xos, Xos, Xu, Xu, Xu, Xos, Xos, Rrc, Rrc, Rrc, Rrc, Rrc, Xos, Xos, Xos, Xos, Xu, Xu, Xu
Xu, Xu, Xu, Xu, Xos, Xos, Xos, Xos, Urb, Urb, Rr, Rr, Urb, Urb, Xos, Xos, Xos, Xos, Xu, Xu, Xu, Xu, Xu, Xu, Xu, Urb, Urb^Bzu, Xos, Rr, Rr, Rr, Urb, Xos, Xos, Xu, Xu, Xu, Xu, Xu, Xu, Xos, Xu, Xu, Xu, Xos, Xos, Xol, Urb, Rr, Urb, Xos, Xos, Xu, Xu, Xu, Xos, Xos, Xos, Xos, Wog, Wog, Xos, Xos, Xu, Xu, Xos, Xos, Xos, Xos, Rrc, Rrc, Rrc, Xos, Xos, Xos, Xos, Xu, Xu, Xu, Xu
Xu, Xu, Xos, Xos, Xos, Xos, Urb, Urb, Rr, Rr, Urb, Urb, Xos, Xos, Xos, Xos, Xu, Xu, Xu, Xu, Xu, Xu, Xu, Xu, Xu, Urb, Urb, Rr, Rr, Rr, Rr, Urb, Xos, Xos, Xu, Xu, Xu, Xu, Xos, Xos, Xos, Xos, Xos, Xos, Xos, Xol, Urb, Urb, Rr, Urb, Xos, Xos, Xu, Xu, Xu, Xu, Xu, Xos, Xos, Xos, Wog^Es, Xos, Xos, Xu, Xu, Xu, Xu, Xos, Xos, Xos, Xos, Xos, Xos, Xos, Xu, Xu, Xu, Xu, Xu, Xu
Xos, Xos, Xos, Xos, Urb, Urb, Rr, Rr, Urb, Urb, Wwg, Wwg, Xos, Xos, Xu, Xu, Xu, Xu, Xu, Xu, Xu, Xu, Xu, Xos, Xos, Urb, Urb, Rr, Rr, Rr, Rr, Urb, Xol, Xos, Xos, Xu, Xos, Xos, Xol, Xol, Urb, Xos, Xol, Xol, Urb, Urb, Rr, Rr, Urb, Urb, Xos, Xos, Xu, Xu, Xu, Xu, Xu, Xu, Xos, Xos, Wog^Es, Xos, Xos, Xu, Xu, Xu, Xu, Xu, Xu, Xos, Xos, Xos, Xu, Xu, Xu, Xu, Xu, Xu, Xu, Xu
Xos, Xos, Urb, Urb, Rr, Rr, Urb, Urb, Wwg, Wwg, Wog, Wog, Xos, Xos, Xu, Xu, Xu, Xu, Xu, Xu, Xu, Xu, Xu, Xos, Xos, Urb, Urb, Urb, Urb^Bzu, Xos, Rr, Urb, Urb, Xol, Xos, Xos, Xol, Xos, Urb, Urb, Rr, Urb, Urb, Urb, Rr, Rr, Urb, Urb, Xos, Xos, Xos, Xos, Xu, Xu, Xu, Xu, Xu, Xu, Xos, Xos, Wog^Es, Xos, Xos, Xu, Xu, Xu, Xu, Xu, Xu, Xu, Xu, Xu, Xu, Xu, Xu, Xu, Xu, Xu, Xu, Xu
Urb, Urb, Rr, Rr, Urb, Urb, Xos, Xos, Xos, Wog, Wog, Wog, Xos, Xos, Xu, Xu, Xu, Xu, Xu, Xu, Xu, Xu, Xu, Xos, Xu, Xu, Xu, Urb, Urb, Urb, Urb, Rr, Rr, Urb, Urb, Xol, Urb, Urb, Rr, Rr, Urb, Rr, Rr, Rr, Urb, Urb, Xos, Xos, Xos, Xos, Xu, Xu, Xu, Xu, Xu, Xu, Xu, Xu, Xos, Xos, Xos, Xos, Xos, Xu, Xu, Xu, Xu, Xu, Xu, Xu, Xu, Xu, Xu, Xu, Xu, Xu, Xu, Xu, Xu, Xu
Rr, Rr, Urb, Urb, Xos, Xos, Xos, Xos, Xos, Xos, Xos, Xos, Xos, Xos, Xu, Xu, Xu, Xu, Xu, Xu, Xu, Xu, Xu, Xu, Xu, Xu, Xu, Xu, Xos, Xos, Xos, Urb, Urb, Rr, Rr, Urb, Rr, Rr, Urb, Urb, Xos, Urb, Urb, Urb, Xos, Xos, Xos, Xos, Xu, Xu, Xu, Xu, Xu, Xu, Xu, Xu, Xu, Xu, Xu, Xos, Xos, Xos, Xu, Xu, Xu, Xu, Xu, Xu, Xu, Xu, Xu, Xu, Xu, Xu, Xu, Xu, Xu, Xu, Xu, Xu
Urb, Urb, Xos, Xos, Xos, Xos, Xu, Xu, Xu, Xos, Xos, Xos, Xu, Xu, Xu, Xu, Xu, Xu, Xu, Xu, Xu, Xu, Xu, Xu, Xu, Xu, Xu, Xu, Xu, Xos, Xos, Xos, Xos, Urb, Urb, Rr, Urb, Urb, Xos, Xos, Xos, Xos, Xos, Xos, Xos, Xos, Xu, Xu, Xu, Xu, Xu, Xu, Xu, Xu, Xu, Xu, Xu, Xu, Xu, Xu, Xu, Xu, Xu, Xu, Xu, Xu, Xu, Xu, Xu, Xu, Xu, Xu, Xu, Xu, Xu, Xu, Xu, Xu, Xu, Xu
Xos, Xos, Xos, Xos, Xu, Xu, Xu, Xu, Xu, Xu, Xu, Xu, Xu, Xu, Xu, Xu, Xu, Xu, Xu, Xu, Xu, Xu, Xu, Xu, Xu, Xu, Xu, Xu, Xu, Xu, Xu, Xos, Xos, Xos, Urb, Rr, Urb, Xos, Xos, Xos, Xu, Xos, Xos, Xos, Xu, Xu, Xu, Xu, Xu, Xu, Xu, Xu, Xu, Xu, Xu, Xu, Xu, Xu, Xu, Xu, Xu, Xu, Xu, Xu, Xu, Xu, Xu, Xu, Xu, Xu, Xu, Xu, Xu, Xu, Xu, Xu, Xu, Xu, Xu, Xu
Xos, Xos, Xu, Xu, Xu, Xu, Xu, Xu, Xu, Xu, Xu, Xu, Xu, Xu, Xu, Xu, Xu, Xu, Xu, Xu, Xu, Xu, Xu, Xu, Xu, Xu, Xu, Xu, Xu, Xu, Xu, Xu, Xos, Xos, Urb^Xo, Rr, Urb^Xo, Xos, Xos, Xu, Xu, Xu, Xu, Xu, Xu, Xu, Xu, Xu, Xu, Xu, Xu, Xu, Xu, Xu, Xu, Xu, Xu, Xu, Xu, Xu, Xu, Xu, Xu, Xu, Xu, Xu, Xu, Xu, Xu, Xu, Xu, Xu, Xu, Xu, Xu, Xu, Xu, Xu, Xu, Xu
Xu, Xu, Xu, Xu, Xu, Xu, Xu, Xu, Xu, Xu, Xu, Xu, Xu, Xu, Xu, Xu, Xu, Xu, Xu, Xu, Xu, Xu, Xu, Xu, Xu, Xu, Xu, Xu, Xu, Xu, Xu, Xu, Xos, Xos, Urb, Rr^Xo, Urb, Xos, Xos, Xu, Xu, Xu, Xu, Xu, Xu, Xu, Xu, Xu, Xu, Xu, Xu, Xu, Xu, Xu, Xu, Xu, Xu, Xu, Xu, Xu, Xu, Xu, Xu, Xu, Xu, Xu, Xu, Xu, Xu, Xu, Xu, Xu, Xu, Xu, Xu, Xu, Xu, Xu, Xu, Xu
Xu, Xu, Xu, Xu, Xu, Xu, Xu, Xu, Xu, Xu, Xu, Xu, Xu, Xu, Xu, Xu, Xu, Xu, Xu, Xu, Xu, Xu, Xu, Xu, Xu, Xu, Xu, Xu, Xu, Xu, Xu, Xu, Xos, Xos, Urb, Rr, Urb, Xos, Xos, Xu, Xu, Xu, Xu, Xu, Xu, Xu, Xu, Xu, Xu, Xu, Xu, Xu, Xu, Xu, Xu, Xu, Xu, Xu, Xu, Xu, Xu, Xu, Xu, Xu, Xu, Xu, Xu, Xu, Xu, Xu, Xu, Xu, Xu, Xu, Xu, Xu, Xu, Xu, Xu, Xu
Xu, Xu, Xu, Xu, Xu, Xu, Xu, Xu, Xu, Xu, Xu, Xu, Xu, Xu, Xu, Xu, Xu, Xu, Xu, Xu, Xu, Xu, Xu, Xu, Xu, Xu, Xu, Xu, Xu, Xu, Xu, Xu, Xos, Xos, Urb, Rr, Urb, Xos, Xos, Xu, Xu, Xu, Xu, Xu, Xu, Xu, Xu, Xu, Xu, Xu, Xu, Xu, Xu, Xu, Xu, Xu, Xu, Xu, Xu, Xu, Xu, Xu, Xu, Xu, Xu, Xu, Xu, Xu, Xu, Xu, Xu, Xu, Xu, Xu, Xu, Xu, Xu, Xu, Xu, Xu
Xu, Xu, Xu, Xu, Xu, Xu, Xu, Xu, Xu, Xu, Xu, Xu, Xu, Xu, Xu, Xu, Xu, Xu, Xu, Xu, Xu, Xu, Xu, Xu, Xu, Xu, Xu, Xu, Xu, Xu, Xos, Xos, Xos, Xos, Urb, Rr, Urb, Xos, Xos, Xu, Xu, Xu, Xu, Xu, Xu, Xu, Xu, Xu, Xu, Xu, Xu, Xu, Xu, Xu, Xu, Xu, Xu, Xu, Xu, Xu, Xu, Xu, Xu, Xu, Xu, Xu, Xu, Xu, Xu, Xu, Xu, Xu, Xu, Xu, Xu, Xu, Xu, Xu, Xu, Xu
Xu, Xu, Xu, Xu, Xu, Xu, Xu, Xu, Xu, Xu, Xu, Xu, Xu, Xu, Xu, Xu, Xu, Xu, Xu, Xu, Xu, Xu, Xu, Xu, Xu, Xu, Xu, Xu, Xos, Xos, Xos, Xos, Urb, Urb, Rr, Rr, Urb, Xos, Xos, Xu, Xu, Xu, Xu, Xu, Xu, Xu, Xu, Xu, Xu, Xu, Xu, Xu, Xu, Xu, Xu, Xu, Xu, Xu, Xu, Xu, Xu, Xu, Xu, Xu, Xu, Xu, Xu, Xu, Xu, Xu, Xu, Xu, Xu, Xu, Xu, Xu, Xu, Xu, Xu, Xu
Xu, Xu, Xu, Xu, Xu, Xu, Xu, Xu, Xu, Xu, Xu, Xu, Xu, Xu, Xu, Xu, Xu, Xu, Xu, Xu, Xu, Xu, Xu, Xu, Xu, Xu, Xu, Xu, Xos, Xos, Urb, Urb, Rr, Rr, Urb, Urb, Xos, Xos, Xos, Xu, Xu, Xu, Xu, Xu, Xu, Xu, Xu, Xu, Xu, Xu, Xu, Xu, Xu, Xu, Xu, Xu, Xu, Xu, Xu, Xu, Xu, Xu, Xu, Xu, Xu, Xu, Xu, Xu, Xu, Xu, Xu, Xu, Xu, Xu, Xu, Xu, Xu, Xu, Xu, Xu
Xu, Xu, Xu, Xu, Xu, Xu, Xu, Xu, Xu, Xu, Xu, Xu, Xu, Xu, Xu, Xu, Xu, Xu, Xu, Xu, Xu, Xu, Xu, Xu, Xu, Xu, Xu, Xu, Xos, Xos, Urb, Rr, Urb, Urb, Xos, Xos, Xos, Xos, Xu, Xu, Xu, Xu, Xu, Xu, Xu, Xu, Xu, Xu, Xu, Xu, Xu, Xu, Xu, Xu, Xu, Xu, Xu, Xu, Xu, Xu, Xu, Xu, Xu, Xu, Xu, Xu, Xu, Xu, Xu, Xu, Xu, Xu, Xu, Xu, Xu, Xu, Xu, Xu, Xu, Xu
Xu, Xu, Xu, Xu, Xu, Xu, Xu, Xu, Xu, Xu, Xu, Xu, Xu, Xu, Xu, Xu, Xu, Xu, Xu, Xu, Xu, Xu, Xu, Xu, Xu, Xu, Xu, Xu, Xos, Xos, Urb, Rr, Urb, Xos, Xos, Xos, Xu, Xu, Xu, Xu, Xu, Xu, Xu, Xu, Xu, Xu, Xu, Xu, Xu, Xu, Xu, Xu, Xu, Xu, Xu, Xu, Xu, Xu, Xu, Xu, Xu, Xu, Xu, Xu, Xu, Xu, Xu, Xu, Xu, Xu, Xu, Xu, Xu, Xu, Xu, Xu, Xu, Xu, Xu, Xu
