Wog, Wog, Wog, Wog, Wog, Wog, Wog, Wog, Wwg, Wwg, Wwrg, Wwrg, Wwg, Wwg, Wwg, Wwg, Wwg, Wwg, Wwg, Wwg, Wwg, Wwg, Wwg, Wog, Wog, Wog, Wwg, Wwg, Wwrg, Wwg, Wwg^Xo, Wwg, Wwg, Wwg, Wwg, Wwg, Ds^Es, Ds, Gs, Gs, Gs, Gll^Fp, Gll^Fms, Hh^Fms, Hh^Fp, Hh^Fp, Mm, Mm, Mm, Mm, Hh, Gs^Fms, Hh^Fp, Gs^Fms, Gll^Fp, Gll^Fp, Gg, Re, Re, Gg, Gg, Gg, Gll^Fp, Gll^Fp, Gg, Gg, Gll^Fp, Gll^Fp, Gg, Gg, Gg, Gg, Ds, Gg, Gg, Gll^Fp, Gll^Fmw
Wog, Wog, Wog, Wog, Wog, Wog, Wog, Wog, Wog, Wwg, Wwrg, Wwrg, Wwg, Wwg, Wwg, Wwg, Wwg, Wwg, Wwg, Wwg, Wwg, Wwg, Wog, Wog, Wwg, Wog, Wwg, Wwg, Wwrg, Wwg, Wwrg^Xo, Wwg, Wwg, Wwg, Wwg, Wwf^Es, Ds^Esd, Ds, Gg^Esd, Gs, Gs, Gll^Fp, Hh^Fms, Hh^Fp, Gll^Fp, Hh, Hh, Mm, Mm, Mm, Hh^Fp, Hh^Fms, Hh^Fmw, Gs^Fms, Gll^Fp, Gll^Fp, Re^Edt, Re, Re^Vct, Gg, Gg, Gll^Fp, Gs^Fms, Gll^Fp, Gll^Fp, Gll^Fp, Gll^Fp, Gg, Gg, Gg, Gg, Gg, Ds, Gg, Gs, Gll^Fmw, Gs^Fdw
Wog, Wog, Wog, Wog, Wog, Wog, Wog, Wog, Wwg, Wwg, Wwg, Wwg, Ds, Wwrg, Wwrg, Wwg, Wwg, Wwg, Wwrg, Wwg, Wwg, Wwg, Wwg, Wog, Wwg, Wwg, Wwg, Wwg, Wwg, Wwg, Wwg^Xo, Wwrg, Wwrg, Ds, Ds, Ds, Gs, Gs^Esd, Gg, Gg, Gs, Gll^Fp, Gll^Fmw, Hh^Fp, Gg, Gg, Mm, Mm, Hh, Hh, Gll^Fp, Gs^Fms, Gll^Fp, Gg^Edt, Gg, Re^Edt, Re, Re, Gg, Gg, Gll^Fp, Gll^Fp, Gg, Gs^Fms, Gll^Fp, Gll^Fp, Gg, Gll^Fp, Gs, Gll^Fp, Gg, Ds, Ds^Esd, Gg, Gg, Gg, Gs^Fdw
Wog, Wog, Wog, Wog, Wog, Wog, Wog, Wog, Wwg, Wwg, Ds, Wwrg, Wwrg, Wwg, Ds, Wwg, Wwg, Ds, Wwg, Wwg, Wwrg, Wwg, Wwg, Wwg, Wwg, Wwg, Wwrg, Wwrg, Ds, Wwg, Wwrg^Xo, Wwg, Wwrg, Wwf, Wwf, Ds^Esd, Ds^Esd, Gg, Gg^Esd, Gs, Gs, Gg, Gll^Fmw, Gll^Fms, Gg, Hh, Mm, Mm, Hh, Gg, Gll^Fms, Gll^Fp, Gs^Vct, Gg, Ce, Re, Ce, Re^Edt, Gs^Vct, Gg, Re, Gg, Gll^Fp, Gll^Fp, Gll^Fp, Gll^Fp, Gs^Fms, Gll^Fp, Gs, Gg, Gg, Ds, Gg, Ds, Gg, Gs, Gs^Fdw
Wog, Wog, Wog, Wog, Wog, Wog, Wog, Wog, Wog, Wwg, Ds, Ds, Wwg, Wwg, Wwg, Wwrg, Wwg, Wwg, Wwg, Wwg, Wwg, Wwrg, Ds, Wwg, Wwrg, Wwg, Wwg, Wwg, Ds^Es, Ds, Wwg^Xo, Wwg^Vm, Wwg, Wwrg, Wwg^Ewf, Ds, Ds, Gg, Gg, Gs, Gs, Gll^Fp, Ss^Tf, Gll^Fp, Hh^Fp, Hh, Hh, Hh, Hh^Fp, Gg, Gs^Vct, Re^Edt, Re, Gg, Ce, Ce, Ce, Re, Gg^Ecf, Re, Gg^Vct, Gg, Gll^Fp, Gs^Fms, Gll^Fp, Gd^Fmw, Gs^Fms, Gll^Fp, Gg, Gs, Gg, Gg, Gg, Gg^Es, Gg, Gs^Fdw, Gg
Wog, Wog, Wog, Wog, Wwg, Wwg, Wwg, Wog, Wog, Wwg, Wwg, Wwrg, Ds, Wwg, Wwg, Wwg, Wwg, Wwg, Wwg, Wwg, Wwrg, Wwrg, Wwg, Ds, Wwg, Wwrg, Wwg, Wwrg, Wwg, Ds, Wwg^Xo, Wwg, Wog, Wwg, Wwf^Es, Wwf^Ewl, Wwf^Ewl, Gg^Esd, Gg, Gs, Gll^Fp, Ss^Emf, Ss, Ss^Emf, Hh, Hh, Gg, Hh, Hh^Fms, Gs^Fms, Gg, Gg, Re, Re, Ce, 1 Ke, Ce, Re, Re, Re, Re, Gg, Gd^Fmw, Gs^Fms, Gs^Fms, Gd^Fmw, Gd^Fmw, Gll^Fp, Gg^Em, Gg, Gg, Gs, Gg, Gg, Gg, Gs, Re
Wog, Wog, Wog, Wog, Wwg, Wwg, Wwrg, Wwg, Wwg, Wwg, Wwg, Wwg, Wwg, Wwg, Wwrg, Wwrg, Wwrg, Wwg, Wwg, Wwg, Wog, Wwrg, Wwg, Wwrg, Wog, Wwg, Wwg, Wwg, Wwg, Wwg, Wwg^Xo, Wwg, Wwg, Wwg, Wwg, Wwg^Ewl, Wwg^Ewf, Ss, Ss, Gs, Ss, Ss, Gg, Hh, Gg, Gg, Hh, Hh, Gg, Gll^Fp, Gll^Fp, Gs^Vct, Gg^Ecf, Gg, Re, Ce, Re, Gg^Edt, Re, Gg^Vct, Gg, Gll^Fp, Gs^Fms, Gs^Fms, Gs^Fms, Gll^Fp, Gll^Fp, Gs^Fms, Gll^Fp, Gll^Fp, Gg, Gg, Gg, Gg, Re, Gg, Re
Wog, Wog, Wog, Wog, Wog, Wwg, Wwrg, Wwg, Wwg, Wwg^Vm, Yhs, Wwrg, Wwrg, Wwg, Wwg, Wwrg, Wwrg, Wog, Wwg, Wwg, Wwg, Wwg, Wwg, Wwg, Wog, Wog, Wwg, Wwg, Wwg, Wwg, Ds^Xo, Wwf^Esd, Wwg, Wwg, Wwrg, Wwg, Ds, Ds^Esd, Ss, Ss, Ss^Emf, Gll^Fp, Gs, Gg, Gg, Gg, Gg, Gg, Gg, Gg, Gg, Gg, Gg, Gg^Es, Re, Re, Re, Re, Re, Gg^Edt, Gll^Fp, Gll^Fp, Gg, Gll^Fp, Gd^Fmw, Gll^Fp, Gll^Fp, Gll^Fp, Gs^Fms, Gll^Fp, Gg, Gg^Efm, Gg, Re, Gg, Re, Gg
Wog, Wog, Wog, Wog, Wog, Wwg, Wwrg, Wwrg, Wwg, Ds, Yhs^Xp, Ds, Wwrg, Wwg, Wwg, Wwrg, Wog, Wog, Wog, Wwg, Wwg, Wwg, Wwg, Wwg, Wwg, Wog, Wwg, Wwg, Wwg, Wwg, Wwg^Xo, Wwg, Wwg, Wwg, Wwg, Ds^Esd, Ds, Ds^Esd, Ss, Ss, Gll^Fp, Gll^Fp, Gs, Gg, Gll^Fp, Gg, Gg, Gg^Efm, Gg^Efm, Gg, Gll^Fp, Gll^Fp, Gg, Re, Gs^Vct, Gg^Ecf, Gg^Edt, Re, Re, Re^Edt, Gg, Gll^Fp, Gg, Gll^Fp, Gg, Gd^Fmw, Gg, Gg, Gll^Fp, Gll^Fp, Gg, Gg, Re, Re, Gg, Gg, Gg^Efm
Wog, Wog, Wog, Wog, Wog, Wwg, Wwg, Wwg, Wwrg, Ds, Yhs, Yhs^Xp, Wwg, Wwg, Wwg, Wwg, Wwg, Wog, Wog, Wog, Wwg, Wwg, Wwg, Wwg, Wwg, Wwg, Wwg, Wwg, Wwg, Wwg, Ds^Xo, Wwg, Wwf, Wwg, Wwg, Wwrg, Wwrg, Ds, Ss, Gll^Fms, Gg, Gs^Em, Gg, Gs, Gll^Fmw, Gg, Gg, Gg, Gg, Gg, Gg, Gg, Gll^Fp, Gll^Fms, Gg, Gg, Gll^Fp, Re, Re, Re, Re, Gs, Gg, Gs, Gs, Gg, Gs, Gg, Gg, Gg, Re, Rd, Gg, Re, Gg, Gg, Gg
Wog, Wog, Wog, Wog, Wwrg, Wwg, Wwg, Wwg, Wwrg, Yhs^Xp, Wwf^Es, Ds, Wwg, Wwg, Wog, Wwg, Wwg, Wog, Wog, Wog, Wog, Wwg, Wwg, Wwg, Wwrg, Ds, Wwg, Wwg, Wwrg, Wwg, Wwg^Xo, Ds, Wwg, Wog, Wog, Wwg, Wwg, Wwg, Ds, Ds, Ds^Esd, Gg, Gg, Gll^Fp, Ds^Esd, Gs, Gg, Gg, Gg^Esd, Gg, Gg^Efm, Gg, Gg, Gll^Fp, Gll^Fp, Gll^Fmw, Gll^Fmw, Gg, Gg, Re, Re, Gg, Gg, Gg, Gg, Gg, Gg, Gg, Gg, Re, Re, Gg^Es, Gg, Re^Edt, Gll^Fmw, Gg, Gg
Wog, Wog, Wog, Wwrg, Wwrg, Wwg, Yhs^Xp, Wwg, Wwg, Wwrg, Wwg, Wwg, Wog, Wog, Wog, Wwg, Wog, Wog, Wog, Wog, Wog, Wog, Wwg, Wwg, Wwg, Wwg^Vm, Wwg, Wwrg, Wwg, Wwg, Wwg^Xo, Ds, Wwg, Wog, Wog, Wog, Wwg, Wwg, Wwg, Ds^Es, Ds, Ds, Ds, Ds, Wwrg, Ds, Wwg^Ewl, Ds, Ds^Esd, Gg, Gg, Gg, Gll^Fp, Gll^Fmw, Gs, Gll^Fms, Gll^Fp, Gll^Fp, Gg^Es, Gg, Re, Rd, Rd, Gg, Gg, Gg, Re, Re, Re, Re, Gg^Vhr, Gg, Gg, Gg, Gll^Fp, Gg, Gg
Wog, Wog, Wwrg, Wwrg, Wwg, Wwg, Wwf^Es, Ds, Ds, Wwf, Wwg, Wwg, Wog, Wog, Wog, Wog, Wog, Wog, Wwg, Wwg, Wwg, Wog, Wwg, Wwg, Wwg, Wwg, Wog, Wwg, Wwg, Ds^Es, Ds^Xo, Wwf^Es, Wwrg, Wwg, Wog, Wog, Ds, Wwrg, Wwg, Wwrg, Wwg, Wwg, Wwg, Wwg, Wwg, Wwg^Ewl, Wwg^Ewl, Wwrg, Ds^Esd, Gg, Gg, Gll^Fp, Gg, Gs, Gs, Gll^Fp, Gs, Gg, Gg, Gg, Gg^Esd, Gg, Gg, Re, Gg, Gg, Re, Gg, Re, Re^Edt, Gg, Gg^Edt, Gg, Gll^Fp, Gll^Fmw, Gg, Gg
Wog, Wog, Wwrg, Wwg, Wwg, Wwg, Wwrg, Ds, Yhs^Xp, Yhs^Xp, Wwg, Wwg, Wog, Wog, Wog, Wog, Wwg, Wwg, Wwg, Wwg, Wwg, Wwg, Wwg, Wwg, Ds, Wwg, Wog, Wog, Wwg, Ds, Hd^Xo, Hd, Hd, Ds, Ds, Wog, Wwg, Wwg, Wwf, Wwg, Wwrg, Wwg, Wwg, Wwrg, Ds, Wwrg, Wwrg, Wwg, Wwg, Ds, Gg, Gg, Gg, Gg, Ds, Gg, Gs, Gs, Gg, Ds^Es, Ds^Esd, Gg, Gg, Rd, Re, Re, Gg, Gg, Gg, Gg, Gg, Gg, Gg, Gll^Fp, Gs, Gd, Gg
Wog, Wog, Wwg, Wwg, Wwf^Es, Wwg, Wwg, Wwf, Yhs, Wwg, Wwg, Wog, Wog, Wog, Wog, Wog, Wwg, Wwg, Wog, Wwrg, Wwrg, Wwg, Wwg, Wwrg, Ds^Fdw, Wwg, Wwg, Wog, Wwg, Wwrg, Ds^Xo, Ds, Ds, Ds, Wwf^Es, Wwrg, Wwg, Wwg, Ds^Fdw, Ds, Ds^Es, Wwrg, Wwg, Ds, Ds, Ds, Wwg, Wog, Wog, Wwg^Ewl, Wwg^Ewf, Ds^Esd, Ds^Esd, Gs, Gg, Gg^Esd, Gg, Gg, Gg, Ds^Esd, Gg, Gg, Gg, Gg, Re, Re, Gg, Gll^Fdw, Gd^Fmw, Gg, Gg, Gs, Gs, Gs, Gs, Gs, Gs^Fdw
Wog, Wog, Wwg^Vm, Wwg, Yhs^Xp, Yhs^Xp, Yhs, Wwg, Wwg, Wwf^Es, Wwg, Wog, Wog, Wog, Wog, Wog, Wwg, Wwg, Wwg, Wog, Wwg, Wwg, Wwg, Wwrg, Ds, Ds, Wwg, Wog, Wwg, Wwg, Wwrg^Xo, Wwrg, Wwrg, Wwf, Wwg, Wwg, Wog, Wwrg, Wwrg, Ds, Ds, Wwf, Wwg, Wwrg, Ds^Es, Ds^Fdw, Ds^Es, Wwg, Wog, Wwg^Ewl, Wwg^Ewl, Ds, Ds, Gs, Gg, Gg, Re^Gvs, Re^Gvs, Re^Gvs, Gg, Gll^Fp, Gll^Fmw, Gg, Gg, Re, Re, Re^Edt, Gd^Fetd, Gs, Ds, Ds, Gs, Gd, Gg, Gg, Gs, Gd^Fmw
Wog, Wwg, Wwg, Wwg, Yhs, Cme, Cme, Wwf, Wwg, Wwg, Wwg, Wwg, Wog, Wog, Wog, Wog, Wwg, Wwrg, Wwg, Wog, Wwg, Wwg, Wwg, Wwg^Vm, Wwg^Es, Wwg, Wwg, Wwg, Wwg, Wwg, Wwg^Xo, Wwf^Es, Wwg, Ds, Wwg, Wog, Wog, Wwg, Wwrg, Ds^Fdw, Ds, Wwf, Ds, Wwg, Wwg, Ds, Ds, Wwg, Wwg, Wwg, Wwg, Wwf^Es, Ds^Esd, Gg, Gg, Re^Gvs, Re^Gvs, Re^Gvs, Gg, Gg, Gs^Fdw, Gd^Fmw, Re, Re, Rp, Re, Gs, Gs, Gs, Ds^Es, Ds, Ds^Esd, Ds^Es, Ds, Gs, Gd^Fdw, Gs
Wwrg, Wwrg, Wwg, Wwf^Es, Cme, 8 Kme, Yhs, Ds, Wwg, Wwg^Vm, Wwrg, Wwg, Wog, Wog, Wog, Wwg, Wwrg, Wwrg, Wwg, Wwg, Wwg, Wwrg, Wwg, Wwg, Wwg, Wwg, Wwg, Wwg, Wwg, Wwg, Ds^Xo, Wwf, Ds, Wwg, Wwg, Wog, Wwg, Wog, Wog, Wwrg, Wwg, Wwrg, Wwg, Wwg, Wwg, Wwrg, Wwrg, Ds, Wwg, Ds, Wwrg, Ds, Gg^Esd, Gg, Gg, Re, Gg, Gg, Gg, Gg, Re, Rp, Re, Re, Gg, Gg, Gs, Gg, Gg, Ds^Es, Ds, Ds, Ds, Ds, Ds^Esd, Gd, Gs
Wwrg, Wwrg, Wwg, Ds, Yhs^Xp, Yhs, Ds, Ds, Wwg, Wwrg, Wwrg, Wwg, Wwg, Wog, Wwg, Wwg, Wwg, Wwg, Wwg, Wwg, Wwrg, Wwrg, Wwg, Wwg, Wwg, Wwg, Wwg, Wwf, Ds, Ds, Hd^Xo, Ds, Ds^Es, Ds, Ds, Wwg, Wwg, Wwg, Wwg, Wwg, Wwg, Wwg, Wwg, Wog, Wog, Wog, Wog, Wwg, Wog, Wwg, Wwg, Ds^Esd, Ds^Esd, Gg, Gs^Vwm, Re, Re, Gs^Vhc, Gg, Gg, Re, Re, Gg, Gg, Gs, Gg, Gg, Gg, Gg, Gg, Ds, Ds, Ds, Ds, Ds, Gs, Ds
Wwrg, Wwg^Vm, Wwg, Cme, Yhs, Ds, Ds, Wwrg, Wwg, Wwrg, Wwg, Wwg, Wwg, Wog, Wwg, Wwg, Ds^Es, Wwrg, Ds, Ds, Ds, Wwf^Es, Wwrg, Wwg, Wwf, Wwg, Wwg^Ewl, Ds, Ss, Ds^Esd, Gg^Xo, Gg, Gs^Vhcr, Gs, Gll^Fp, Gll^Fp, Ss, Wwf^Es, Wwf^Ewl, Wwf, Ds, Wwf, Ds, Wwg, Wwg, Wog, Wwg, Wog, Wog, Wog, Wwg, Wwf, Ds, Gg^Esd, Gg, Gg, Chr, Re, Rp, Re, Re, Re, Gg, Gs, Gs, Gg, Gg, Gs, Gg, Gg, Ds, Gs^Esd, Gs, Ds, Ds, Ds, Ds
Wog, Wwg, Wwg, Wwf^Es, Wwrg, Ds, Wwrg, Wwg, Wwg, Wwrg, Wwg, Wwg, Wwrg, Wwg, Wwg, Wwg, Ds^Es, Ds, Hd, Ds^Edpp, Ds, Ds, Wwg^Ewl, Wwg, Wwf^Ewf, Wwg^Ewl, Wwg^Ewf, Wwg^Ewf, Ss, Ss, Gg^Xo, Gg^Dr, Re^Edt, Gs, Gll^Fp, Gll^Fp, Ss, Ss, Gg, Gll^Fp, Gll^Fp, Ds, Gll^Fp, Ds, Wwf, Wwg, Ds, Wwg, Wwg, Wog, Wog, Wwg, Ch, Ch, Chr, Gg, Rp, Rp, Rp, Re^Edt, Gs^Vhr, Re, Re, Gg, Ce, Ce, Gg, Gg, Ce, Gg, Gg, Gg, Gs, Ds, Gs, Ds^Esd, Ds
Wog, Wwg, Wwg, Wwg, Wwg^Vm, Wwrg, Wwg, Wwg, Wwg, Wwg, Wwg, Wwg, Wog, Wog, Wog, Wwg, Ds, Hd, Hd, Ss, Ss, Ss, Ds, Wwg^Ewl, Wwg^Ewl, Wwf^Es, Ds, Ds, Gs, Ss, Gs^Xo, Gg, Rd^Edt, Gs^Edt, Gg^Em, Gll^Fp, Gll^Fp, Ss^Tf, Ss^Emf, Gll^Fp, Gll^Fp, Gg, Gg, Gll^Fp, Gs^Vwm, Ds, Ds^Es, Wwf, Chr, Ch, Wog, Wog, Wog, Wwg, Rr, Rr, Rp, Rr, Ch, Gg, Gg, Gg, Re, Rp, Rp, Gs^Vh, Gg, Gs, Gg, Ce, Gg, Gg, Gg, Gg, Gd^Fmw, Gs, Ds
Wog, Wog, Wog, Wwg, Wwg, Wwg, Wwg, Wog, Wwg, Wwg, Wwg, Wwg, Wwg, Wwg, Wwg, Wwg, Wwf, Ds^Es, Ds, Ds, Ss, Ds, Ds, Ss, Ss, Ds^Esd, Gs^Esd, Ds, Gll^Fp, Ss, Ss^Xo, Re, Re, Gg, Gg, Gll^Fp, Gs^Em, Gll^Em, Gll^Fp, Ss, Gll^Fp, Gll^Fp, Re^Gvs, Re^Gvs, Re, Gg, Gs^Vhc, Ds, Ch, Wwg^Ewl, Wwrg, Ch, Wwrg, Wwg, Wwg^Bsb/, 4 Kh, Ch, Gg, Gg, Gg, Gg, Gg, Gg, Rp, Rr^Edt, Gg^Edt, Chr, Gg, Gg, Gg, Gg, Gg, Gg, Gll^Fp, Gll^Fp, Gg, Gg
Wog, Wog, Wog, Wwg, Wwg, Wwg, Wwg, Wog, Wog, Wwg, Wwg, Wwg, Wwg, Wwg, Wwrg, Ds^Es, Wwf, Ds, Ds, Ss^Vm, Ss, Ss, Gg, Ss, Ss, Gs^Esd, Gg, Gs, Gll^Fp, Gll^Fp, Ss^Xo, Ss, Re, Gg, Re, Gg, Gs, Gs, Gg, Ss, Gll^Fp, Re^Gvs, Re^Gvs, Re^Gvs, Gs^Vhr, Re, Re, Gg, Ch, Wwg, Wwg, Wwg, Wwg^Bsb/, Wwg^Bsb/, Kh, Wwrg, Wwg^Ewl, Chr, Ch, Gs, Gg, Ce, Gg^Edt, Rp, Rr^Edt, Chr, 5 Khr, Ch, Re, Gs^Vh, Gg, Ce, Gg, Gll^Fp, Gs, Gg, Gg
Wog, Wog, Wog, Wog, Wwg, Wwg, Wog, Wog, Wog, Wwg, Wwg, Wwg, Wwg, Wwrg, Wwrg, Ds, Ds, Wwg, Wwg, Ds, Ds^Esd, Gs, Ds^Esd, Gg, Ss, Ss, Ss^Emf, Ss^Em, Ss^Emf, Ss, Gs^Xo, Ss, Gg, Re, Gg, Gg, Rd, Gs, Gg, Gg, Gg, Gg, Gg, Gg, Gg, Gg, Chr, Re, Rp, Rr, 3 Kh, Wwg^Bsb/, Wwrg, Chr, Ch, Wog, Wwg^Ewl, Wwf^Ewl, Chr, Gg, Gg, Ce, Re, Re^Edt, Gg, Ch, Chr, Ch, Re^Edt, Gg, Ce, Ce, Gg, Gg, Gs, Gg, Gg
Wog, Wog, Wog, Wog, Wog, Wog, Wog, Wog, Wog, Wog, Wwg, Wwg, Ww^Es, Ds^Es, Ds, Ds, Ds, Wwf, Ds, Wwf, Ds, Gs, Gs, Gg, Gll^Fp, Gll^Fp, Gll^Fp, Gll^Fp, Gll^Fp, Gll^Fp, Hh^Xo, Gll^Fp, Gg^Em, Re, Re^Es, Gg, Gg, Gg, Re, Gg, Re, Re, Re, Re^Edt, Re, Gs, Re, Re, Rp, Rr, Ch, Gg^Fet, Wwg^Ewl, Wwg, Wog^Es, Wwrg, Wwg, Ch, Gg, Gg, Gs^Vh, Re, Gg, Gg^Edt, Gg, Gg, Gg, Re^Edt, Re^Edt, Re, Re, Gg, Gg, Gg, Re^Gvs, Gs, Gg
Wog, Wog, Wog, Wog, Wog, Wog, Wog, Wog, Wog, Wog, Wog, Wwg, Wwg, Wwg, Wwg, Ds^Es, Ds, Ds^Edpp, Ds, Ds, Wwf, Ds^Esd, Ds^Esd, Gs, Gs, Gll^Fp, Gll^Fp, Hh, Hh, Hh, Hh^Xo, Gs, Gg, Re, Re, Gg, Re, Re, Re, Re, Re^Edt, Re, Gg, Re, Re^Edt, Re, Rp, Re, Ch, Re, Gg, Chr, Chr, Wwg, Wwg, Wog, Wog, Wwg, Wwrg, Gg^Esd, Ds^Esd, Gg^Esd, Ds^Esd, Gg, Ce, Gs^Vh, Ce, Gg, Gg^Esd, Re, Gg^Vwm, Re, Re^Gvs, Re^Gvs, Re^Gvs, Re^Gvs, Re^Gvs
Wog, Wog, Wog, Wog, Wog, Wog, Wog, Wog, Wog, Wog, Wog, Wwg, Wwrg, Wwg, Wwg, Ds^Es, Wwg, Wwrg, Ds, Ds, Wwf, Ds, Ds, Gs, Gs, Gll^Fp, Hh, Hh^Fp, Mm, Mm, Hh^Xo, Gg, Gll^Fp, Gg^Em, Gg, Re, Re^Es, Re, Gg, Re^Edt, Gg, Gg, Gs, Gg, Gg, Re, Re, Gg, Gg, Re, Gs^Vhcr, Gg, Gg, Ch, Wwg, Wog, Wog, Wwg, Wwrg, Ds, Ds, Ds, Ds, Ds, Ds, Ce, Gg, Gg, Ds^Edt, Ds^Esd, Gd^Edt, Gs, Gg, Re^Gvs, Re^Gvs, Re^Gvs, Gg
Wog, Wog, Wog, Wog, Wog, Wog, Wog, Wog, Wog, Wog, Wwg, Wwg, Wwg, Wwrg, Wwg, Wwg, Wwrg, Wwrg, Ds, Ds, Ds^Edpp, Wwf, Ds^Edt, Gs^Edt, Gg^Edt, Gg, Gg, Hh, Mm, Mm, Hh^Xo, Hh, Gll^Em, Gll^Fmw, Gll^Fmw, Gg, Gg, Gg, Gg, Gg^Es, Qxu, Gll^Fp, Gll^Fmw, Gg, Gs, Re, Rp^Edt, Gg, Gs^Vd, Re, Re, Gg, Gg, Wwf, Wwrg, Wwg, Wog, Wwg, Wwg, Ds, Wwg, Wwf, Wwg, Wwg^Ewl, Wwf, Ds, Ds^Esd, Gg, Ds^Esd, Ds, Gd^Fmw, Gg, Gg, Gg, Gg, Gg, Gll^Fp
Wog, Wog, Wog, Wog, Wog, Wog, Wog, Wog, Wog, Wog, Wog, Wwg, Wwg, Wwrg, Wwg, Wwg, Wwg, Ds, Ds, Hd, Ds^Es, Ds, Ds^Esd, Gs^Edt, Gg, Gg, Hh, Hh^Fp, Hh, Mm, Hh^Xo, Gll^Fp, Gll^Fp, Gll^Fp, Hh^Fmw, Gll^Fp, Gg^Em, Gs^Es, Qxu, Qxu, Gll^Fmw, Gll^Fp, Gg^Em, Gg, Gg^Edt, Rp, Rp^Edt, Gg^Edt, Gg, Gg, Re, Gs^Vhr, Gg, Wwf, Gg, Wwg, Wwg, Wog, Wog, Wwg, Wwg, Wog, Wog, Wwg, Ds, Wwf^Es, Ds, Gg^Esd, Gg, Gg, Gll^Fp, Gll^Fmw, Gll^Fdw, Gg, Gll^Fp, Gs^Emf, Ss
Wog, Wog, Wog, Wog, Wog, Wog, Wog, Wog, Wog, Wog, Wog, Wog, Wwg, Wwg, Wwg, Wwg, Wwg, Ds, Wwg, Ds, Wwf, Ds^Edpp, Ds, Gs, Gs, Hh, Gg, Gg, Hh, Mm^Vhhr, Mm^Xo, Hh^Fp, Hh^Fmw, Hh, Hh, Gll^Fmw, Gll^Fp, Gg, Qxu, Gll^Fp, Gll^Fmw, Gll^Fp, Gg, Gg, Chr, Ch, Chr, Re^Edt, Re, Ce, Gs, Gg, Gll^Fmw, Gg, Gll^Fp, Ds, Wwf, Wwg, Wwg, Wog, Wog, Wog, Wog, Wwg, Wwg, Ds, Ds^Esd, Gg, Gg, Gll^Fmw, Gll^Fp, Gll^Fdw, Gll^Fp, Gs^Fdw, Gll^Fdw, Ss^Tf, Ss
Wog, Wog, Wog, Wog, Wog, Wog, Wog, Wog, Wog, Wog, Wog, Wog, Wog, Wwg, Wwg^Vm, Wwg, Wwg, Wwg, Ds, Wwg, Wwg, Ds, Ds^Es, Gs^Edt, Gs, Gg, Gg^Efm, Gg, Gg, Hh, Hh^Xo, Hh, Hh, Hh, Hh, Gll^Fp, Gll^Em, Gg, Gll^Fp, Gll^Fmw, Ce, Gg, Gs^Vh, Gg, Ch, 6 Kh, Chr, Re, Gs, Gg, Gg, Gg, Gs^Em, Gll^Fp, Gll^Fmw, Ds, Ds, Wwrg, Wwf, Wwg, Wwg, Wwg, Wog, Wog, Wog, Wwg, Wwrg, Gg, Gg^Esd, Gg, Ds, Gg, Gll^Fp, Gll^Fetd, Gd^Fmw, Gll^Fp, Ss
Wog, Wog, Wog, Wog, Wwg, Wwg, Wog, Wog, Wwg, Wwg, Wwg, Wwg, Wwg, Wwg, Wwg, Wwg, Wwrg, Wwrg, Ds, Ds, Ds, Wwf^Es, Ds^Esd, Ds^Edt, Gs, Gg, Gg, Gg, Hh, Hh^Fp, Hh^Xo, Hh^Fp, Hh, Hh^Fp, Gll^Fmw, Gll^Em, Gll, Gll, Gll^Fp, Gll^Fp, Re, Gg, Re, Rp, Rp^Edt, Chr, Rp, Re^Edt, Gg, Gg, Ce, Gg, Gg, Gll^Fp, Gll^Fmw, Gll^Fp, Ds, Ds, Ds, Wwf^Ewl, Ds, Wwg, Wwg, Wog, Wog, Wwg, Wwg, Ds^Esd, Ds, Ds^Esd, Ds^Dr, Ds^Esd, Gg, Gll^Fp, Wwg^Ewl, Ss, Gll^Fp
Wog, Wwg, Wwg, Wog, Wwg, Wwg, Wwg, Wog, Wwg, Wwg, Wwrg, Wwg, Wwg, Wwg, Wwg, Wwg, Wwf, Wwrg, Ds^Es, Ds, Wwf, Wwf, Ds, Gs, Gg, Gg, Gg, Hh, Gg, Hh, Gg^Xo, Gg, Hh, Hh, Gll^Fmw, Gd^Fmw, Gs, Gg, Re, Re, Re, Re, Re, Rp, Gs^Edt, Gg^Edt, Re, Rp, Re, Gs^Vh, Ce, Gg, Gg^Em, Gll^Fp, Gll^Em, Gll^Fp, Gg^Esd, Ds^Esd, Ds^Esd, Ds, Ds^Esd, Ds, Ds, Wwrg, Wwrg, Wog, Wwg, Wwg, Wwg, Ds, Wwrg, Ds^Esd, Ds, Wwg^Ewl, Wwg^Ewf, Wwg^Ewl, Ds
Wog, Wwg, Wwg, Wwg, Wwg, Wwg, Wwg, Wwg, Wwg, Wwg, Wwrg, Wwg, Wwg, Wwrg, Wwg, Wwg, Wwg, Ds, Ds, Ds, Wwf, Wwf, Wwf, Ds^Esd, Gg, Gg, Hh, Gg, Gs, Gg, Gg^Xo, Hh, Hh, Gg, Gll^Fp, Gll^Fp, Gg, Gg, Re, Re, Gll^Fp, Gg, Gll^Fmw, Gg, Gg, Ce, Gg, Re, Re, Ce, Gg, Gs, Gg, Gll^Fmw, Gs, Gs, Gg, Gg, Gg, Gs, Gs, Gs^Esd, Gg, Gg, Wwrg, Wog, Wog, Wog, Wog, Wwg, Wog, Wwrg, Wwg, Wwrg, Wwg, Wwg, Ds
Wog, Wog, Wwg, Wwg, Wwg, Wwg, Wwg, Wwg, Wwg, Wwrg, Wwg, Wwg, Wwg, Wwg, Wwg, Wwg, Wwg, Wwg, Wwg, Wwf, Ds, Ds, Ds^Esd, Gs, Gg, Hh, Gg, Gg, Gll^Fp, Gll^Fmw, Gg^Xo, Hh, Gg, Gg, Gg^Efm, Gg, Re, Re, Re, Qxu, Qxu, Gll^Em, Gll^Fmw, Gll^Fp, Gg, Gs, Gs^Vh, Re, Re, Gg, Gg, Gg, Gs, Gs, Gg, Gll^Fp, Gll^Fp, Gg, Gg, Gg^Es, Gg^Es, Gs, Gg, Gg, Wwg, Wwg, Wwg, Wog, Wwg, Wog, Wog, Wog, Wog, Wwg, Wog, Wwg^Ewl, Wwg
Wog, Wwg, Wwg, Wwg, Wwg, Wwg, Wwf, Wwg, Wwg, Wwg, Wwrg, Ds, Ds, Wwg, Wwg, Wwf, Ds, Wwg, Wwg, Ds, Gs^Edt, Ds^Esd, Gg, Gg, Gg, Gg, Hh, Gg, Gll^Fp, Gll^Fmw, Gs^Xo, Gs^Xo, Gll^Xo, Gg^Xo, Gg^Xo, Gg^Xo, Gg^Xo, Gg^Xo, Gg^Xo, Gg^Xo, Gg^Xo, Qxu^Xo, Gll^Xo, Gs^Xo, Gg^Xo, Gg^Xo, Gg^Xo, Re^Xo, Re^Xo, Gg^Xo, Gg^Xo, Gg^Xo, Gll^Xo, Gs^Xo, Gg^Xo, Gll^Xo, Gll^Xo, Gg^Xo, Gg^Xo, Qxu^Xo, Gg^Xo, Gs^Xo, Gs^Xo, Ds^Xo, Wwg^Xo, Wwg^Xo, Ss^Xo, Wwg^Xo, Ss^Xo, Wwg^Xo, Wwg^Xo, Wog^Xo, Wog^Xo, Wog^Xo, Wog^Xo, Wog^Xo, Wog^Xo
Wwg, Wwg, Wwg, Wwg, Wwg^Vm, Wwg, Wwg, Wwf, Wwg, Wwg, Wwg, Ds, Ds, Ds, Wwg, Wwg, Ds, Ds, Wwf, Ds, Gll^Fp, Gg, Hh, Hh, Hh, Hh, Gg, Gg, Gg, Gg, Gs^Vhr, Gg, Gg, Gg, Gg, Re, Gg, Gg, Gll^Fp, Gg, Gg, Qxu, Qxu, Gll^Fmw, Gll^Fp, Gg, Re, Re, Gg, Gg, Gg, Gll^Fp, Gll^Fp, Gg, Qxu, Gg, Gll^Fp, Gll^Fp, Qxu, Qxu, Gs, Gs, Gs, Ds^Esd, Ds, Wwrg, Ss, Ss, Ss, Ds, Ds, Wwg, Wwg^Ewl, Wwg, Wwg^Ewl, Wog, Wog
Wwg, Wwrg, Wwg, Wwrg, Wwg, Wwg, Ds^Es, Ds^Es, Wwf, Wwg, Wwg, Wwrg, Wwf, Wwg, Wwg, Wwrg, Ds^Esd, Gs, Gs, Gs, Gd^Fmw, Gg, Gg, Hh, Hh, Gg, Gs, Gs^Es, Gg, Gg, Hh, Gg, Gg, Gg, Re, Re^Edt, Gs^Edt, Gs^Edt, Gll^Fp, Gll^Fmw, Gg, Gg^Es, Qxu, Qxu, Qxu, Gg, Re, Re, Gg, Gll^Fp, Gg, Gll^Fp, Gg, Qxu, Gg, Qxu, Qxu, Qxu, Gg, Gg^Es, Gs, Ds, Ds^Esd, Gs^Esd, Ds, Ds, Gs, Gg, Ds, Ss, Ds, Wwg^Ewl, Wwg^Ewl, Wwg^Ewl, Ds, Wwrg, Wwrg
Wwg, Wwg, Wwg, Wwrg, Wwg, Wwrg, Yhs^Xp, Ds, Wwf^Es, Ds, Wwf, Ds, Wwg, Wwg, Wwrg, Ds, Ds, Gg, Gs^Vh, Gd^Fmw, Gs, Gs^Fdw, Gg, Gg, Hh, Gg, Gll^Fp, Gll^Fp, Gg, Gg, Hh, Gg, Re^Edt, Re, Gg^Es, Gg, Gs^Edt, Gs, Gll, Gg, Gg, Gg^Es, Gg, Qxu, Qxu, Gg^Es, Gg, Re, Re, Gg, Gg, Gg^Es, Qxu, Qxu, Gg^Es, Gg, Gg, Gg, Gg, Gs, Gg, Ds, Gs, Gs^Esd, Gg^Esd, Ds^Esd, Gs^Vhr, Ds, Ds^Esd, Ss, Ss, Ss, Gg, Gg, Ds^Es, Ds, Gg
Wwg, Wwg^Vm, Wwg, Wwg, Wwg, Yhs, Ds, Ds, Wwg, Wwg, Wwg, Wwg, Wwg, Wwg, Wwg, Ds, Ds, Ds, Gs, Gs^Edt, Ch, Gs, Gg, Gg, Gg, Gg, Chr, Gll^Fp, Gg, Hh, Gg, Gg^Em, Re, Re, Gg, Gg, Gg, Gll^Fp, Gs, Gs, Gg, Gg^Es, Gs, Gg^Es, Gg^Es, Gg, Gs, Re, Re, Gg, Gg, Qxu, Gg, Gg, Gg, Gg, Gg, Gll^Fmw, Gg, Gg, Gg, Gg^Es, Gs, Gs, Gg, Gg, Gg, Gs^Esd, Gg^Esd, Gs, Gg, Gg, Ds^Esd, Gg, Ds^Esd, Ds, Gg
Wwg, Wwg, Ds^Es, Ds, Ds, Chr, 7 Kme, Cme, Wwg, Wwg^Vm, Wwg, Wwg, Wwg, Wwg, Wwg, Wwf, Wwg, Ds^Esd, Ds, Chr, Khr, Ch, Rr^Edt, Gs^Vh, Gs^Edt, Gg, Gg, Gs, Gg, Gg, Re^Es, Re, Gg, Gg^Em, Gg, Gll^Fp, Gs, Gll^Fp, Gll^Fmw, Gll^Fp, Gs, Gg, Gg, Gs^Vh, Gs, Gg, Gll^Fmw, Gg, Re, Re, Gg, Gg, Gll^Fmw, Gll^Fp, Gg, Gg, Gg, Gg, Re, Gg, Gg, Gg, Gs, Gg, Ds^Esd, Gg, Gs, Gs, Gll^Fdw, Gg, Gll^Fdw, Gd^Fmw, Gs^Fdw, Gs, Gs, Gs, Gs^Fdw
Ds, Wwg, Yhs, Yhs, Yhs^Xp, Yhs, Cme, Wwf, Wwg, Wwg, Wwg, Wog, Wwg, Wwg, Wwg, Wwf, Wwg, Ds, Ds^Esd, Ch, Chr, Ch, Rr^Edt, Rp, Rp, Rp, Re^Es, Gg, Re, Gg^Em, Re, Re, Gg, Gg, Gs, Gg, Gll^Fp, Gll^Fmw, Gll^Fp, Gll, Gg, Hh, Gg, Gs, Gs, Gll^Fp, Gll^Fmw, Gg, Gg, Re, Gg, Gg, Gll^Fp, Gg, Gg, Gll^Fp, Gll^Fp, Gg, Re, Gg, Gg, Gll^Fp, Gs, Ds^Esd, Ds^Es, Gg, Gg, Gg, Gg, Re^Vhr, Gs, Gll^Fdw, Gs, Gs, Ds, Ds, Gs
Ds, Ds, Yhs, Yhs^Xp, Ds, Chw, Wwg, Wwg, Wwg, Wwg, Wog, Wog, Wwg, Wwg, Wwg, Wwg, Wwf, Ds, Gs^Vh, Gs, Gg, Gs^Edt, Gd^Vhr, Rp^Edt, Gs^Edt, Re, Re^Edt, Re, Re, Re, Re^Edt, Re, Re, Gg, Gs, Gg^Em, Gll, Gll^Fmw, Gs, Gll, Gll^Fmw, Hh, Hh^Fp, Gg, Gs, Gll^Fdw, Gs, Gs, Re, Re, Gg^Es, Gg, Gg, Gg, Gg, Gll^Fp, Gs, Gg, Re, Gg, Re, Gs, Re, Gg, Re, Rd^Esd, Re^Edb, Gg, Re, Re, Re, Gg, Gs, Yhs, Yhs, Ds^Esd, Ds
Wwg, Wwf, Yhs^Xp, Ds, Wwrg, Wwrg, Wwg^Vm, Wwg, Wog, Wwg, Wog, Wwg, Wwg, Wwg, Wwg, Wwg, Ds, Ds, Gg, Gs^Edt, Gs, Gg, Gs^Edt, Gs^Edt, Gll^Fdw, Gg, Gs, Gg, Gg, Gg, Gg, Re^Es, Re, Gg, Gg, Gs, Gll, Gll^Fp, Gg, Gg, Gll^Fp, Gll^Fp, Hh^Fmw, Gs, Gs, Gg, Gg, Gg, Gg, Re, Re, Gg, Gg, Re, Re, Gs, Re, Re, Re, Re, Re, Re, Re, Re, Re, Re^Edb, Re^Edb, Re^Edb, Chr, Chr, Ch, Gg, Gs^Fdw, Ds^Esd, Yhs^Xp, Yhs, Yhs^Xp
Wwrg, Wwg, Wwg, Ds^Es, Wwg, Wwrg, Wwg, Wwg, Wwg, Wog, Wog, Wwg, Wwg, Wwg, Wwg, Wwrg, Wwf, Gs, Ds, Gg, Chr, Hh, Hh, Gs, Gll^Fdw, Gs^Fdw, Gs, Gg, Hh, Chr, Chr, Gg, Re^Edt, Re, Gg, Gll^Fmw, Gs, Gg, Hh, Hh, Hh, Hh^Fp, Gll^Fp, Gll^Fmw, Gll^Fmw, Gg, Gg, Re, Re, Rd, Re, Re, Gg, Gg, Re, Gs, Re^Edb, Re^Edb, Yhs^Xp, Re^Edb, Gll^Fdw, Gs, Gs, Gg, Gg, Gg, Re, Re, Ch, Kh, Ch, Re, Gs^Fdw, Yhs, Yhs, Yhs, Yhs
Wwg, Wwrg, Wwg, Wwf, Wwg, Wwrg, Wwg, Wwg, Wwg, Wwg, Wwg, Wwg, Wwg, Wwg, Wwg, Wwg, Wwg, Ds, Ds^Esd, Ds, Gg, Hh, Hh, Gs, Gs, Gll^Fdw, Gs, Gg, Hh, Chr, Gg, Gg, Gg, Re, Re, Gll^Fp, Gll^Fmw, Gg, Gg, Gg, Gs, Gs, Gg, Gll^Fmw, Gs, Gs, Re, Re, Gg, Re^Edt, Re^Edt, Re, Re, Re, Re, Re, Re, Yhs^Edb, Yhs^Xp, Yhs^Edb, Gll^Fdw, Gll^Fmw, Gll^Fmw, Gll^Fdw, Wwf^Es, Re^Vhr, Re, Re^Edb, Gs^Edt, Chr, Gs, Re, Re^Vhr, Gg, Ds^Esd, Yhs^Xp, Yhs
Wog, Wwg, Wog, Wwg, Wwg, Wwg, Yhs^Xp, Wwf, Wwrg, Wwg, Wwg, Wwg, Wwg, Wwg, Wwg, Wwrg, Ds, Ds, Gs, Gg, Gg, Gg, Hh, Hh, Gs, Gg, Gg, Gg, Gg, Gg, Gg, Gs, Gs, Gs^Fdw, Re, Gg, Gg^Edt, Gg^Edt, Gg^Vhr, Gg^Edt, Gs, Gs^Es, Gg, Gg, Gg, Gg, Re, Re, Gg, Re^Edt, Gg, Re, Gg, Re, Re, Re, Gd^Fdw, Yhs, Gd^Fdw, Gll^Fdw, Gll^Fmw, Gll^Fdw, Gll^Fdw, Gll^Fdw, Gs, Wwf^Es, Wwf^Es, Gg, Gg^Edt, Gs^Edt, Gg, Gg, Gg, Gg, Ds^Esd, Ds, Gg
Wwg, Wog, Wog, Wwg, Wwf, Yhs, Ds, Ds, Wwrg, Wwg, Wog, Wwg, Wwg, Wwg, Wwrg, Wwrg, Gs, Ds^Esd, Gs, Gll^Fmw, Gll^Fdw, Hh, Gg, Gg, Gg, Hh, Hh, Hh, Gg, Gg, Hh, Gg, Gs, Gll^Fdw, Gg, Re, Gg, Gg^Edt, Gg^Edt, Gg, Gg, Gg, Re, Re, Re, Rd, Gg, Gg, Gs^Vh, Gg, Gg, Gg, Re, Re, Re, Re, Re^Edt, Gd^Fmw, Gs, Gs, Gg, Gg, Gg, Gll^Fmw, Gg, Wwf^Es, Re, Wwg, Wwg, Gg^Edt, Hh, Hh, Gs, Ds, Gg, Gg, Hh
Wog, Wog, Wwg, Wwg, Wwf, Ds^Es, Ds, Wwrg, Wwg, Wwg, Wog, Wwg, Wwg, Wwg, Ds, Ds, Ds, Gs, Gll^Fp, Gll^Fmw, Gll^Fmw, Gg, Gg, Gg, Gg, Hh, Gg, Gg, Gg, Hh, Gg, Gg, Gs, Gs, Re, Re, Re^Edt, Gs, Re, Re, Re, Gs, Gg, Gg, Gg, Gg, Gs^Fmw, Gs^Fms, Gll^Fp, Gg, Re, Re, Re, Re, Gs, Re, Re, Re, Re, Gs^Es, Gg, Hh, Gg, Gg, Gg, Re, Gg, Gg, Wwg, Gg, Gg, Hh, Gs^Fdw, Ds^Esd, Gg, Gg, Hh^Fdw
Wog, Wwg^Vm, Wwg, Wwg, Yhs, Ds, Cme, Wwf, Wwg, Wog, Wwg, Wwg, Wwg, Wwrg, Ds, Ds^Es, Ds^Esd, Gll^Fmw, Gll^Fp, Gll^Fdw, Gll^Fdw, Gs, Gs, Hh, Hh, Gg, Gg, Gg, Hh, Hh, Gg, Gg, Gg, Gg, Rd, Re, Gg, Gg, Gg, Gg, Gs, Gg, Hh, Gs, Hh, Gg, Gs^Fmw, Gs^Fms, Hh^Fp, Gg, Gs, Gg, Gs, Gg, Hh, Gs, Gs, Re^Edt, Re^Edt, Re, Gs^Edt, Gs, Gg, Gg, Gg, Re, Gs, Gg, Gg, Wwg, Wwg, Gg, Gg, Gs, Gg, Hh^Fmw, Hh^Fmw
Wwg, Wwg, Ds^Es, Ds, Yhs^Xp, Yhs^Xp, 9 Kme, Wwf, Wwg, Wwg^Vm, Wwg, Wwg, Wwg, Ds, Ds^Edpp, Ds, Gs, Gs, Gs, Gs, Gs, Gs^Es, Gs, Hh, Gg, Gg, Hh, Hh, Hh, Hh, Gg, Gg, Cer, Gg, Re, Gg, Gs, Gg, Gg, Gg, Gs, Gs, Hh, Hh, Mm, Hh, Hh, Hh^Fp, Hh, Gll^Fp, Gll^Fp, Gs, Gs, Gg, Hh, Gs, Gs, Gs^Edt, Gs, Re, Re, Gs, Gg, Gs, Re, Gd, Gd^Fmw, Co, Co, Wwg, Wwg, Gg, Gs, Gs, Hh, Hh^Fdw, Hh^Fmw
Wwg, Ds, Yhs, Yhs^Xp, Yhs, Cme, Wwf, Wwg, Wwg^Vm, Wwg, Wwg, Wwg, Wwg, Ds, Ds^Es, Ds, Ds, Ds^Esd, Ds, Ds, Ds, Gg, Gs, Gg, Gg, Gg, Hh, Hh, Hh, Gg, Gg, Cer, Gs^Edt, Re^Edb, Re, Gs, Cer, Gd, Gs, Hh, Hh, Hh, Mm^Vhhr, Mm, Hh, Mm, Mm, Hh, Hh^Fp, Gll^Fp, Gll^Fp, Gg, Gs, Hh, Mm, Gg, Hh, Gs, Gs^Fdw, Gs, Re^Edt, Re, Co, Co, Re^Edb, Gs, Gd^Fmw, Gd^Fmw, Gs, Gs, Wwg, Gg, Gs, Gs, Gg, Gll^Fmw, Gs^Fdw
Ds, Ds, Ds^Es, Ds, Ds, Chw, Wwg, Wwg, Wwg, Wog, Wwg, Wwg, Wwg, Wwrg, Wwrg, Ds, Wwf, Ds, Wwrg, Ds, Ds, Ds^Esd, Ds, Gd^Fdw, Gll^Fmw, Gg, Gg, Hh, Gg, Gg, Gs, Gg, Rd, Re^Edb, Gs^Vo, Gg, Gs, Gs, Gg, Gs, Hh, Hh^Fp, Hh, Hh, Hh, Mm, Hh, Hh, Hh, Gll^Fp, Gg, Gg, Hh, Hh, Mm, Hh, Gg, Gg, Gs^Fdw, Gs^Fdw, Gs^Fdw, Re, Re, Re^Edb, Rr^Vd, Gs, Gg, Gg, Gs, Gs, Wwf^Es, Gg, Gg, Gg, Gg, Gd^Fdw, Gs
Ds, Ds^Es, Yhs, Yhs^Xp, Wwg, Wwg, Wwg, Wwg, Wog, Wog, Wog, Wwg, Wwg, Wwg, Wwg, Wwg, Wwg, Wwg, Wwg, Wwg, Wwrg, Ds, Ds, Gg, Gg, Gg, Gll^Fmw, Hh, Gs^Edt, Gs^Edt, Co, Co, Co, Gs, Gg, Re, Gs^Fdw, Gg, Gd^Fmw, Gs, Gs, Hh^Fp, Hh, Hh, Gs, Mm, Mm, Hh, Mm, Hh^Fp, Hh, Gs, Hh, Mm, Mm^Vhhr, Hh, Gg, Gs, Co, Co, Gs^Es, Re, Rp, Rr^Edb, Rr, Rr, Chr, Ch, Gg, Gs, Gs, Wwg, Wwf^Es, Gg, Wwg, Gg, Re
Wwg, Wwg, Wwg, Wwg, Wwg, Wwg^Vm, Wwg, Wwg, Wog, Wog, Wog, Wwg, Wwrg, Wwg, Wwg, Wwg, Wwrg, Wwrg, Wwg, Wwg, Wwg, Ds, Ds^Edt, Ds^Esd, Gs, Gll^Fdw, Gll^Fdw, Gg, Gs^Vo, Re, Co, Ko, Co, Re, Re^Edb, Re, Gs^Fdw, Gs^Fmw, Hh^Fdw, Gs, Gs, Hh, Hh, Gs, Gg, Hh, Hh, Mm, Mm, Mm, Mm, Hh, Mm, Mm, Hh, Hh, Gg, Gs^Fdw, Gs, Gs^Fdw, Gs^Es, Gs^Es, Rp, Rr, Rr, Chr, Rr, Rr, Rr^Vd, Gg, Co, Gs, Gs, Wwg, Wwg^Bw/, Re, Re
Wwg, Wwg, Wwg, Wwg, Wwrg, Wwrg, Wwg, Wog, Wog, Wog, Wog, Wog, Wog, Wog, Wog, Wog, Wwg, Wwrg, Wwg, Wwg, Wwg, Wwg, Ds^Edt, Ds^Edt, Ds^Esd, Gs^Fdw, Gll^Fmw, Gg, Gs, Re^Edb, Re^Edb, Co, Re, Re^Edb, Gs^Edb, Gs^Fmw, Gs, Gd^Fdw, Hh^Fmw, Gs, Gg, Gg, Hh, Gg, Gg, Gs, Gll^Fp, Hh, Hh, Mm, Mm, Mm, Mm, Hh, Gs, Gg, Gs, Re, Gs^Edb, Gg^Edb, Rr^Vd, Re^Es, Rr^Edb, Rr^Edb, Ch, Ch, Ch, Rr^Edb, Rr^Edb, Gs, Rp, Rp^Edb, Rp^Edb, Re, Re, Wwg, Wog
Wog, Wwg, Wog, Wwg, Wwg, Wwg, Wog, Wog, Wog, Wog, Wog, Wog, Wog, Wog, Wog, Wwg, Wwg, Wwf^Es, Wwg, Wwg, Ds^Es, Wwf, Ds, Ds^Edt, Gll^Fmw, Gll^Fdw, Gs, Cer, Re, Re^Edb, Gs^Vo, Re, Rd, Re^Edb, Gs, Cer, Gs, Hh, Gs, Gs, Gg, Gg, Gg, Gg, Gll^Fmw, Gg, Gll^Fmw, Hh^Fp, Hhd, Mm, Mm, Mm, Hhd, Hhd, Gd, Gs, Gg, Co, Yhs^Edb, Re^Edb, Yhs^Edb, Rr, Rr^Edb, Rr^Edb, Ch, Kh, Chr, Rr^Edb, Rp^Edb, Rp, Rp^Edb, Re^Edb, Re^Edb, Re, Re, Wwg, Wwg
Wog, Wog, Wwg, Wwg, Wog, Wog, Wog, Wog, Wog, Wog, Wog, Wog, Wog, Wog, Wwg, Wwg, Wwg, Wwf, Ds^Es, Ds, Ds, Ds, Ds, Ds^Esd, Gll^Fmw, Gll^Fp, Gg, Cer, Cer, Gs, Re^Edb, Re^Edb, Gg, Gs^Vo, Gg, Gg^Edt, Gg, Gg, Gg, Gd^Fmw, Gg, Gg, Gg, Gg, Gll^Fp, Gll^Fp, Gll^Fmw, Gll^Fdw, Hhd^Fdw, Hhd, Hhd, Hhd, Hhd, Gd, Gd, Gs, Gs, Co, Yhs^Edb, Yhs^Edb, Yhs^Xp, Rr^Edb, Rr, Chr, Rr, Chr, Re, Rr^Edb, Re^Edb, Rp, Gs, Gs, Gs, Ch, Re, Gs, Gs
Wog, Wog, Wog, Wwg, Wog, Wog, Wog, Wog, Wog, Wog, Wog, Wwg, Wwg, Wwg, Wwg, Wwg, Wwrg, Wwf^Es, Ds, Ds^Es, Ds^Esd, Gg, Hh, Gg, Gg, Gg, Gs^Edt, Gs, Gs, Re, Re, Re^Edb, Gs, Gll^Fdw, Gg, Gg, Gg, Gg, Gs^Fp, Gs^Fmw, Gg, Hh, Gs^Fp, Gg, Gg, Gg, Hhd^Fmw, Hhd^Fdw, Hhd, Hhd, Md, Hhd, Hhd, Hhd, Gd^Fmw, Gd, Gll^Fmw, Yhs, Gll^Fdw, Yhs^Xp, Gll^Fdw, Rr^Edb, Rr^Vd, Rr, Rp, Rr, Re, Re, Co, Re, Hhd, Hhd, Hhd, Re, Gll^Fp, Re, Gll^Fp
Wog, Wog, Wog, Wog, Wog, Wog, Wog, Wog, Wog, Wog, Wwg, Wwg, Wwg, Wwg, Wwg, Wwrg, Ds, Ds, Ds, Ds, Gd^Fdw, Gg, Hh, Hh, Hh^Fmw, Hh^Fmw, Gs, Gs, Re^Edt, Rd, Gs, Gs^Es, Gll^Fmw, Gg, Hh, Gg, Gg, Gg, Gg, Gs^Fp, Hh, Hh, Gs^Fp, Gg, Gg, Hhd, Hhd, Hhd^Fmw, Hhd, Hhd, Hhd, Md, Hhd, Hhd^Fmw, Gd^Fmw, Gll^Fdw, Gll^Fmw, Gll^Fdw, Yhs, Gll^Fdw, Gll^Fdw, Co, Co, Re^Edb, Re^Edb, Rp, Re, Co, Re, Re, Re^Es, Hhd, Re, Re, Gll^Fdw, Gll^Fp, Gll^Fdw
Wog, Wog, Wog, Wog, Wog, Wog, Wog, Wog, Wog, Wog, Wog, Wog, Wwg, Wwg, Wwf^Es, Wwrg, Ds, Ds, Gll^Fdw, Gll^Fmw, Hh, Hh, Mm, Hh, Hh^Fmw, Gd^Fmw, Gs, Gg, Re, Rd, Gll^Fp, Gg, Gll^Fmw, Hh, Hh, Gg, Hh, Gg, Gg, Hh, Gg, Gs^Fms, Gs^Fp, Hh, Gs^Fp, Gg, Hhd, Gg, Gg, Hhd, Md, Md, Md, Hhd, Ch, Gll^Fdw, Gd^Fdw, Gll^Fdw, Yhs, Hhd, Hhd, Re, Re, Re^Edb, Yhs^Edb, Re, Re, Re, Yhs^Edb, Re, Chr, Re^Edb, Re^Es, Ch, Yhs, Gll^Fmw, Gll^Fdw
Wog, Wog, Wog, Wog, Wog, Wog, Wog, Wog, Wog, Wog, Wog, Wog, Wwg, Wwg^Es, Wwf^Es, Wwg, Ds, Ds, Gll^Fmw, Gll^Fmw, Hh, Mm, Hh, Hh, Gd^Fmw, Gd^Fmw, Gll^Fdw, Gg, Re, Re, Gg, Gll^Fp, Gll^Fmw, Gg, Hh, Hh, Hh, Hh, Gg, Hh, Gg, Gg, Hh, Hh, Gs^Fms, Gg, Hhd, Gg, Hhd, Md, Mm, Mv, Mm, Md, Hhd, Gd^Fdw, Yhs^Xp, Gll^Fdw, Yhs, Hhd, Hhd, Re, Re, Yhs, Yhs, Ch, Re, Re^Edb, Yhs^Edb, Yhs^Xp, Ch, Re, Re^Edb, Re^Edb, Yhs^Xp, Yhs, Gll^Fdw
Wog, Wog, Wog, Wog, Wog, Wog, Wog, Wog, Wog, Wog, Wog, Wog, Wwg, Wwg, Wwg, Ds, Ds, Gg, Gll^Fdw, Gll^Fmw, Hh, Mm, Hh, Gg, Gg, Gll^Fp, Gg, Gg, Gg, Re, Gg, Gg, Gll^Fmw, Gll^Fp, Hh, Hh, Hh, Hh, Gg, Gg, Gs^Fp, Gs^Fp, Hh, Hh, Gg, Gs^Fms, Gs^Fp, Gg, Hhd, Md, Md, Mm, Md, Md, Hhd, Yhs, Yhs, Yhs, Re, Re, Re, Re^Es, Ch, Yhs^Xp, Ss, Re, Re, Yhs^Edb, Yhs, Yhs, Yhs, Ch, Re, Yhs^Edb, Yhs, Yhs^Xp, Yhs
