Xu, Xu, Xu, Xu, Xu, Xu, Xu, Xu, Xu, Xu, Xu, Xu, Xoa, Xoa, Xoa, Xoa, Xoa, Xu, Xu, Xu, Xu, Xu, Xu, Xu, Xu, Xu, Xu, Xu, Xu, Xu, Xu, Xu, Xu, Xu, Xu, Xu, Xu, Xu, Xu, Xu, Xu, Xu, Xu, Xu, Xu, Xu, Xu, Xu, Xu, Xu, Xu, Xu, Xu, Xu, Xu, Xu, Xu, Xu, Xu, Xu, Xu, Xu, Xu, Xu, Xu, Xu, Xu, Xu, Xu, Xu
Xu, Xu, Xu, Xu, Xu, Xu, Xu, Xu, Xu, Xu, Xoa, Xoa, Xoa, Xoa, Xoa, Xoa, Xoa, Xoa, Xoa, Xu, Xu, Xu, Xu, Xu, Xu, Xu, Xu, Xu, Xu, Xu, Xu, Xu, Xu, Xu, Xu, Xu, Xu, Xu, Xu, Xu, Xu, Xu, Xu, Xu, Xu, Xu, Xu, Xu, Xu, Xu, Xu, Xu, Xu, Xu, Xu, Xu, Xu, Xu, Xu, Xu, Xu, Xu, Xu, Xu, Xu, Xu, Xu, Xu, Xu, Xu
Xu, Xu, Xu, Xu, Xu, Xu, Xu, Xu, Xu, Xoa, Xoa, Xoa, Xu, Xoa, Uh, Xoa, Xoa^Xzm\, Xoa, Xoa, Xoa, Xoa, Xu, Xu, Xu, Xu, Xu, Xu, Xu, Xu, Xu, Xu, Xu, Xu, Xu, Xu, Xu, Xu, Xu, Xu, Xu, Xu, Xu, Xu, Xu, Xu, Xu, Xu, Xu, Xu, Xu, Xu, Xu, Xu, Xu, Xu, Xu, Xu, Xu, Xu, Xu, Xu, Xu, Xu, Xu, Xu, Xu, Xu, Xu, Xu, Xu
Xu, Xu, Xu, Xu, Xu, Xu, Xu, Xu, Xu, Xoa, Xoa, Xoa, Uh, Uh, Uu, Uu, Uu, Xuc, Xuc, Xoa, Xoa, Xu, Xu, Xu, Xu, Xu, Xu, Xu, Xu, Xu, Xu, Xu, Xu, Xu, Xu, Xu, Xu, Xu, Xu, Xu, Xu, Xu, Xu, Xu, Xu, Xu, Xu, Xu, Xu, Xu, Xu, Xu, Xu, Xu, Xu, Xu, Xu, Xu, Xu, Xu, Xu, Xu, Xu, Xu, Xu, Xu, Xu, Xu, Xu, Xu
Xu, Xu, Xu, Xu, Xu, Xu, Xu, Xu, Xoa, Xoa, Xoa, Uu, Xuc, Uu, Urb, Xuc, Uu^Tf, Uh, Xuc, Xu, Xu, Xu, Xu, Xu, Xu, Xu, Xu, Xu, Xu, Xu, Xu, Xu, Xu, Xu, Xu, Xu, Xu, Xu, Xu, Xu, Xu, Xu, Xu, Xu, Xu, Xu, Xu, Xu, Xu, Xu, Xu, Xu, Xu, Xu, Xu, Xu, Xu, Xu, Xu, Xu, Xu, Xu, Xu, Xu, Xu, Xu, Xu, Xu, Xu, Xu
Xu, Xu, Xu, Xu, Xu, Xu, Xu, Xu, Xoa, Xoa^Xzm/, Uu, Uu, Uh, Uh, Urb, Urb, Uu^Tf, Tb^Tf, Xu, Xu, Xu, Xu, Xu, Xu, Xu, Xu, Xu, Xu, Xu, Xu, Xu, Xu, Xu, Xu, Xu, Xu, Xu, Xu, Xu, Xu, Xu, Xu, Xu, Xu, Xu, Xu, Xu, Xu, Xu, Xu, Xu, Xu, Xu, Xu, Xu, Xu, Xu, Xu, Xu, Xu, Xu, Xu, Xu, Xu, Xu, Xu, Xu, Xu, Xu, Xu
Xu, Xu, Xu, Xu, Xu, Xu, Xu, Xu, Xu, Xuc, Uu, Uu, Uu, Urb, Urb, Urb, Uh, Tb^Tf, Uh, Xoa, Xoa, Xu, Xu, Xu, Xu, Xu, Xu, Xu, Xu, Xu, Xu, Xu, Xu, Xu, Xu, Xu, Xu, Xu, Xu, Xu, Xu, Xu, Xu, Xu, Xu, Xu, Xu, Xu, Xu, Xu, Xu, Xu, Xu, Xu, Xu, Xu, Xu, Xu, Xu, Xu, Xu, Xu, Xu, Xu, Xu, Xu, Xu, Xu, Xu, Xu
Xu, Xu, Xu, Xu, Xu, Xu, Xu, Xu, Xu, Xu, Uh, Xuc, Uu, Urb, Urb, Urb, Uu, Uh, Uu, Xoa, Xoa, Xu, Xu, Xu, Xu, Xu, Xu, Xu, Xu, Xu, Xu, Xu, Xu, Xu, Xu, Xu, Xu, Xu, Xu, Xu, Xu, Xu, Xu, Xu, Xu, Xu, Xu, Xu, Xu, Xu, Xu, Xu, Xu, Xu, Xu, Xu, Xu, Xu, Xu, Xu, Xu, Xu, Xu, Xu, Xu, Xu, Xu, Xu, Xu, Xu
Xu, Xu, Xu, Xu, Xu, Xu, Xu, Xu, Xu, Xu, Uh, Uu, Uu, Urb, Urb, Urb, Uu, Xuc, Uh, Xoa, Xoa, Xu, Xu, Xu, Xu, Xu, Xu, Xu, Xu, Xu, Xu, Xu, Xu, Xu, Xu, Xu, Xu, Xu, Xu, Xu, Xu, Xu, Xu, Xu, Xu, Xu, Xu, Xu, Xu, Xu, Xu, Xu, Xu, Xu, Xu, Xu, Xu, Xu, Xu, Xu, Xu, Xu, Xu, Xu, Xu, Xu, Xu, Xu, Xu, Xu
Xu, Xu, Xu, Xu, Xu, Xu, Xu, Xu, Xoa, Xoa, Xoa, Uu^Tf, Xu, Urb, Urb, Urb, Xu, Uu, Xoa, Xoa, Xoa, Xu, Xu, Xu, Xu, Xu, Xu, Xu, Xu, Xu, Xu, Xu, Xu, Xu, Xu, Xu, Xu, Xu, Xu, Xu, Xu, Xu, Xu, Xu, Xu, Xu, Xu, Xu, Xu, Xu, Xu, Xu, Xu, Xu, Xu, Xu, Xu, Xu, Xu, Xu, Xu, Xu, Xu, Xu, Xu, Xu, Xu, Xu, Xu, Xu
Xu, Xu, Xu, Xu, Xu, Xu, Xu, Xu, Xoa, Xoa, Xoa, Xu, Xu, Urb, Uh, Urb, Xoa, Xoa, Xoa, Xoa, Xu, Xu, Xu, Xu, Xu, Xu, Xu, Xu, Xu, Xu, Xu, Xu, Xu, Xu, Xu, Xu, Xu, Xu, Xu, Xu, Xu, Xu, Xu, Xu, Xu, Xu, Xu, Xu, Xu, Xu, Xu, Xu, Xu, Xu, Xu, Xu, Xu, Xu, Xu, Xu, Xu, Xu, Xu, Xu, Xu, Xu, Xu, Xu, Xu, Xu
Xu, Xu, Xu, Xu, Xu, Xu, Xoa, Xoa, Xoa, Xoa, Xoa, Xu, Xu, Urb, Xu, Urb, Xoa, Xoa, Xu, Xu, Xu, Xu, Xu, Xu, Xu, Xu, Xu, Xoa, Xoa, Xu, Xu, Xu, Xu, Xu, Xu, Xu, Xu, Xu, Xu, Xu, Xu, Xu, Xu, Xu, Xu, Xu, Xu, Xu, Xu, Xu, Xu, Xu, Xu, Xu, Xu, Xu, Xu, Xu, Xu, Xu, Xu, Xu, Xu, Xu, Xu, Xu, Xu, Xu, Xu, Xu
Xu, Xu, Xu, Xu, Xoa, Xoa, Xoa, Xoa, Xu, Xoa, Xoa, Xoa, Xu, Xoa, Uu, Xoa, Xoa, Xu, Xuc, Xu, Xu, Xu, Xu, Xu, Xu, Uh, Xu, Xoa, Xu, Xoa, Xoa, Xu, Xu, Xu, Xu, Xu, Xu, Xu, Xu, Xu, Xu, Xu, Xu, Xu, Xu, Xu, Xu, Xu, Xu, Xu, Xu, Xu, Xu, Xu, Xu, Xu, Xu, Xu, Xu, Xu, Xu, Xu, Xu, Xu, Xu, Xu, Xu, Xu, Xu, Xu
Xu, Xu, Xoa, Xoa, Xoa, Xoa, Xu, Xu, Xu, Xu, Xoa, Xoa, Xom, Uh, Uh, Xoa^Xzm/, Uu, Xuc, Uu, Xuc, Xu, Xu, Xoa, Xoa, Xoa, Uh, Uh, Urb^Edt, Uh^Edt, Uh, Xu, Xoa, Xu, Xu, Xu, Xu, Xu, Xu, Xu, Xu, Xu, Xu, Xu, Xu, Xu, Xu, Xu, Xu, Xu, Xu, Xu, Xu, Xu, Xu, Xu, Xu, Xu, Xu, Xu, Xu, Xu, Xu, Xu, Xu, Xu, Xu, Xu, Xu, Xu, Xu
Xu, Xu, Xoa, Xoa, Qxu, Xu, Xu, Xu, Xu, Xu, Xu, Xom, Uu^Tf, Uu^Emf, Uh, Uh, Uu, Uu, Xuc, Xuc, Xoa, Xoa, Xoa, Xu, Uh^Edt, Wwf^Es, Wwf^Edt, Urb^Edt, Urb^Edt, Uh, Uh^Edt, Wwf^Edt, Wwf^Es, Xu, Xos, Xu, Xu, Xu, Xu, Xu, Xu, Xu, Xu, Xu, Xu, Xu, Xu, Xu, Xu, Xu, Xu, Xu, Xu, Xu, Xu, Xu, Xu, Xu, Xu, Xu, Xu, Xu, Xu, Xu, Xu, Xu, Xu, Xu, Xu, Xu
Xu, Xu, Xoa, Xoa, Xu, Qxu, Uh, Uh, Uh, Xu, Tb^Tf, Xu, Uh, Uu^Em, Uu, Uu, Uu^Emf, Tb^Tf, Xu, Xu, Xu, Xoa, Xu, Urb^Edt, Uh^Edt, Uh, Urb^Edt, Urb^Ii, Urb^Edt, Uh, Xu, Wwf^Edt, Xoa, Xu, Xu, Xu, Xu, Xu, Xu, Xu, Xu, Xu, Xu, Xu, Xu, Xu, Xu, Xu, Xu, Xu, Xu, Xu, Xu, Xu, Xu, Xu, Xu, Xu, Xu, Xu, Xu, Xu, Xu, Xu, Xu, Xu, Xu, Xu, Xu, Xu
Xu, Xu, Xos, Xos, Xu, Qxu, Qxu, Uh, Xu, Uu, Tb^Tf, Uh, Uu, Uu, Uu^Edt, Uu, Uh, Xuc, Xuc, Xu, Xu, Xu, Xu, Xoa, Urb^Edt, Urb, Urb^Edt, Urb^Edt, Xoa, Uh, Xoa, Xoa, Xu, Xu, Xu, Xu, Xu, Xu, Xu, Xu, Xu, Xu, Xu, Xu, Xu, Xu, Xu, Xu, Xu, Xu, Xu, Xu, Xu, Xu, Xu, Xu, Xu, Xu, Xu, Xu, Xu, Xu, Xu, Xu, Xu, Xu, Xu, Xu, Xu, Xu
Xu, Xu, Xos, Xos, Uh, Qxu, Yhl^Xp, Xuc, Xu, Uu^Eb, Uu, Uu^Em, Uu, Uu^Edt, Uu^Edt, Uu, Uu^Em, Xu, Cud, Xuc, Cud, Xu, Urb^Zz\, Urb^Edt, Xu, Xoa, Xoa, Uh, Xu, Uh, Xu, Xu, Xu, Xu, Xu, Xu, Xu, Xu, Xu, Xu, Xu, Xu, Xu, Xu, Xu, Xu, Xu, Xu, Xu, Xu, Xu, Xu, Xu, Xu, Xu, Xu, Qxv, Xu, Xu, Xu, Xu, Xu, Xu, Xu, Xu, Xu, Xu, Xu, Xu, Xu
Xu, Xu, Xos, Xos, Uh, Yhl, Yhl, Yhl^Xp, Xuc, Xuc, Uu^Tf, Uu, Uh, Uu, Uh, Uu, Uu, Uu, Uu, Cud, Uh^Edt, Uu^Edt, Uu^Edt, Xu, Xu, Xu, Xu, Wwf, Xu, Xu, Xu, Xu, Xu, Xu, Xu, Xu, Xu, Xu, Xu, Xu, Xu, Xu, Xu, Xu, Xu, Xu, Xu, Xu, Xu, Xu, Xu, Xu, Xu, Xu, Qxv, Qxv, Urb^Eb, Qxv, Qxv, Xu, Xu, Xu, Xu, Xu, Xu, Xu, Xu, Xu, Xu, Xu
Xos, Xos, Xos, Xos, Yhl, Yhl, Tb^Tf, Yhl, Yhl, Xuc, Uu^Zz\, Uu, Uh, Xu, Cud, Xuc, Uu, Uu, Uu, Uu^Emf, Uh, Uu^Edt, Wwf^Edt, Wwf, Xu, Xu, Xu, Xu, Xu, Xu, Xu, Xu, Xu, Xu, Xu, Xu, Xu, Xu, Xu, Xu, Xu, Xu, Xu, Xu, Xu, Xu, Xu, Xu, Xu, Xu, Xu, Xu, Qxv, Qxv, Urb, Urb, Xoa, Urb, Urb, Qxv, Qxv, Xu, Xu, Xu, Xu, Xu, Xu, Xu, Xu, Xu
Xos, Xos, Yhl, Yhl^Pr\, Xos, Uh, Tb^Tf, Tb^Tf, Yhl^Xp, Uu, Uu, Xu, Xu, Xu, Xu, Cud, Uh, Wwf, Uu^Em, Tb^Tf, Tb^Tf, Uu, Wwf^Es, Wwf, Uh, Uh, Xu, Xu, Xos, Xu, Xu, Xu, Xu, Xu, Xu, Xu, Xu, Xu, Xu, Xu, Xu, Xu, Xu, Xu, Xos, Xu, Xu, Xu, Xu, Xu, Xu, Qxv, Urb^Eb, Urb, Urb, Urb, Urb, Urb, Urb, Urb, Urb^Eb, Qxv, Xu, Xu, Xu, Xu, Xu, Xu, Xu, Xu
Yhl, Yhl, Xos, Xos, Xos, Uh, Uh, Tb^Tf, Uh, Yhl, Uh, Uh, Xu, Uh, Wwf, Uu, Wwf^Es, Uh, Wwf^Edt, Uu, Uh, Cte, Uu, Wwf^Edt, Wwf, Wwf, Xos, Xos, Xos, Xos, Xos, Xu, Xu, Xu, Xu, Xu, Xu, Xu, Xu, Xu, Xu, Xu, Xos, Xos, Xos^Zok, Xos, Xos, Xu, Xu, Xu, Xu, Qxv, Urb, Xoa, Urb, Urb, Urb, Urb, Urb, Xoa, Urb, Qxv, Xu, Xu, Xu, Xu, Xu, Xu, Xuc, Xu
Xos, Xos, Xos, Xos, Xu, Xu, Xu, Uh, Xu, Uh, Xu, Uh, Xuc, Xuc, Wwf, Wwf, Wwf^Es, Uh, Wwf^Es, Uu, Uu, Uu^Edt, Uu^Edt, Uh, Uh, Uh, Xor, Xos, Xu, Xos, Xos, Xos, Xos, Xu, Xu, Xu, Xu, Xu, Xu, Xu, Xos, Xos, Xos^Zok, Xos^Zok, Xv^Zok, Xos^Zok, Xos^Zok, Xos, Xos, Xu, Xu, Qxv, Urb, Urb, Urb, Urb, Urb^Ii, Urb, Urb, Urb, Urb, Qxv, Xu, Xu, Xu, Xu, Xu, Xu, Xuc, Xuc
Xos, Xos, Xu, Xu, Xu, Xu, Xu, Xu, Xu, Xu, Xu, Xuc, Uh, Xuc, Uh, Uu^Tf, Wwf, Wwf, Uh, Uh, Uu, Uu^Edt, Urb^Edt, Urb, Urb^Edt, Urb, Urb, Uu, Xu, Xu, Xos, Xos, Xoa, Xoa, Xos, Xu, Xu, Xu, Xos, Xos, Xos^Zok, Xos^Zok, Xv^Zok, Xv^Zok, Xv^Zok, Xv^Zok, Xv^Zok, Xos^Zok, Xos^Zok, Xos, Xos, Qxv, Urb, Urb, Urb, Urb, Urb, Urb, Urb, Urb, Urb, Qxv, Xu, Xu, Xu, Xu, Xuc, Xu, Xuc, Uh
Xu, Xu, Xu, Xu, Xu, Xu, Xu, Xu, Wwb, Xu, Xu, Xuc, Xu, Uh, Uu^Tf, Uu^Tf, Wwf, Wwf, Uu^Em, Tb^Tf, Xoa, Xoa, Uh, Urb, Xoa, Xoa, Urb, Re^Es, Xoa, Xos, Xoa, Xoa, Uu, Xoa, Xoa, Xos, Xos, Xos, Xos, Xos, Urb, Xv^Zok, Xv^Zok, Xv^Zok, Xv^Zok, Xv^Zok, Xos^Zok, Xos^Zok, Xos, Xos, Xos, Qxv, Urb^Eb, Urb, Urb, Urb, Urb, Urb, Urb, Xoa, Urb^Eb, Qxv, Xu, Xuc, Uh, Tb^Tf, Uh, Xuc, Uh, Uh
Xu, Xu, Xu, Xu, Xu, Xu, Xu, Xu, Xu, Wwb, Wwb, Xu, Xu, Xu, Uh, Wwf, Xu, Wwf^Es, Wwf, Xoa, Xom, Xom, Uu, Urb, Urb, Urb, Urb, Uu^Em, Uu^Eb, Xoa, Uu^Pr\, Uu, Ur^Br/, Ur^Br/, Uu, Xoa, Xos, Xos, Urb, Urb^Ebme, 1 Urb, Urb, Urb, Xv^Zok, Xos^Zok, Xos^Zok, Xos, Xos, Xos, Xos, Urb^Eb, Qxv, Qxu^Bcx/, Urb, Urb, Urb, Urb, Urb, Urb, Urb, Qxv, Qxv, Xu, Xuc, Uh, Tb^Tf, Uh, Xuc, Yhl, Yhl
Xu, Xu, Xu, Xu, Xu, Xu, Xu, Xu, Xu, Xu, Xu, Wwb, Xu, Xu, Uu^Em, Xu, Xu, Uh, Xu, Xoa, Xoa, Uu, Xu, Uu, Xoa, Uu^Em, Uu, Urb, Urb, Uu^Em, Ur^Br/, Ur^Pr\, Uu^Pr\, Uu, Xoa, Xoa, Xos, Xos, Urb, Urb, Urb, Urb, Xos, Xos, Xos, Xos, Xos, Xos, Xos, Xos, Urb, Urb, Urb^Eb, Qxv, Qxv, Urb, Urb^Eb, Urb, Qxv, Qxv, Xu, Xu, Xu, Xuc, Tb^Tf, Tb^Tf, Yhl, Yhl, Yhl^Xp, Yhl^Xp
Xu, Xu, Xu, Xu, Xu, Xu, Xu, Xu, Uh, Xu, Xu, Wwb^Xo, Wwb, Xu, Uu, Xu, Xu, Xu, Xu, Xoa, Xoa, Xoa, Xoa, Xoa, Xoa, Xoa, Uu^Pr\, Uh, Ur^Br/, Ur^Br/, Urb, Urb, Urb, Xoa, Xoa, Xos, Xos, Xos, Urb, Urb, Urb, Xos, Xos, Xos, Xos, Xos, Xor, Xos, Urb, Urb, Xos, Xos, Xos, Xos, Xu, Qxv, Qxv, Qxv, Xu, Xu, Xu, Xu, Xu, Xu, Yhl^Xp, Yhl, Xu, Xu, Xu, Xu
Xu, Xu, Xu, Xu, Xu, Xu, Xu, Xu, Uh, Xuc, Xuc, Xu, Xu, Uu, Ur^Em, Uu^Em, Xu, Xu, Xu, Xu, Xoa, Xoa, Xoa, Xoa, Uu, Uu, Ur^Br/, Ur^Pr\, Uu^Pr\, Urb, Urb, Urb, Urb, Urb, Xor, Xos, Xos, Xos, Urb, Urb, Urb, Xos, Xos, Xos, Xos, Xor, Urb, Urb, Xos, Xos, Xos, Xos, Xu, Xu, Xu, Xu, Xu, Xu, Xu, Xu, Yhr^Xp, Xu, Xu, Uh, Yhl, Xu, Xuc, Xuc, Yhl, Yhl
Xu, Xu, Xu, Xu, Xu, Wwf, Wwf, Tb^Tf, Tb^Tf, Uh, Xu, Xu, Xoa, Uu^Emf, Uu^Em, Uh, Wwb, Xu, Xu, Xu, Xu, Xoa, Xoa, Xoa, Xoa, Ur^Br/, Uu, Uu, Xoa, Xoa, Xoa, Urb, Xos, Urb^Zz/, Urb, Urb, Xor, Xos, Xos, Urb, Urb, Urb, Urb, Urb^Eb, Urb, Urb, Xos, Xos, Xos, Xos, Xu, Xu, Xu, Xu, Xu, Xu, Cte, Xu, Xuc, Xuc, Uh, Xu, Xu, Xuc, Yhl, Xu, Yhl, Yhl, Xuc, Xu
Xu, Xu, Xu, Xu, Xu, Xu, Xu, Wwf, Uu^Edt, Uu^Edt, Uu^Eb, Xuc, Uu, Uu^Zz\, Xoa, Xu, Xu, Wwb^Xo, Wwb, Xu, Xu, Xu, Xu, Xoa, Xoa, Xoa, Xoa, Xoa, Xoa, Xoa, Xos, Xos, Xos, Urb, Urb, Urb, Urb, Xor, Urb^Ebme, Urb, Urb, Urb, Urb, Urb, Urb, Urb, Urb^Eb, Xos, Xos, Xu, Xu, Xu, Xu, Xu, Xu, Xu, Xu, Yhr, Uh, Xuc, Tb^Tf, Uh, Xu, Xu, Yhl^Xp, Yhl, Xu, Yhl, Yhl, Xu
Xu, Xu, Xu, Xu, Uh, Tb^Tf, Uu, Wwf^Es, Wwf, Uu^Edt, Uu, Uu, Ur, Uu, Xuc, Xu, Xu, Xu, Xu, Wwb, Wwb, Xu, Xu, Xu, Xu, Xoa, Xu, Xu, Xu, Xos, Xos, Xos, Xos, Xos, Urb^Eb, Urb, Urb, Urb^Eb, Qxu, Urb, Urb, Urb, Urb, Urb, Urb, Urb, Urb, Xor, Xor, Xos, Xu, Xu, Xu, Xu, Xuc, Xu, Xu, Yhr^Xp, Uh, Tb^Tf, Tb^Tf, Uh, Yhl, Yhl^Pr\, Xu, Xu, Xu, Xu, Yhl^Xp, Yhl
Xu, Xu, Xu, Uh, Xu, Tb^Tf, Xu, Uu, Uu^Edt, Uu, Ur, Uu, Uu^Edt, Uu^Eb, Uh, Tb^Tf, Xu, Xu, Xu, Xu, Xu, Wwb, Xu, Xu, Xu, Xu, Xu, Wog, Wog, Xu, Xu, Xos, Xos, Xos, Xor, Urb, Urb, Uh, Qxu, Uh, Qxu, Xos, Xos, Urb, Urb, Urb, Urb, Urb, Xor, Xos, Xu, Xu, Xu, Xuc, Cte, Xuc, Xu, Xu, Yhr^Xp, Yhr, Yhr, Yhr, Uh, Xuc, Xu, Xu, Xu, Xu, Xu, Xu
Xu, Xu, Xu, Xu, Xu, Xu, Xu, Wwf, Uu, Ur, Uu, Uu, Uu^Edt, Wwf^Es, Xu, Tb^Tf, Xu, Xu, Xu, Xu, Xu, Xu, Xu, Xu, Xu, Xu, Xu, Wog, Wog, Xu, Xu, Xu, Xu, Xor, Qxu, Qxu, Uh, Qxu, Qxu, Qxu, Uu, Xos, Xos, Xos, Xos, Urb, Urb, Urb, Xos, Xos, Xu, Xu, Xu, Xu, Yhr, Uh, Uh, Yhr^Xp, Yhr, Yhr, Uh, Xu, Xuc, Urb, Urb, Xu, Cud, Xu, Xu, Xu
Xu, Xu, Xu, Xu, Xu, Xu, Xu, Tb^Tf, Wwf^Es, Uu, Uu^Edt, Ur, Uu, Xu, Uh, Xu, Xu, Xu, Xu, Xu, Xu, Xu, Xu, Xu, Xom, Xu, Xuc, Wog^Xo, Wog^Xo, Wog, Xuc, Xu, Xu, Qxu, Qxu, Qxu, Qxu, Qxu, Qxu, Qxu, Qxu, Xos, Xor, Xos, Xos, Urb, Urb, Urb, Xos, Xos, Xu, Qxu, Qxu, Xu, Yhr, Yhr, Yhr, Yhr, Xu, Xu, Xu, Yhr^Xp, Uh, Xuc, Xu, Cud, Uu^Ii, Cud, Xu, Xu
Xu, Xu, Xu, Xu, Xu, Uh, Uh, Tb^Tf, Wwf, Xu, Uu^Edt, Uu^Edt, Xu, Tb^Tf, Wwf, Uh, Xu, Xu, Xu, Xu, Xu, Xu, Xuc, Xom, Uh, Tb^Tf, Wwrg, Wwg, Wwg, Xu, Uh, Xuc, Xu, Qxu, Yhl, Yhl, Qxu, Qxu, Yhl, Qxu, Qxu, Qxu, Qxu, Xor, Xos, Urb, Urb^Zz/, Urb^Zz/, Xos, Xos, Xos, Xu, Qxu, Qxu, Uh, Yhr, Ur, Cte, Xu, Xu, Xu, Xu, Xom, Xom, Xu, Cud, Cud, Cud, Xu, Xu
Xu, Xu, Xu, Xu, Xu, Xu, Xu, Wwf, Xu, Xu, Uh, Tb^Tf, Xu, Wwf^Es, Wwf, Xu, Xu, Xu, Xu, Xuc, Uh, Xuc, Tb^Tf, Uh, Tb^Tf, Tb^Tf, Wwrg, Wwrg, Wwrg, Uh, Tb^Tf, Tb^Tf, Xu, Xuc, Yhl^Em, Yhl^Xp, Qxu, Qxu, Qxu, Yhl, Yhl^Xp, Qxu, Xu, Xos, Xos, Urb^Zz/, Urb, Urb, Uu, Xu, Xos, Xos, Qxu, Uu^Tf, Tb^Tf, Yhr, Ur, Xu, Xu, Xu, Xu, Xu, Xu, Xu, Xu, Qxu, Qxu, Xu, Xu, Xu
Xu, Xu, Xu, Xu, Xu, Xu, Xu, Xu, Uu, Wwb^Pr\, Xu, Xu, Uh, Xu, Xu, Wwf^Es, Xoa, Xu, Qxu, Qxu, Qxu, Tb^Tf, Tb^Tf, Uh, Xuc, Wwg, Wwg, Wwg, Wwf^Es, Uu, Tb^Tf, Tb^Tf, Uh, Uu^Em, Yhl^Xp, Xuc, Xu, Qxu, Qxu, Yhl, Yhl, Xu, Xu, Xos, Xos, Urb, Urb, Urb, Uu, Uu, Urb, Yhr^Edt, Yhr, Uu^Tf, Uh, Yhr, Uh, Uh, Xos, Xu, Xu, Xu, Xu, Xu, Qxu, Qxu, Qxu, Xu, Qxu, Xu
Xu, Xu, Xu, Xu, Xu, Xu, Xu, Uh, Uh, Wwb, Wwb, Xu, Xu, Wwb, Xu, Xoa, Xoa, Xu, Qxu, Qxu, Xu, Tb^Tf, Uu^Tf, Uh, Wwg, Wwrg, Xuc, Xuc, Uu^Eb, Wwf, Uu^Tf, Tb^Tf, Uu^Em, Ur^Emf, Uh, Yhl^Em, Yhl, Xu, Yhl, Xu, Yhl^Zz/, Xu, Xu, Xu, Xos, Uu, Ur, Uu, Uu^Tf, Uh, Urb, Urb, Urb, Uh, Ur, Ur, Uh, Uh, Xos, Xos, Xu, Xu, Xu, Xu, Qxu, Qxu, Qxu, Qxu, Xu, Xu
Xu, Xu, Xu, Xu, Xoa, Xoa, Xoa, Xu, Uh, Wwb, Wwb, Xu, Uh, Wwb, Xu, Xoa, Xoa, Xu, Xu, Xu, Xu, Xuc, Xuc, Wwrg, Wwg, Wwrg, Uh, Uu^Edb, Ur^Edb, Wwrg, Wwf, Ur, Uu, Xuc, Uu^Eb, Xu, Xu, Yhl, Xu, Xu, Xu, Yhl, Yhl, Xu, Ur, Ur^Pr\o, Xos, Xor, Xor, Tb^Tf, Uh, Urb, Urb, Uh, Ur, Ur, Urb, Urb, Urb^Eb, Uh, Qxu, Xos, Xos, Xu, Xu, Qxu, Xu, Qxu, Xu, Xu
Xu, Xu, Xu, Xu, Xoa, Xoa, Yhr, Xu, Xu, Xu, Wwb, Wwb, Wwb, Wwb, Xu, Xu, Yhr^Xp, Xu, Xu, Xu, Xu, Uh, Uh, Uu^Edb, Wwf^Edb, Wwg, Ur, Cte^Ii, Uu^Edb, Wwf^Es, Wwrg, Uh, Urb, Uu^Ii, Uu, Xuc, Xuc, Xu, Xu, Xu, Xu, Xu, Uu, Uu, Ur, Uu, Xu, Qxu, Qxu, Uh, Uh, Xu, Xu, Urb^Edt, Uu, Uu, Uu^Edt, Uh, Urb, Urb^Edt, Urb, Xom, Xom, Xu, Xos, Xu, Xu, Xu, Xu, Xu
Xu, Xu, Xoa, Xoa, Xoa, Xoa, Xu, Yhr^Xp, Wwb, Wwb, Yhr^Xp, Wwb, Wwb, Wwb, Wwb, Yhr, Xu, Xu, Xu, Xu, Xu, Uh, Uu^Ii, Ur^Edb, Wwf^Edb, Wwf^Es, Wwf^Es, Uh, Wwf^Es, Wwf, Uu^Emf, Uu^Em, Uu^Ii, Uh, Uu, Uh, Xuc, Xu, Xu, Xu, Xu, Uu, Uh, Xuc, Uu, Uh, Xuc, Xu, Qxu, Xu, Uh, Qxu, Qxu, Xu, Xu, Uu^Edt, Xu, Urb^Edt, Urb, Urb, Urb, Urb^Edt, Urb^Tf, Xu, Xos, Xos, Xu, Xu, Xu, Xu
Xu, Xu, Xoa, Xoa, Xu, Yhr, Yhr^Xp, Wwb, Wwb, Yhr, Uh, Wwb, Xu, Wwb, Xu, Wwb, Wwb, Xu, Xu, Xu, Xu, Uu, Uh, Uu^Eb, Uh, Wwrg, Wwg, Wwg, Wwrg, Uu, Uh, Tb^Tf, Uu^Em, Uu^Eb, Qxu, Qxu, Xu, Xu, Xu, Xu, Xu, Uh, Uu^Emf, Ur^Br|, Uu, Uh, Xuc, Xu, Xu, Xu, Xu, Qxu, Qxu, Xu, Xu, Qxu, Qxu, Qxu, Xu, Uh, Uh, Uh, Urb, Uh, Urb, Xos, Xu, Xos, Xos, Xu
Xu, Xu, Xu, Xu, Xu, Xu, Xu, Wwb, Wwb, Wwb, Wwb, Wwb, Xu, Xu, Xu, Xu, Xu, Wwb, Wwb, Xu, Xu, Xu, Xu, Xu, Wog, Wwg, Wwg, Wwrg, Wwg, Wwg, Wog, Xu, Xu, Xu, Qxu, Qxu, Xu, Xu, Xu, Xu, Xu, Xu, Xu, Ur^Br|, Xu, Xu, Xu, Xu, Xu, Xu, Xu, Qxu, Xu, Xu, Xu, Qxu, Qxu, Qxu, Qxu, Qxu, Xu, Uu^Tf, Urb^Eb, Urb, Urb, Urb^Edt, Urb^Edt, Xos, Xos, Xu
Xu, Xu, Xu, Xu, Xu, Xu, Xu, Xoa, Xoa, Wwb, Xu, Xu, Xu, Xu, Xu, Xu, Xu, Xu, Xu, Xu, Xu, Xu, Xu, Xu, Wog^Xo, Wog, Wwrg, Wwg, Wwrg, Wog, Wog, Xu, Xu, Xu, Xu, Xu, Xu, Xu, Xu, Xu, Xu, Xu, Xu, Ur^Pr|, Xu, Xu, Xu, Xu, Xu, Xu, Xu, Xu, Xu, Xu, Xu, Xu, Xu, Xu, Xu, Xu, Xu, Xu, Xos, Uh, Uu^Tf, Urb, Urb, Uh^Edt, Urb, Xu
Xu, Xu, Xu, Xu, Xu, Xu, Xoa, Xoa, Wwb, Wwb, Xoa, Xoa, Xu, Xu, Xu, Xu, Xu, Xu, Xu, Xu, Xu, Xu, Wog, Wog, Wog, Xu, Xu, Xu, Xu, Wog, Wog^Xo, Wog^Xo, Wog, Xu, Xu, Xu, Xu, Xu, Xu, Xu, Xu, Xu, Xu, Ur^Br|, Xu, Xu, Xu, Xu, Xu, Xu, Xu, Xu, Xu, Xu, Xu, Xu, Xu, Xu, Xu, Xu, Xu, Xu, Xu, Xos, Xu, Urb^Emf, Uh^Edt, Urb, Urb, Urb
Xu, Xu, Xu, Xu, Xoa, Xoa, Wwb, Wwb, Xoa, Xoa, Xu, Xu, Xu, Xu, Xu, Xu, Xu, Xu, Xu, Xu, Xu, Xu, Wog, Wog, Xu, Xu, Xu, Xu, Xu, Xu, Wog, Wog, Wog, Xu, Xu, Xu, Xu, Xu, Xu, Xu, Xu, Xu, Xu, Ur^Br|, Xu, Xu, Xu, Xu, Xu, Xu, Xu, Xu, Xu, Xu, Xu, Xu, Xu, Xu, Xu, Xu, Xu, Xu, Xu, Xu, Xu, Xu, Xu, Urb^Edt, Uh, Urb
