Uu, Qlf, Qlf, Qlf, Uu, Uu, Uu, Uu, Uu^Ii, Uu^Ii, Qlf, Qlf, Uu, Uu, Xu, Xu, Xu, Xu, Xu, Qxua, Qxua, Xu, Xu, Xu, Xu, Qxua, Qxua, Qxua, Qxua, Qxua, Qxua, Qxua, Qxua, Qxua, Qxua, Qxua, Qxua, Qxua, Qxua, Qxua, Qxua, Qxua, Qxua, Qxua, Qxua, Qxua
Uu, Qlf, Qlf, Qlf, Uu, Uue^Ii, Uu, Uu, Uu^Ii, Uu^Ii, Qlf, Qlf, Uh, Uh, Xu, Xu, Xu, Xu, Xu, Qlf, Qxua, Wog, Xu, Xu, Xu, Qxua, Qxua, Qxua, Qxua, Qxua, Qxua, Qxua, Qxua, Qxua, Qxua, Qxua, Qxua, Qxua, Qxua, Qxua, Qxua, Qxua, Qxua, Qxua, Qxua, Qxua
Qlf, Qlf, Qlf, Qlf, Xu, Xu, Uu^Zok, Uu, Uu, Qlf, Uh, Qlf, Qlf, Xu, Xu, Xu, Xu, Xu, Qlf, Qxua, Qxua, Qxua, Wog, Xu, Xu, Qxua, Qxua, Qxua, Qxua, Wog, Qxua, Qxua, Qxua, Qxua, Qxua, Qxua, Qxua, Qxua, Qxua, Qxua, Qxua, Qxua, Qxua, Qxua, Qxua, Qxua
Qlf, Qlf, Uh, Qlf, Xu, Uu^Zok, 5 Uu^Zok, Uu^Zok, Qlf, Qlf, Ql, Ql, Xu, Xu, Qxua, Xu, Xu, Xu, Xu, Qlf, Qxua, Xu, Xu, Xu, Qxua, Wog, Wog, Qxua, Qxua, Qxua, Qxua, Qxua, Qxua, Qxua, Qxua, Qxua, Qxua, Qxua, Qxua, Qxua, Qxua, Qxua, Qxua, Qxua, Qxua, Qxua
Qlf, Qlf, Uh, Uu, Uu, Uu^Zok, Uu^Zok, Uu^Zok, Uu, Qlf, Ql, Xu, Qxua, Uh, Qxua, Qxua, Qxua, Xu, Uh, Qlf, Qxua, Wog, Wog, Xu, Qxua, Qxua, Wog, Qxua, Qxua, Qxua, Qxua, Qxua, Qxua, Qxua, Qxua, Qxua, Qxua, Qxua, Qxua, Qxua, Qxua, Qxua, Qxua, Qxua, Qxua, Qxua
Uu, Qlf, Uu, Uh, Uu, Uu, Uu, Uu, Uh, Ql, Qxua, Qxua, Qxua, Uh, Xu, Qxua, Xu, Uh, Uh, Xu, Wog, Qxua, Qxua, Qxua, Qxua, Qxua, Qxua, Qxua, Qxua, Qxua, Qxua, Qxua, Qxua, Qxua, Qxua, Qxua, Qxua, Qxua, Qxua, Qxua, Qxua, Qxua, Qxua, Qxua, Qxua, Qxua
Uu, Qlf, Uu, Uue^Ii, Uu, Xu, Xu, Xu, Qxua, Qxua, Xu, Qxua, Qxua, Xu, Xu, Qxua, Qxua, Qxua, Uh, Wog, Qxua, Qxua, Qxua, Xu, Qxua, Qxua, Qxua, Qxua, Qxua, Qxua, Qxua, Qxua, Qxua, Qxua, Qxua, Qxua, Qxua, Qxua, Qxua, Qxua, Qxua, Qxua, Qxua, Qxua, Qxua, Qxua
Uu, Uu, Xu, Uue^Ii, Uh, Uh, Xu, Xu, Uh, Qxua, Qxua, Qxua, Qxua, Xu, Uh, Qlf, Ql, Uh, Qxua, Wog, Qxua, Wog, Qxua, Qxua, Qxua, Qxua, Qxua, Qxua, Qxua, Qxua, Qxua, Qxua, Qxua, Qxua, Qxua, Qxua, Qxua, Qxua, Qxua, Qxua, Qxua, Qxua, Qxua, Qxua, Qxua, Qxua
Xu, Xu, Xu, Uu, Ql, Uh, Qxua, Uh, Uh, Ql, Ql, Qxua, Qxua, Xu, Qxua, Ql, Ql, Qxua, Qxua, Qxua, Qxua, Qxua, Qxua, Qxua, Qxua, Wog, Qxua, Qxua, Qxua, Qxua, Qxua, Qxua, Qxua, Qxua, Qxua, Qxua, Qxua, Qxua, Qxua, Qxua, Qxua, Qxua, Qxua, Qxua, Qxua, Qxua
Xu, Xu, Xu, Ql, Ql, Uh, Qxua, Ql, Uh, Ql, Qxua, Xu, Uh, Qxua, Qxua, Uh, Ql, Wog, Qxua, Qxua, Qxua, Qxua, Qxua, Qxua, Qxua, Qxua, Qxua, Qxua, Qxua, Qxua, Qxua, Qxua, Qxua, Qxua, Qxua, Qxua, Qxua, Qxua, Qxua, Qxua, Qxua, Qxua, Qxua, Qxua, Xos, Qxua
Qlf, Uh, Ql, Ql, Uh, Qxua, Qxua, Qxua, Qxua, Xu, Ql, Qxua, Uh, Xu, Ql, Qxua, Qxua, Qxua, Wog, Qxua, Qxua, Qxua, Qxua, Qxua, Qxua, Qxua, Qxua, Qxua, Qxua, Qxua, Qxua, Qxua, Qxua, Qxua, Qxua, Qxua, Qxua, Qxua, Qxua, Qxua, Qxua, Qxua, Qxua, Qxua, Qxua, Qxua
Qlf, Qlf, Qxua, Ql, Uh, Xu, Wog, Qxua, Qxua, Qxua, Qlf, Qxua, Xu, Uh, Ql, Qlf, Qxua, Qxua, Qxua, Qxua, Qxua, Qxua, Qxua, Qxua, Qxua, Qxua, Qxua, Qxua, Qxua, Qxua, Qxua, Qxua, Qxua, Qxua, Qxua, Qxua, Qxua, Qxua, Qxua, Qxua, Qxua, Qxua, Qxua, Qxua, Qxua, Urb^Pr\
Uh, Qlf, Ql, Qxua, Qxua, Xu, Wog, Wog, Qxua, Uh, Qlf, Xu, Qxua, Ql, Ql, Qxua, Qxua, Qxua, Qxua, Wog, Qxua, Qxua, Qxua, Qxua, Qxua, Qxua, Qxua, Qxua, Qxua, Qxua, Qxua, Qxua, Qxua, Qxua, Qxua, Qxua, Qxua, Qxua, Qxua, Qxua, Qxua, Qxua, Qxua, Qxua, Urb^Pr/, Urb^Pr/
Qxua, Xu, Ql, Qxua, Qxua, Qxua, Xu, Wog, Qxua, Ql, Qxua, Qxua, Qxua, Qxua, Qxua, Qxua, Qxua, Qxua, Qxua, Qxua, Qxua, Qxua, Qxua, Qxua, Qxua, Qxua, Qxua, Qxua, Qxua, Qxua, Qxua, Qxua, Qxua, Qxua, Qxua, Qxua, Qxua, Qxua, Qxua, Qxua, Qxua, Qxua, Urb^Pr/, Urb^Pr/, Urb, Urb
Qxua, Qxua, Uh, Uh, Ql, Qxua, Qxua, Qxua, Qxua, Qxua, Qxua, Wog, Qxua, Qxua, Wog, Qxua, Qxua, Qxua, Qxua, Qxua, Qxua, Qxua, Qxua, Qxua, Qxua, Qxua, Qxua, Qxua, Qxua, Qxua, Qxua, Qxua, Qxua, Qxua, Qxua, Qxua, Qxua, Qxua, Qxua, Qxua, Qxua, Xoc, Urb, Urb, Urb, Urb
Wog, Wog, Uh, Xu, Qlf, Ql, Qxua, Qxua, Qxua, Qxua, Qxua, Qxua, Qxua, Qxua, Qxua, Qxua, Qxua, Qxua, Qxua, Qxua, Qxua, Qxua, Qxua, Qxua, Qxua, Qxua, Qxua, Qxua, Qxua, Qxua, Qxua, Qxua, Qxua, Qxua, Qxua, Qxua, Qxua, Qxua, Qxua, Qxua, Urb^Pr/, Urb^Pr/, Urb, Urb, Xu, Xu
Xu, Wog, Qxua, Xu, Xu, Ql, Qxua, Wog, Qxua, Qxua, Qxua, Qxua, Qxua, Qxua, Qxua, Qxua, Qxua, Qxua, Qxua, Qxua, Qxua, Qxua, Qxua, Qxua, Qxua, Qxua, Qxua, Qxua, Qxua, Qxua, Qxua, Qxua, Qxua, Qxua, Qxua, Qxua, Qxua, Qxua, Urb^Pr/, Urb^Pr/, Urb, Urb, Urb, Urb, Xu, Xu
Xu, Qxua, Qxua, Qxua, Qxua, Qxua, Qxua, Qxua, Qxua, Qxua, Qxua, Qxua, Qxua, Qxua, Qxua, Qxua, Qxua, Qxua, Qxua, Qxua, Qxua, Qxua, Qxua, Qxua, Qxua, Qxua, Qxua, Qxua, Qxua, Qxua, Qxua, Qxua, Qxua, Qxua, Qxua, Qxua, Qxua, Xoc, Urb, Urb, Urb, Urb, Qlf, Xu, Xu, Xu
Xu, Qxua, Qxua, Wog, Qxua, Qxua, Qxua, Qxua, Qxua, Qxua, Qxua, Qxua, Qxua, Qxua, Qxua, Qxua, Qxua, Qxua, Qxua, Qxua, Qxua, Qxua, Qxua, Qxua, Qxua, Qxua, Cud^Xo, Qxua, Qxua, Cud^Xo, Qxua, Qxua, Qxua, Qxua, Qxua, Qxua, Urb^Pr/, Urb^Pr/, Urb, Urb, Xu, Qlf, Qlf, Qlf, Qlf, Xu
Qxua, Qxua, Qxua, Qxua, Qxua, Qxua, Qxua, Qxua, Qxua, Qxua, Qxua, Qxua, Qxua, Qxua, Qxua, Qxua, Qxua, Qxua, Qxua, Qxua, Qxua, Qxua, Qxua, Qxua, Qxua, Qxua, Yhr, Qxua, Qxua, Qxua, Qxua, Qxua, Qxua, Qxua, Qxua, Xoc, Urb, Urb, Urb, Urb, Xu, Xu, Xu, Qlf, Xos, Xos
Qxua, Qxua, Qxua, Qxua, Qxua, Qxua, Qxua, Qxua, Qxua, Qxua, Qxua, Qxua, Qxua, Qxua, Qxua, Qxua, Qxua, Qxua, Qxua, Qxua, Qxua, Qxua, Qxua, Qxua, Yhr, Yhr, Yhr, Yhr, Yhr, Cud^Xo, Qxua, Xos, Qxua, Qxua, Urb^Pr/, Urb^Pr/, Urb, Urb, Qlf, Qlf, Qlf, Xu, Xu, Xos, Xos, Xos
Qxua, Qxua, Qxua, Qxua, Qxua, Qxua, Qxua, Qxua, Qxua, Qxua, Qxua, Qxua, Qxua, Qxua, Qxua, Qxua, Qxua, Qxua, Qxua, Qxua, Qxua, Qxua, Qxua, Cud^Xo, Qxua, Yhr, Yhr, Yhr, Urb, Urb, Urb, Qxua, Qxua, Qxua, Urb^Pr\, Urb, Urb, Urb, Xu, Qlf, Qlf, Qlf, Xos, Xos, Xos, Xu
Qxua, Qxua, Qxua, Qxua, Qxua, Qxua, Qxua, Qxua, Qxua, Qxua, Qxua, Qxua, Qxua, Qxua, Qxua, Qxua, Qxua, Qxua, Qxua, Qxua, Qxua, Qxua, Qxua, Qxua, Qxua, Yhr, Qxua, Urb, Urb, Urb, Urb, Urb, Urb, Qxua, Urb^Pr/, Urb, Urb, Xu, Xu, Xu, Xos, Xos, Xos, Xos, Xu, Xu
Qxua, Qxua, Qxua, Qxua, Qxua, Qxua, Qxua, Qxua, Qxua, Qxua, Qxua, Qxua, Qxua, Qxua, Qxua, Qxua, Qxua, Qxua, Qxua, Qxua, Qxua, Cud^Xo, Qxua, Qxua, Cud^Xo, Yhr, Xos, Qxua, Qxua, Urb, Urb, Urb, Urb, Urb, Urb, Urb, Urb, Xu, Xu, Xos, Xos, Xos, Xu, Xu, Xu, Xu
Qxua, Qxua, Qxua, Qxua, Qxua, Qxua, Qxua, Qxua, Qxua, Qxua, Qxua, Qxua, Qxua, Qxua, Qxua, Qxua, Qxua, Qxua, Qxua, Qxua, Qxua, Qxua, Qxua, Qxua, Qxua, Yhr, Yhr, Qxua, Xoc, Qxua, Urb^Pr/, Urb, Urb, Urb, Urb, Urb, Urb, Xu, Xu, Xoc, Xoc, Xu, Xu, Xu, Xu, Xu
Qxua, Qxua, Qxua, Qxua, Qxua, Qxua, Qxua, Qxua, Qxua, Qxua, Qxua, Qxua, Qxua, Qxua, Qxua, Qxua, Qxua, Qxua, Qxua, Qxua, Qxua, Qxua, Qxua, Qxua, Qxua, Xu, Wog, Xoc, Xoc, Xoc, Urb, Urb, Urb, Urb, Urb, Urb, 1 Urb, Urb, Urb, Xoc, Xoc^Efs, Xoc, Xoc, Xu, Xu, Xu
Qxua, Qxua, Qxua, Qxua, Qxua, Qxua, Qxua, Qxua, Qxua, Qxua, Qxua, Qxua, Qxua, Qxua, Qxua, Qxua, Qxua, Qxua, Qxua, Qxua, Qxua, Qxua, Qxua, Qxua, Qxua, Xu, Wog, Xoc, Xoc^Efs, Xoc^Efs, Urb, Urb, Xoc, Xoc, Xoc, Urb, Urb, Urb, Urb, Urb, Urb, Xoc^Efs, Xoc, Xoc, Xoc, Xu
Qxua, Qxua, Qxua, Qxua, Qxua, Qxua, Qxua, Qxua, Qxua, Qxua, Qxua, Qxua, Qxua, Qxua, Qxua, Qxua, Qxua, Qxua, Qxua, Qxua, Qxua, Qxua, Qxua, Qxua, Xos, Xu, Wog, Xoc, Yhl, Yhl, Urb, Urb, Xoc, Xos, Xu, Xu, Xu, Urb, Urb, Urb, Urb, Urb, Urb, Xoc^Efs, Xoc^Efs, Xoc
Qxua, Qxua, Qxua, Qxua, Qxua, Qxua, Qxua, Qxua, Qxua, Qxua, Qxua, Qxua, Qxua, Qxua, Qxua, Qxua, Qxua, Qxua, Qxua, Qxua, Qxua, Qxua, Qxua, Qxua, Qxua, Xu, Cud, Wog, Wog, Yhl, Urb, Urb, Xu, Xu, Xu, Xu, Xu, Xoc, Xoc, Urb, Urb, Urb, Urb, Urb, Urb, Xoc
Qxua, Qxua, Qxua, Qxua, Qxua, Qxua, Qxua, Qxua, Qxua, Qxua, Qxua, Qxua, Qxua, Qxua, Qxua, Qxua, Qxua, Qxua, Qxua, Qxua, Qxua, Qxua, Qxua, Qxua, Xu, Xu, Qlf, Xu, Xu, Wwf, Wwf, Urb, Uh, Xu, Yhl, Xu, Uu^Uf, Xoc, Xoc, Xoc, Xoc, Urb, Urb, Urb, Urb, Urb
Qxua, Qxua, Qxua, Qxua, Qxua, Qxua, Qxua, Qxua, Qxua, Qxua, Qxua, Qxua, Qxua, Qxua, Qxua, Qxua, Qxua, Qxua, Qxua, Qxua, Qxua, Qxua, Xu, Xu, Qlf, Qlf, Xu, Xu, Urb, Urb, Urb, Wwf, Wog, Wog, Wog, Yhl, Uu^Uf, Uu^Uf, Xu, Xoc, Xoc, Xoc, Xoc, Urb, Urb, Urb
Qxua, Qxua, Qxua, Qxua, Qxua, Qxua, Qxua, Qxua, Qxua, Qxua, Qxua, Qxua, Qxua, Qxua, Qxua, Qxua, Qxua, Qxua, Qxua, Qxua, Qxua, Xu, Xu, Qlf, Xu, Xu, Qxua, Urb^Pr\, Urb, Urb, Urb, Urb, Yhl, Yhl, Yhl, Wog, Wog, Uu^Uf, Xu, Xu, Xu, Xoc, Xoc, Xoc, Xoc, Urb
Qxua, Qxua, Qxua, Qxua, Qxua, Qxua, Qxua, Qxua, Qxua, Qxua, Qxua, Qxua, Qxua, Qxua, Qxua, Qxua, Qxua, Qxua, Qxua, Qxua, Qxua, Qxua, Xos, Xu, Qxua, Qxua, Qxua, Urb^Pr/, Urb, Urb, Urb, Urb, Yhl, Yhl, Uh, Yhl, Uu^Uf, Wog, Wog^Pr/, Xu, Xu, Xu, Xu, Xoc, Xoc, Xoc
Qxua, Qxua, Qxua, Qxua, Qxua, Qxua, Qxua, Qxua, Qxua, Qxua, Qxua, Qxua, Qxua, Qxua, Qxua, Qxua, Qxua, Qxua, Qxua, Qxua, Qxua, Qxua, Qxua, Qxua, Qxua, Qxua, Urb^Pr/, Xos, Urb, Urb, Xu, Xu, Uh, Uu^Uf, Uu^Uf, Xu, Xu, Xu, Xu, Wog, Wog^Zok, Xu^Zok, Xu^Zok, Xu, Xu, Xoc
Qxua, Qxua, Qxua, Qxua, Qxua, Qxua, Qxua, Qxua, Qxua, Qxua, Qxua, Qxua, Qxua, Qxua, Qxua, Qxua, Qxua, Qxua, Qxua, Qxua, Qxua, Qxua, Qxua, Qxua, Qxua, Qxua, Urb^Pr\, Urb, Urb, Urb, Xu, Xu, Uh, Uu^Uf, Uu^Uf, Xu, Xu, Xu, Xu, Xu^Zok, Xu^Zok, Xu^Zok, Xu, Xu, Xu, Xu
Qxua, Qxua, Qxua, Qxua, Qxua, Qxua, Qxua, Qxua, Qxua, Qxua, Qxua, Qxua, Qxua, Qxua, Qxua, Qxua, Qxua, Qxua, Qxua, Qxua, Qxua, Qxua, Qxua, Qxua, Qxua, Qxua, Urb^Pr/, Urb, Urb, Urb, Xu, Xu, Xu, Uh, Xu, Uu, Uu^Uf, Xu, Xu, Xu, Xu, Xu, Xu, Xu, Xu, Xu
Qxua, Qxua, Qxua, Qxua, Qxua, Qxua, Qxua, Qxua, Qxua, Qxua, Qxua, Qxua, Qxua, Qxua, Qxua, Qxua, Qxua, Qxua, Qxua, Qxua, Qxua, Qxua, Qxua, Qxua, Qxua, Qxua, Urb^Pr\, Urb, Urb, Urb, Xu, Xu, Xu, Xu, Xu, Qxu, Qxu, Uh, Xu, Xu, Xu, Xu, Xu, Xu, Xu, Xu
Qxua, Qxua, Qxua, Qxua, Qxua, Qxua, Qxua, Qxua, Qxua, Qxua, Qxua, Qxua, Qxua, Qxua, Qxua, Qxua, Qxua, Qxua, Qxua, Qxua, Qxua, Qxua, Qxua, Qxua, Qxua, Qxua, Rr^Pr/, Urb, Urb, Urb, Xu, Xu, Xu, Xu, Xu, Xu, Xu, Uh, Uu, Xu, Qxu, Xu, Xu, Xu, Xu, Xu
