Xos, Xos, Xos, Xos, Xos, Xos, Xos, Xos, Xos, Xos, Xos, Xos, Xos, Xos, Xos, Xos, Xos, Xos, Xos, Xos, Wog, Wog, Wog, Wog, Xos, Xos, Xos, Cud, Gs, Gs, Gll^Fp, Gs, Gs, Rr, Rp, Gs, Gg, Gs, Gs, Cud, Xos, Xos, Xos, Xos, Xos, Xos, Xos, Xos, Xos, Xos, Xos, Xos, Xos, Xos, Xos, Xos, Xos, Xos, Xos, Xos, Xos, Xos, Xos, Xos, Xos, Xos, Xos, Xos, Xos, Xos, Xos, Xos, Xos, Xos, Xos, Xos, Xos, Xos, Xos, Xos, Xos, Xos, Xos, Xos
Xos, Xos, Xos, Xos, Xos, Xos, Xos, Xos, Xos, Xos, Xos, Xos, Xos, Xos, Xos, Xos, Xos, Xos, Wog^Pr\, Wog, Xos, Wog, Wog, Wog, Xos, Xos, Xos, Cud, Gs, Gs, Gg^Fet, Gs, Rp, 1 Rr, Gs, Gg, Gg^Fet, Gs, Gs, Cud, Xos, Xos, Xos, Xos, Xos, Xos, Xos, Xos, Xos, Xos, Xos, Xos, Xos, Xos, Xos, Xos, Xos, Xos, Xos, Xos, Xos, Xos, Xos, Xos, Xos, Xos, Xos, Xos, Xos, Xos, Xos, Xos, Xos, Xos, Xos, Xos, Xos, Xos, Xos, Xos, Xos, Xos, Xos, Xos
Cud, Xos, Xos, Xos, Xos, Xos, Xos, Xos, Xos, Xos, Xos, Xos, Xos, Xos, Xos, Xos, Wog, Wog, Xos, Xos, Xos, Wog, Wog, Wog, Xos, Xos, Xos, Cud, Gs, Gll^Fp, Gs, Gs, Rp^Vd, Rr, Rp, Rp^Vh, Gll^Fp, Gll^Fp, Gs, Cud, Xos, Xos, Xos, Xos, Xos, Xos, Xos, Xos, Xos, Xos, Xos, Xos, Xos, Xos, Xos, Xos, Xos, Xos, Xos, Xos, Xos, Xos, Xos, Xos, Xos, Xos, Xos, Xos, Xos, Xos, Xos, Xos, Xos, Xos, Xos, Xos, Xos, Xos, Xos, Xos, Xos, Xos, Xos, Xos
Gs, Cud, Cud, Xos, Xos, Xos, Xos, Xos, Xos, Xos, Xos, Xos, Xos, Xos, Wog^Pr\, Wog, Xos, Xos, Xos, Xos, Xos, Wog, Wog, Wog, Xos, Xos, Xos, Cud, Gs, Gll^Fp, Rp^Vh, Gg, Rp, Rr, Rp, Gs, Rp^Vhc, Gs, Gs, Cud, Xos, Xos, Xos, Xos, Xos, Xos, Xos, Xos, Xos, Xos, Xos, Xos, Xos, Xos, Xos, Xos, Xos, Xos, Xos, Xos, Xos, Xos, Xos, Xos, Xos, Xos, Xos, Xos, Xos, Xos, Xos, Xos, Xos, Xos, Xos, Xos, Xos, Xos, Xos, Xos, Xos, Xos, Xos, Xos
Gs, Gs, Gs, Cud, Cud, Cud, Cud, Cud, Cud, Xos, Xos, Xos, Wwf, Wwg, Xos, Xos, Xos, Xos, Xos, Xos, Xos, Wog, Wog, Wog, Xos, Xos, Xos, Cud, Cud, Gs, Gs, Rp, Rp, Rr, Gs, Rp, Gs, Gs, Cud, Cud, Xos, Xos, Xos, Xos, Xos, Xos, Xos, Xos, Xos, Xos, Xos, Xos, Xos, Xos, Xos, Xos, Xos, Xos, Xos, Xos, Xos, Xos, Xos, Xos, Xos, Xos, Xos, Xos, Xos, Xos, Xos, Xos, Xos, Xos, Xos, Xos, Xos, Xos, Xos, Xos, Xos, Xos, Xos, Xos
Gs, Gll^Fp, Gs, Gg, Gll^Fp, Gg, Gs, Gs, Gs, Cud, Cud, Xos, Wwf, Xos, Xos, Xos, Xos, Xos, Xos, Xos, Xos, Wog, Wog, Wog, Xos, Xos, Xos, Xos, Xos, Cud, Cud, Gs, Cud, Kud, Cud, Gg, Cud, Cud, Xos, Xos, Xos, Xos, Xos, Xos, Xos, Xos, Xos, Xos, Xos, Xos, Xos, Xos, Xos, Xos, Xos, Xos, Xos, Xos, Xos, Xos, Xos, Xos, Xos, Xos, Xos, Xos, Xos, Xos, Xos, Xos, Xos, Xos, Xos, Xos, Xos, Xos, Xos, Xos, Xos, Xos, Xos, Xos, Xos, Xos
Rr, Gg, Gs, Gll^Fp, Gll^Fp, Gs, Rr, Rp^Vd, Gs, Gs, Gs, Wwf, Wwf, Xos, Xos, Xos, Xos, Xos, Xos, Xos, Wog, Wog, Wog, Wog, Xos, Xos, Xos, Xos, Xos, Xos, Xos, Cud, Urb, Rr, Urb, Cud, Xos, Xos, Xos, Xos, Xos, Xos, Xos, Xos, Xos, Xos, Xos, Xos, Xos, Xos, Xos, Xos, Xos, Xos, Xos, Xos, Xos, Xos, Xos, Xos, Xos, Xos, Xos, Xos, Xos, Xos, Xos, Xos, Xos, Xos, Xos, Xos, Xos, Xos, Xos, Xos, Xos, Xos, Xos, Xos, Xos, Xos, Xos, Xos
Rr, Rr, Rr, Gs, Re, Gs, Rp, Rp, Gs, Gg, Wwf, Wwf, Gs, Cud, Xos, Xos, Xos, Xos, Xos, Xos, Wog, Wog, Wog, Wog, Xos, Xos, Xos, Xos, Xos, Xos, Xos, Cud, Urb, Rr, Urb, Cud, Xos, Xos, Xos, Xos, Xos, Xos, Xos, Xos, Xos, Xos, Xos, Xos, Xos, Xos, Xos, Xos, Xos, Xos, Xos, Xos, Xos, Xos, Xos, Xos, Xos, Xos, Xos, Xos, Xos, Xos, Xos, Xos, Xos, Xos, Xos, Xos, Xos, Xos, Xos, Xos, Xos, Xos, Xos, Xos, Xos, Xos, Xos, Xos
Gg, Rp, Rp, Rr, Rr, Rp, Ce, Rr, Rp, Rp^Vh, Gs, Gg, Gg, Cud, Xos, Xos, Xos, Xos, Xos, Xos, Wog, Wog, Wog, Xos, Xos, Xos, Xos, Xos, Xos, Xos, Xos, Cud, Urb, Rr, Urb, Cud, Xos, Xos, Xos, Xos, Xos, Xos, Xos, Xos, Xos, Xos, Xos, Xos, Xos, Xos, Xos, Xos, Xos, Xos, Xos, Xos, Xos, Xos, Xos, Xos, Xos, Xos, Xos, Xos, Xos, Xos, Xos, Xos, Xos, Xos, Xos, Xos, Xos, Xos, Xos, Xos, Xos, Xos, Xos, Xos, Xos, Xos, Xos, Xos
Gs, Gs^Es, Gll^Fp, Rp, Rp, Ce, 2 Ke, Ce, Rr, Rr, Rr, Gs, Cud, Cud, Xos^Efs, Xos, Xos, Xos, Xos, Wog^Xo, Wog^Xo, Wog^Xo, Wog^Xo, Xos, Xos, Xos, Xos, Xos, Xos, Xos, Xos^Efs, Xos^Efs, Urb, Rr, Urb, Xos^Efs, Xos^Efs, Xos, Xos, Xos, Xos, Xos, Xu, Xu, Xu, Xos, Xos, Xos, Xos, Xos, Xos, Xos, Xos, Xos, Xos, Xos, Xos, Xos, Xos, Xos, Xos, Xos, Xos, Xos, Xos, Xos, Xos, Xos, Xos, Xos, Xos, Xos, Xos, Xos, Xos, Xos, Xos, Xos, Xos, Xos, Xos, Xos, Xos, Xos
Gll^Fp, Gs, Gll^Fp, Gs, Rr, Ce, Ce, Ce, Rr, Rp, Rp, Rr, Cud, Urb, Urb, Xos^Efs, Xos^Efs, Xos, Wwg, Wog, Wog, Wog, Xos, Xos, Xos, Xos, Xoc, Xos, Xos, Xos, Xom, Urb^Eb, Urb, Rr, Urb, Urb^Eb, Xos, Xos, Xos, Xos, Xu, Xu, Xu, Xu, Xu, Xu, Xu, Xos, Xos, Xos, Xos, Xos, Xos, Xos, Xos, Xos, Xos, Xos, Xos, Xos, Xos, Xos, Xos, Xos, Xos, Xos, Xos, Xos, Xos, Xos, Xos, Xos, Xos, Xos, Xos, Xos, Xos, Xos, Xos, Xos, Xos, Xos, Xos, Xos
Gll^Fp, Gs, Gg, Gg, Rp, Rp, Gs, Gs, Rp, Gs^Es, Gg, Cud, Urb, Rr, Rr, Urb^Eb, Urb, Xos^Efs, Wwg, Wog, Wog, Wog, Xos, Xos, Xoc^Efs, Xoc, Urb, Xoc, Xos^Efs, Xom, Urb, Urb, Rr, Rr, Urb, Urb, Xos, Xos, Xu, Xu, Xu, Xu, Xu, Xu, Xu, Xu, Xu, Xu, Xu, Xos, Xos, Xos, Xos, Xos, Xos, Xos, Xos, Xos, Xos, Xos, Xos, Xos, Xos, Xos, Xos, Xos, Xos, Xos, Xos, Xos, Xos, Xos, Xos, Xos, Xos, Xos, Xos, Xos, Xos, Xos, Xos, Xos, Xos, Xos
Gg, Gll^Fp, Gg, Gg, Gs, Rr, Gs, Gs, Rp^Vh, Gs, Gs, Cud, Xos, Urb, Urb^Eb, Rr, Rr, Wwg, Wwg, Wog, Wwg, Xos, Xom, Xos^Efs, Urb, Urb, Rr, Urb, Urb, Urb, Rr, Rr, Urb, Urb, Xos, Xos, Xos, Xos, Xu, Xuc, Xos, Xos, Xos, Xu, Xu, Xu, Xu, Xu, Xu, Xu, Xu, Xos, Xos, Xos, Xos, Xos, Xos, Xos, Xos, Xos, Xos, Xos, Xos, Xos, Xos, Xos, Xos, Xos, Xos, Xos, Xos, Xos, Xos, Xos, Xos, Xos, Xos, Xos, Xos, Xos, Xos, Xos, Xos, Xos
Gg, Gg^Es, Gg, Gs, Gs, Rp^Vhc, Rr, Wwf, Wwf, Gs, Cud, Cud, Xos, Xos, Xos, Urb, Wwg, Wwg^Bsb\, Wwg^Bsb\, Wwg, Urb, Uu^Vud, Urb, Urb, Rr, Rr, Urb, Rr, Rr, Rr, Urb, Urb, Xos, Xos, Xos^Xzm/, Xos, Xos, Xu, Uh, Xu, Xos, Xos, Xos, Xos, Xu, Xu, Xu, Xu, Xu, Xu, Xu, Xu, Xos, Xos, Xos, Xos, Xos, Xos, Xos, Xos, Xos, Xos, Xos, Xos, Xos, Xos, Xos, Xos, Xos, Xos, Xos, Xos, Xos, Xos, Xos, Xos, Xos, Xos, Xos, Xos, Xos, Xos, Xos, Xos
Cud, Gg, Cud, Gg, Cud, Gs, Cud, Wwf, Wwf, Cud, Xos, Xos, Xos, Xos, Xos, Xos, Wwg, Wwg, Wwg, Rr, Rr, Urb, Rr, Rr, Urb, Urb, Xos, Urb, Urb, Urb, Xos, Xos, Xos^Efs, Xos^Efs, Uh^Ebur, Uu, Uu, Uh, Uh, Uh, Xos, Xos, Xu, Xu, Xu, Xu, Xu, Xu, Xu, Xu, Xu, Xu, Xos, Xos, Xos, Xos, Xos, Xos, Xos, Xos, Xos, Xos, Xos, Xos, Xos, Xos, Xos, Xos, Xos, Xos, Xos, Xos, Xos, Xos, Xos, Xos, Xos, Xos, Xos, Xos, Xos, Xos, Xos, Xos
Xos, Cud, Xos, Cud, Xos, Cud, Xos, Cud, Xos, Xos, Xos, Xos, Xos, Xos, Xos, Wog, Wog, Wog, Xos, Urb, Urb, Rr, Urb, Rr, Urb, Xos, Xos, Xos, Xos, Xos, Xos, Xos^Xzm/, Urb, Uh, Uu^Vud, Uu^Tf, Cud, Cud, Urb, Uu^Vud, Uh, Xu, Xu, Xu, Xu, Xu, Xu, Xu, Xu, Uu^Ii, Xu, Xu, Xos, Xos, Xos, Xos, Xos, Xos, Xos, Xos, Xos, Xos, Xos, Xos, Xos, Xos, Xos, Xos, Xos, Xos, Xos, Xos, Xos, Xos, Xos, Xos, Xos, Xos, Xos, Xos, Xos, Xos, Xos, Xos
Xos, Xos, Xos, Xos, Xos, Xos, Xos, Xos, Xos, Xos, Xos, Xos, Xos, Xos, Xos, Wog, Wog, Wog, Xos, Xos, Xos, Urb, Urb, Rr, Urb, Xos, Xos, Xos, Xos, Xos, Xom^Efs, Xos^Efs, Cud, Urb, Urb, Uu^Em, Cud, 5 Kud, Cud, Urb, Urb, Uh, Xu, Xu, Xu, Xu, Xos, Xu, Xu, Uu^Em, Uh, Xos, Yhl^Pr\, Yhl, Xos, Xos, Xos, Xos, Xos, Xos, Xos, Xos, Xos, Xos, Xos, Xos, Xos, Xos, Xos, Xos, Xos, Xos, Xos, Xos, Xos, Xos, Xos, Xos, Xos, Xos, Xos, Xos, Xos, Xos
Xos, Xos, Xos, Xos, Xos, Xos, Xos, Xos, Xos, Xos, Xos, Xos, Xos, Xos, Xos, Wog^Xo, Wog^Xo, Wog^Xo, Xos, Xos, Xos, Xos, Urb, Rr, Urb, Xos, Xos, Xos, Xos, Xom, Urb, Urb, Rr, Cud, Urb, Urb, Urb, Cud, Urb, Uh, Xu, Xos, Xos, Xu, Xos, Xos, Xos, Xos, Xos, Uh, Yhl, Yhl, Xos, Xos, Xos, Xos, Xos, Xos, Xos, Xos, Xos, Xos, Xos, Xos, Xos, Xos, Xos, Xos, Xos, Xos, Xos, Xos, Xos, Xos, Xos, Xos, Xos, Xos, Xos, Xos, Xos, Xos, Xos, Xos
Xos, Xos, Xos, Xos, Xos, Xos, Xos, Xos, Xos, Xos, Xos, Xos, Xos, Xos, Xos, Wog, Wog, Wog, Xos, Xos, Xoc, Xos, Urb, Rr, Urb, Xos^Efs, Xom^Efs, Xos, Xos, Xos, Urb, Rr, Urb, Cud, Xu, Urb, Uu^Vud, Uu, Uu^Tf, Uu^Tf, Xu, Xu, Xos, Xos, Xos, Xos, Yhl, Xos, Xos, Uu^Tf, Yhl, Wwb, Wwb^Pr/, Xos, Xos, Xos, Xos, Xos, Xos, Xos, Xos, Xos, Xos, Xos, Xos, Xos, Xos, Xos, Xos, Xos, Xos, Xos, Xos, Xos, Xos, Xos, Xos, Xos, Xos, Xos, Xos, Xos, Xos, Xos
Xos, Xos, Xos, Xos, Xos, Xos, Xos, Xos, Xos, Xos, Xos, Xos, Xos, Xos, Xos, Wog, Wog, Wog, Xoc, Xoc, Iwr, Xoc, Urb, Rr, Rr, Urb, Urb, Xom, Xom, Xos, Urb, Rr, Urb, Xos, Xos, Xu, Xu, Xu, Xu, Xu, Xu, Xu, Xu, Xos, Xos, Yhl, Yhl^Pr/, Yhl^Pr/, Yhl, Yhl, Uu^Tf, Xos, Xot^Xzm\, Wwb, Wwb, Xos, Xos, Xos, Xos, Xos, Xos, Xos, Xos, Xos, Xos, Xos, Xos, Xos, Xoc, Xos, Xos, Xos, Xos, Xos, Xos, Xos, Xos, Xos, Xos, Xos, Xos, Xos, Xos, Xos
Xos, Xos, Xos, Xos, Xos, Xos, Xos, Xos, Xos, Xos, Xos, Xos, Xos, Xos, Xos, Wog, Xos, Xos, Xoc^Efs, Iwr, Iwr, Iwr, Xoc, Urb, Urb, Rr, Rr, Urb, Urb, Xos^Efs, Urb, Rr, Urb, Xos, Xos, Xu, Xu, Xu, Xu^Uov, Xu, Xu, Xu, Xu, Xu, Xu, Xos, Xu, Yhl^Xp, Yhl, Uu^Tf, Yhl^Xp, Uu^Vud, Uh, Xos^Xzm\, Xos, Wwb, Wwb, Xos, Xos, Xos, Xos, Xos, Xos, Xos, Xos, Xos, Xoc, Xoc, Xoc, Xoc, Xoc, Xos, Xos, Xos, Xos, Xos, Xos, Xos, Xos, Xos, Xos, Xos, Xos, Xos
Xos, Xos, Xos, Xos, Xos, Xos, Xos, Xos, Xos, Xos, Xos, Xos, Xos, Xos, Xos, Xos, Xos, Xoc^Efs, Wwg, Iwr, Iwr, Xoc, Xos, Xos, Xos, Urb, Urb, Rr, Rr, Urb, Rr, Rr, Urb, Xos, Xos, Xu, Xu^Uov, Xu^Uov, Xu, Xu^Uov, Xu^Uov, Xu, Xu, Xu, Xu, Xu, Xu^Uov, Xu^Uov, Xu, Uu^Emf, Uu^Tf, Yhl^Xp, Yhl, Xot, Xos, Xos, Xos, Wwb, Xos, Xos, Xos, Xos, Xos, Xos, Xoc, Xoc, Xoc, Xoc, Qxu^Xo, Xoc, Xoc, Xoc, Xoc, Xos, Xos, Xos, Xos, Xos, Xos, Xos, Xos, Xos, Xos, Xos
Xos, Xos, Xos, Xos, Xos, Xos, Xos, Xos, Xos, Xos, Xos, Xos, Xos, Xos, Xos, Xos, Xos, Xoc, Xoc, Iwr, Iwr, Xoc, Xoc, Xoc, Xoc, Xos, Xos, Urb^Eb, Rr, Rr, Urb, Urb, Xos, Xos, Wog, Wog, Wog^Es, Xu, Xu, Xu, Xu, Xu^Uov, Xu^Uov, Xu, Xu^Uov, Xu^Uov, Xu, Xu, Xu, Xos, Xos, Uu^Tf, Yhl^Pr/, Yhl^Pr/, Yhl, Xos, Xos, Xos, Xos, Xos, Xos, Xos, Xoc, Xoc, Xoc, Xoc, Qxu^Xo, Qxu^Xo, Qxu^Xo, Qxu^Xo, Qxu^Xo, Xoc, Xoc, Xoc, Xoc, Xos, Xos, Xos, Xos, Xos, Xos, Xos, Xos, Xos
Xos, Xos, Xos, Xos, Xos, Xos, Xos, Xos, Xos, Xos, Xos, Xos, Xos, Xos, Xos, Xos, Xos, Xos, Xoc, Iwr, Iwr, Iwr, Iwr, Wwg, Xoc, Xos, Xoc, Urb, Rr, Urb, Xos, Xos, Xos, Xos, Wog, Wog, Wog, Xos, Xos, Xu, Xu, Xu, Xu, Xu^Uov, Xu, Xu, Xu, Xu, Xos, Xos, Xos, Xos, Xos, Yhl, Xos, Xos, Xos, Xos, Xos, Xos, Xoc, Xoc, Xoc, Xoc, Qxu^Xo, Qxu^Xo, Qxu^Xo, Qxu^Xo, Gs^Fds, Qxu^Xo, Qxu^Xo, Qxu^Xo, Qxu^Xo, Xoc, Xoc, Xoc, Xoc, Xos, Xos, Xos, Xos, Xos, Xos, Xos
Cud, Cud, Cud, Cud, Cud, Xos, Xos, Xos, Xos, Xos, Xos, Xos, Xos, Xos, Xos, Xos, Xos, Xos, Xos, Xoc, Xoc, Iwr, Iwr, Iwr, Iwr, Xoc, Xoc, Urb, Rr, Urb, Xos, Xos, Wog, Wog, Wog, Wog, Xos, Wog^Pr/, Wog, Xos, Xos, Xu, Xu, Xu, Xu, Xu, Xos, Xos, Xos, Xos, Xos, Xos, Xos, Xos, Xos, Xos, Xos, Xos, Xoc, Xoc, Xoc, Xoc, Qxu^Xo, Qxu^Xo, Qxu^Xo, Qxu^Xo, Gs^Fds, Gs^Fds, Cud, Gs^Fds, Gg, Qxu^Xo, Qxu^Xo, Qxu^Xo, Qxu^Xo, Xoc, Xoc, Xoc, Xoc, Xoc, Xos, Xos, Xos, Xos
Gs, Gs, Gs, Gs, Gs, Cud, Cud, Xos, Xos, Xos, Xos, Xos, Xos, Xos, Xos, Xos, Xos, Xos, Xos, Xos, Xoc, Wwg, Xoc, Iwr, Iwr, Xoc^Efs, Urb, Urb, Rr, Urb, Xos, Xos, Wog, Wog, Uu^Tf, Uu^Emf, Xu, Xos, Xos, Wog, Wog, Xos, Xos, Xu, Xos, Xos, Xos, Xos, Xos, Xos, Xos, Xos, Xos, Xos, Xos, Xos, Xoc, Xoc, Xoc, Xoc, Qxu^Xo, Qxu^Xo, Qxu^Xo, Qxu^Xo, Gs^Fms, Gs^Fms, Gs^Fds, Gs^Fds, Gg, Gg, Cud, Cud, 3 Kud, Qxu^Xo, Qxu^Xo, Qxu^Xo, Qxu^Xo, Xoc, Xoc, Xoc, Xoc, Xos, Xos, Xos
Rp, Gs, Rp, Gs, Gs, Gs, Cud, Xos, Xos, Xos, Xos, Xos, Xos, Xos, Xos, Xos, Xos, Xos, Xos, Xos, Xos, Xoc, Xoc^Efs, Xoc, Urb^Eb, Urb, Rr, Rr, Urb, Urb, Xos, Xos, Wog, Wog, Wog, Xuc, Xuc, Xu, Xos, Xos, Xos, Wog, Wog, Xos, Xos, Xos, Xos, Xos, Xos, Xos, Xos, Xos, Xos, Xos, Xoc, Xoc, Xoc, Xoc, Qxu^Xo, Qxu^Xo, Qxu^Xo, Qxu^Xo, Gs^Fds, Gs^Fms, Gs^Fms, Gs^Fms, Gg^Efm, Gg, Gg, Gg, Cud, Cud, Cud, Cud, Gg, Qxu^Xo, Qxu^Xo, Qxu^Xo, Qxu^Xo, Xoc, Xoc, Xoc, Xoc, Xos
Rr, Rr, Rr, Rr, Rp, Gs, Cud, Xos, Xos, Xos, Xos, Wog, Xos, Xos, Xos, Xos, Xos, Xos, Xos, Xos, Xos^Efs, Xoc^Efs, Urb, Urb, Rr, Rr, Urb, Urb, Xos, Xos, Xos, Xos, Uu, Uu^Vud, Uh, Wog, Wog, Xos, Xos, Xos, Xos, Xos, Xos, Wog, Wog, Xos, Xos, Xos, Xos, Xos, Xos, Xos, Xoc, Xoc, Xoc, Xoc, Qxu^Xo, Qxu^Xo, Qxu^Xo, Qxu^Xo, Gs^Fms, Gs^Fms, Gs^Fds, Gs^Fds, Gg, Gg, Gg, Gg, Rp, Rp, Rp, Cud, Cud, Cud, Gg, Gg, Gs^Fds, Qxu^Xo, Qxu^Xo, Qxu^Xo, Qxu^Xo, Xoc, Xoc, Xos
Rr, Rr, Rr, Rr, Rr, Gs, Gs, Xos, Xos, Xos, Xoc, Wog^Xo, Xos, Xos, Xoc, Xos, Xoc, Xoc, Xoc, Xos^Efs, Urb, Urb, Rr, Rr, Urb, Urb, Xos, Xos, Xos, Xos, Xu, Xos, Uh, Uh, Xu, Xos, Xos, Wog^Pr/, Wog, Xos, Xos, Xos, Xos, Xos, Xos, Xos, Xos, Xos, Xos, Xos, Xos, Xos, Xoc, Xoc, Qxu^Xo, Qxu^Xo, Qxu^Xo, Qxu^Xo, Gs^Fms, Gs^Fds, Gs^Fms, Gs^Fds, Gg^Efm, Gg^Efm, Gg, Gg^Es, Rp, Rp, Rp, Rp, Gg^Es, Gg, Gg, Gg, Gs^Fds, Cud, Gs^Fds, Gs^Fds, Qxu^Xo, Qxu^Xo, Qxu^Xo, Qxu^Xo, Xoc, Xos
Rp, Rr, Rp, Rr, Gs, Rr, Rr^Zz/, Gs^Zz/, Gs^Fds, Xoc, Xoc, Wog, Xoc, Xoc, Cud, Cud, Cud, Cud, Gs, Urb, Rr, Rr, Urb, Urb, Xos, Xos, Xos, Xos, Qxu, Qxu, Qxu, Xu, Qxu, Qxu, Xu, Xu, Xos, Xos, Xos, Wog, Wog, Xos, Xos, Xos, Xos, Xos, Xos, Xos, Xos, Xos, Xos, Xos, Xoc, Xoc, Xoc, Qxu^Xo, Gs^Fds, Gs^Fds, Gs^Fms, Gs^Fms, Gg^Efm, Gg^Efm, Gg^Efm, Gg, Rp, Rp, Rp, Rp, Gg, Gg^Efm, Gg, Gg, Gs^Fms, Gs^Fds, Gs^Fms, Gs^Fms, Qxu^Xo, Qxu^Xo, Qxu^Xo, Qxu^Xo, Xoc, Xoc, Xoc, Xos
Gs, Gs, Gs, Gs, Xos, Gs^Zz/, Gs^Fds, Rr, Rr, Gs^Fds, Gs, Wwg, Gg, Cud, Gs, Gs, Gg, Gg^Vhc, Rr, Rp, Rp, Urb, Xoc, Xos, Xos, Xos, Xos, Xos, Qxu, Xu, Qxu, Xu, Xu, Qxu, Xu, Xu, Xos, Xos, Xos, Xos, Xos, Xos, Xos, Xos, Xos, Xos, Xos, Xos, Xos, Xos, Xos, Xos, Xoc, Xoc, Xoc, Xoc, Xoc, Gs^Fms, Gg^Efm, Gg, Gg, Gg, Rp, Rp, Rp, Rp, Gg, Gg^Efm, Gg^Efm, Gg^Efm, Gs^Fds, Gs^Fds, Gs^Fms, Gs^Fds, Qxu^Xo, Qxu^Xo, Qxu^Xo, Qxu^Xo, Xoc, Xoc, Xoc, Xoc, Xos, Xos
Cud, Gs, Cud, Cud, Xos, Xos, Xoc, Gs^Fds, Gs^Fds, Rr, Rr, Wwg, Gs^Vh, Gg, Gs^Fds, Gs^Fds, Rp, Rp, Gs, Gs^Fds, Gg^Fet, Rp, Rr, Xoc, Xos, Xos, Uu^Vud, Uu^Vud, Xos, Xu, Xu, Qxu, Qxu, Qxu, Xu, Xu, Xos, Xos, Xos, Xos, Xos, Xos, Xos, Xos, Xos, Xos, Xos, Xos, Xos, Xos, Xoc, Xoc, Cud, Xoc, Xoc^Efs, Xoc, Xoc^Efs, Xoc, Xoc, Gg, Rp, Rp, Rp, Rp, Gg, Gg, Gg^Es, Gg^Efm, Gs^Fms, Gs^Fds, Gs^Fds, Gs^Fms, Qxu^Xo, Qxu^Xo, Qxu^Xo, Qxu^Xo, Xoc, Xoc, Xoc, Xoc, Xos, Xos, Xos, Xos
Xos, Cud, Xos, Xos, Xos, Xos, Xos, Xoc, Xoc, Gs, Wwg, Wwg^Bw\, Rr, Gg, Rp, Rp, Wwg, Wwrg, Wwrg, Gs^Fds, Gs^Fds, Rp, Rr, Rr, Cud, Xoc, Urb, Urb^Em, Xos, Xos, Xu, Xu, Xu, Xu, Xu, Xu, Xos, Xos, Xos, Xos, Xos, Xos, Xos, Xos, Xoc^Zok, Xos, Xos, Xos, Xos, Xoc, Cud, Cud, Wog, Wog, Wog, Cud, Cud, Xoc^Efs, Xoc^Efs, Xoc, Xoc, Rp, Gg, Gg, Gg^Efm, Gg, Gs^Fds, Gs^Fds, Gs^Fms, Gs^Fds, Qxu^Xo, Qxu^Xo, Qxu^Xo, Qxu^Xo, Xoc, Xoc, Xoc, Xoc, Xos, Xos, Xos, Xos, Xos, Xos
Xos, Xos, Xos, Xos, Xos, Xos, Xos, Xoc, Wog, Wwg, Cud, Gs, Gs, Rp, Gs^Fds, Wwrg, Wwg, Wwrg, Wwg, Wwg, Rb, Rp, Rr, Rr, Cud, Cud, Urb, Uh, Xos, Xos, Xos, Xu, Xu, Xu, Xos, Xos, Xos, Xos, Xos, Xos, Xos, Xos, Xoc^Zok, Xoc^Zok, Yhs^Zok, Xoc^Zok, Xoc, Xos, Xoc^Efs, Xoc, Wog, Wog, Wog, Wog, Cud, Wog, Wog, Cud, Cud, Xoc^Efs, Xoc, Xoc, Xoc, Gg, Gs^Fds, Gs^Fms, Gs^Fds, Gs^Fds, Qxu^Xo, Qxu^Xo, Qxu^Xo, Qxu^Xo, Xoc, Xoc, Xoc, Xoc, Xos, Xos, Xos, Xos, Xos, Xos, Xos, Xos
Xos, Xos, Xos, Xos, Xos, Xos, Wog, Wog^Xo, Xos, Xoc, Cud, Gd, Gg^Fet, Rp, Gs, Wwf, Wwf^Ewl, Wwf^Ewf, Wwf^Ewl, Wwf^Ewl, Rr, Rr, Rr, Cud, 4 Kud, Cud, Xoc, Xos, Xos, Xos, Xos, Xos, Xos, Xos, Xos, Xos, Xos, Xos, Xos, Xos, Xos, Xos, Xos, Xoc^Zok, Xoc, Yhs^Pr/, Xoc^Uov, Xoc^Efs, Wog, Wog, Wog, Wog, Wog, Cud, 6 Cud, Cud, Wog, Wog, Wog, Cud, Xoc^Efs, Xoc, Xoc, Xoc, Xoc, Gs^Fms, Qxu^Xo, Qxu^Xo, Qxu^Xo, Qxu^Xo, Xoc, Xoc, Xoc, Xoc, Xos, Xos, Xos, Xos, Xos, Xos, Xos, Xos, Xos, Xos
Xos, Xos, Xos, Xos, Xos, Xos, Xos, Xos, Xos, Xoc, Cud, Gs^Fds, Gs^Fds, Rr, Gs, Wwf, Wwrg, Wwg, Wwg, Wwg, Gs^Em, Rr, Rr, Cud, Cud, Cud, Urb, Xoc^Efs, Xoc^Efs, Xos, Xos, Xos, Xos, Xos, Xos, Xos, Xos, Xos, Xos, Xos, Xos, Xos, Xos, Xos, Xos, Xoc, Xoc^Efs, Wog, Wog, Wog, Ior^Ii, Iwr^Ii, Iwr^Ii, Cud, Cud, Cud, Wog, Wog, Wog, Wog, Wog, Xoc^Efs, Xoc, Xoc, Xoc, Xoc, Xoc, Qxu^Xo, Xoc, Xoc, Xoc, Xoc, Xos, Xos, Xos, Xos, Xos, Xos, Xos, Xos, Xos, Xos, Xos, Xos
Xos, Xos, Xos, Xos, Xos, Xos, Xos, Xos, Xos, Xoc, Cud, Gs^Fds, Gs^Em, Rr, Rr, Rr^Vd, Gg, Wwg, Gs^Fds, Gs^Fds, Gg^Fds, Rr, Rp, Gs^Fds, Cud, Cud, Urb, Uh, Uu^Vud, Xos, Xos, Xos, Wog, Xos, Xos, Xos, Xos, Xos, Xoc^Zok, Xoc^Zok, Xoc^Zok, Xos, Xos, Xos, Xoc, Xoc^Efs, Cud, Cud, Iwr^Ii, Iwr^Ii, Wog, Wog, Wog, Iwr^Ii, Ior^Ii, Wog, Wog, Wog, Wog, Wog, Cud, Cud, Xoc, Xos, Xos, Xoc, Xoc, Xoc, Xoc, Xoc, Xos, Xos, Xos, Xos, Xos, Xos, Xos, Xos, Xos, Xos, Xos, Xos, Xos, Xos
Xos, Xos, Xos, Xos, Xos, Xos, Xos, Xos, Xoc, Xoc, Gs, Gs, Rr, Rr, Rr^Vd, Rp, Rp, Gg, Gg, Gg^Fet, Gs, Rr, Rp, Gs^Fds, Xos^Efs, Xos, Xos, Urb, Uu^Vud, Xos, Xos, Xos, Wog, Wog, Wog, Xos, Xos, Xoc^Zok, Xoc^Zok, Yhs^Zok, Yhs^Pr/, Xoc, Xoc^Efs, Xoc^Efs, Wog, Cud, Iwr^Ii, Iwr^Ii, Wog, Ior^Ii, Iwr^Ii, Wog, Iwr^Ii, Ior^Ii, Wog, Wog, Wog, Wog, Xoc, Cud, Xoc, Xoc, Xos, Xos, Xos, Xos, Xos, Xoc, Xos, Xos, Xos, Xos, Xos, Xos, Xos, Xos, Xos, Xos, Xos, Xos, Xos, Xos, Xos, Xos
Xos, Xos, Xos, Xos, Xos, Xos, Xos, Xos, Gs^Fds, Gs, Rp, Rp, Gs, Gs^Es, Gs, Gg, Gg^Fds, Rp, Rp, Gg, Rp, Rr, Rr, Rp, Urb, Xos^Efs, Xos^Efs, Xos, Xos, Xos, Xos, Xos, Wog, Wog, Wog, Xos, Xos, Xos, Xos, Xoc, Xoc^Efs, Xoc^Uov, Wog, Wog, Ior^Ii, Iwr^Ii, Wog, Wog, Wog, Wog, Ior^Ii, Iwr^Ii, Cud, Wog, Wog, Wog, Xoc, Xoc, Xos, Xoc, Xos, Xos, Xos, Xos, Xos, Xos, Xos, Xos, Xos, Xos, Xos, Xos, Xos, Xos, Xos, Xos, Xos, Xos, Xos, Xos, Xos, Xos, Xos, Xos
Xos, Xos, Xos, Xos, Xos, Xos, Gs^Fds, Gs^Fds, Rr, Rr, Gs^Fds, Gs, Xos, Cud, Cud, Gs, Gs, Gs^Fds, Gs, Rp, Rp, Rr, Rr, Rr, Rr^Pr/, Urb^Pr/, Urb, Xoc^Efs, Xoc^Efs, Xos, Xoc, Xoc, Wog, Wog, Wog, Xos, Xos, Xos, Xos, Xoc^Efs, Wog, Wog, Iwr^Ii, Iwr^Ii, Wog, Iwr^Ii, Iwr^Ii, Wog, Iwr^Ii, Iwr^Ii, Cud, Cud, Xoc, Xoc, Xoc, Xoc^Uov, Yhs^Pr/, Xoc, Xoc^Zok, Xos, Xos, Xos, Xos, Xos, Xos, Xos, Xos, Xos, Xos, Xos, Xos, Xos, Xos, Xos, Xos, Xos, Xos, Xos, Xos, Xos, Xos, Xos, Xos, Xos
Gll^Fp, Gll^Fp, Gll^Fp, Xos, Gs, Gs^Zz\, Rr^Zz\, Rr, Gs^Fds, Gs^Fds, Xos, Xos, Xos, Xos, Xos, Cud, Cud, Gs, Gs, Gg^Vhc, Gs^Fds, Gs^Fds, Xos, Urb^Pr/, Urb, Rr, Rr, Urb, Urb, Xos, Wog, Wog^Xo, Wog^Xo, Wog, Wog, Xos, Xos, Xos, Xoc, Xoc, Xoc, Iwr^Ii, Iwr^Ii, Wog, Wog, Wog, Iwr^Ii, Iwr^Ii, Wog, Wog, Xoc, Xoc, Xos, Xos, Xos, Xoc, Xoc^Zok, Yhs^Zok, Xoc^Zok, Xoc^Zok, Xos, Xos, Xos, Xos, Xos, Xos, Xos, Xos, Xos, Xos, Xos, Xos, Xos, Xos, Xos, Xos, Xos, Xos, Xos, Xos, Xos, Xos, Xos, Xos
Gll^Fp, Gg^Fet, Gs, Gs, Rr, Rr, Gs, Gs^Zz\, Xos, Xos, Xos, Xos, Xos, Xos, Xos, Xos, Xos, Cud, Cud, Cud, Xos, Xos, Xos, Xos, Xos, Urb, Urb, Rr, Wwg^Bsb\, Wwg, Wog, Wog, Wog, Wog^Xo, Xos, Xos, Xos, Xos, Xoc, Xoc, Iwr^Xo, Cud, Kud, Iwr^Ii, Iwr^Ii, Ior^Ii, Wog, Wog, Xoc^Uov, Xoc, Xoc, Xos, Xos, Xos, Xos, Xos, Xos, Xoc^Zok, Xos, Xos, Xos, Xos, Xos, Xos, Xos, Xos, Xos, Xos, Xos, Xos, Xos, Xos, Xos, Xos, Xos, Xos, Xos, Xos, Xos, Xos, Xos, Xos, Xos, Xos
Gs, Gs, Rr, Rr, Gs, Gs, Xos, Xos, Xos, Xos, Xos, Xos, Xos, Xos, Xos, Xos, Xos, Xos, Xos, Xos, Xos, Xos, Xos, Xos, Xos, Xos, Wwg, Wwg, Wog, Wog^Bsb\, Wwg^Bsb\, Wwg, Urb, Xoc, Xos, Xos, Xoc, Xoc, Iwr^Ebur, Iwr^Ebur, Icn, Icn^Xo, Iwr^Xo, Cud, Xoc, Wog, Xoc, Xoc, Xoc, Yhs^Pr/, Yhs^Zok, Xoc^Zok, Xoc^Zok, Xos, Xos, Xos, Xos, Xos, Xos, Xos, Xos, Xos, Xos, Xos, Xos, Xos, Xos, Xos, Xos, Xos, Xos, Xos, Xos, Xos, Xos, Xos, Xos, Xos, Xos, Xos, Xos, Xos, Xos, Xos
Rr, Rr, Gs, Gs, Gll^Fp, Xos, Xos, Xos, Xos, Xos, Xos, Xos, Xos, Xos, Xos, Xos, Xos, Xos, Xos, Xos, Xos, Xos, Xos, Xos, Wog^Xo, Wwg, Wog, Wog, Wwg, Wwg, Urb, Rr, Rr, Urb, Urb, Xoc^Efs, Cud^Xo, Iwr^Xo, Icn^Xo, Icn, Iwr, Iwr, Xoc, Xoc, Xos, Xoc, Xos, Xos, Xos, Xoc^Zok, Xoc^Zok, Xoc^Zok, Xos, Xos, Xos, Xos, Xos, Xos, Xos, Xos, Xos, Xos, Xos, Xos, Xos, Xos, Xos, Xos, Xos, Xos, Xos, Xos, Xos, Xos, Xos, Xos, Xos, Xos, Xos, Xos, Xos, Xos, Xos, Xos
Gs, Gs, Gll^Fp, Gg^Fet, Gll^Fp, Xos, Xos, Xos, Xos, Xos, Xos, Xos, Xos, Xos, Xos, Xos, Xos, Xos, Xos, Xos, Xos, Xos, Xos, Xos, Wog, Wog^Xo, Wog^Xo, Wog, Xos, Xos, Xos, Urb, Urb, Rr, Rr, Urb, Urb, Kud, Cud^Xo, Iwr^Xo, Xoc, Xoc, Xos, Xos, Xos, Xos, Xos, Xos, Xos, Xos, Xos, Xos, Xos, Xos, Xos, Xos, Xos, Xos, Xos, Xos, Xos, Xos, Xos, Xos, Xos, Xos, Xos, Xos, Xos, Xos, Xos, Xos, Xos, Xos, Xos, Xos, Xos, Xos, Xos, Xos, Xos, Xos, Xos, Xos
Gs, Gll^Fp, Gll^Fp, Gll^Fp, Xos, Xos, Xos, Xos, Xos, Xos, Xos, Xos, Xos, Xos, Xos, Xos, Xos, Xos, Xos, Xos, Xos, Xos, Xos, Xos, Wog, Wog, Wog, Xos, Xos, Xos, Xos, Xoc, Xoc, Urb, Urb, Rr, Rr, Rr, Urb, Xoc, Xos, Xos, Xos, Xos, Xos, Xos, Xos, Xos, Xos, Xos, Xos, Xos, Xos, Xos, Xos, Xos, Xos, Xos, Xos, Xos, Xos, Xos, Xos, Xos, Xos, Xos, Xos, Xos, Xos, Xos, Xos, Xos, Xos, Xos, Xos, Xos, Xos, Xos, Xos, Xos, Xos, Xos, Xos, Xos
Gll^Fp, Gll^Fp, Gll^Fp, Gll^Fp, Xos, Xos, Xos, Xos, Xos, Xos, Xos, Xos, Xos, Xos, Xos, Xos, Xos, Xos, Xos, Xos, Xos, Xos, Xos, Xos, Wog, Wog, Wog, Xos, Xos, Xos, Xos, Xos, Xos, Xoc, Xos, Urb, Urb, Rr, Urb, Xoc^Efs, Xoc^Efs, Xos, Xos, Xos, Xos, Xos, Xos, Xos, Xos, Xos, Xos, Xos, Xos, Xos, Xos, Xos, Xos, Xos, Xos, Xos, Xos, Xos, Xos, Xos, Xos, Xos, Xos, Xos, Xos, Xos, Xos, Xos, Xos, Xos, Xos, Xos, Xos, Xos, Xos, Xos, Xos, Xos, Xos, Xos
Gll^Fp, Gll^Fp, Gll^Fp, Xos, Xos, Xos, Xos, Xos, Xos, Xos, Xos, Xos, Xos, Xos, Xos, Xos, Xos, Xos, Xos, Xos, Xos, Xos, Xos, Xos, Wog, Wog, Wog, Xos, Xos, Xos, Xos, Xos, Xos, Xos, Xos, Xoc, Urb, Rr, Urb, Uu, Uh^Em, Xuc, Xu, Xos, Xos, Xos, Xos, Xos, Xos, Xos, Xos, Xos, Xos, Xos, Xos, Xos, Xos, Xos, Xos, Xos, Xos, Xos, Xos, Xos, Xos, Xos, Xos, Xos, Xos, Xos, Xos, Xos, Xos, Xos, Xos, Xos, Xos, Xos, Xos, Xos, Xos, Xos, Xos, Xos
Gll^Fp, Gll^Fp, Xos, Xos, Xos, Xos, Xos, Xos, Xos, Xos, Xos, Xos, Xos, Xos, Xos, Xos, Xos, Xos, Xos, Xos, Xos, Xos, Xos, Xos, Xos, Wog, Wog, Xos, Xos, Xos, Xos, Xos, Xos, Xos, Xoc^Efs, Xoc^Efs, Urb, Rr, Urb^Eb, Uu^Vud, Uu^Tf, Xuc, Xu, Xos, Xos, Xos, Xos, Xos, Xos, Xos, Xos, Xos, Xos, Xos, Xos, Xos, Xos, Xos, Xos, Xos, Xos, Xos, Xos, Xos, Xos, Xos, Xos, Xos, Xos, Xos, Xos, Xos, Xos, Xos, Xos, Xos, Xos, Xos, Xos, Xos, Xos, Xos, Xos, Xos
Gll^Fp, Xos, Xos, Xos, Xos, Xos, Xos, Xos, Xos, Xos, Xos, Xos, Xos, Xos, Xos, Xos, Xos, Xos, Xos, Xos, Xos, Xos, Xos, Xos, Xos, Xos, Xos, Xos, Xos, Xos, Xos, Xos, Xos, Xoc, Urb^Zz\, Urb, Rr, Rr, Urb, Uh, Xu, Xu, Xu, Xos, Xos, Xos, Xos, Xos, Xos, Xos, Xos, Xos, Xos, Xos, Xos, Xos, Xos, Xos, Xos, Xos, Xos, Xos, Xos, Xos, Xos, Xos, Xos, Xos, Xos, Xos, Xos, Xos, Xos, Xos, Xos, Xos, Xos, Xos, Xos, Xos, Xos, Xos, Xos, Xos
Xos, Xos, Xos, Xos, Xos, Xos, Xos, Xos, Xos, Xos, Xos, Xos, Xos, Xos, Xos, Xos, Xos, Xos, Xos, Xos, Xos, Xos, Xos, Xos, Xos, Xos, Xos, Xos, Xos, Xos, Xos, Xos, Xos, Urb, Rr, Rr^Zz\, Urb^Zz\, Urb, Xos, Xu, Xu, Xu, Xos, Xos, Xos, Xos, Xos, Xos, Xos, Xos, Xos, Xos, Xos, Xos, Xos, Xos, Xos, Xos, Xos, Xos, Xos, Xos, Xos, Xos, Xos, Xos, Xos, Xos, Xos, Xos, Xos, Xos, Xos, Xos, Xos, Xos, Xos, Xos, Xos, Xos, Xos, Xos, Xos, Xos
Xos, Xos, Xos, Xos, Xos, Xos, Xos, Xos, Xos, Xos, Xos, Xos, Xos, Xos, Xos, Xos, Xos, Xos, Xos, Xos, Xos, Xos, Xos, Xos, Xos, Xos, Xos, Xos, Xos, Xos, Xos, Xos, Xos, Urb, Rr, Urb, Xos, Xos, Xos, Xos, Xos, Xos, Xos, Xos, Xos, Xos, Xos, Xos, Xos, Xos, Xos, Xos, Xos, Xos, Xos, Xos, Xos, Xos, Xos, Xos, Xos, Xos, Xos, Xos, Xos, Xos, Xos, Xos, Xos, Xos, Xos, Xos, Xos, Xos, Xos, Xos, Xos, Xos, Xos, Xos, Xos, Xos, Xos, Xos
