border_size=1
usage=map

Xos, Xos, Xos, Xos, Xos, Xos, Xos, Xos, Xos, Xos, Xos, Xos, Xos, Xos, Xos, Xos, Xos, Xos, Xos, Xos, Wog, Wog, Wog, Wog, Xos, Xos, Xos, Cud, Gs, Gs, Gll^Fp, Gs, Gs, Rr, Rp, Gs, Gg, Gs, Gs, Cud, Xos, Xos, Xos, Xos, Xos, Xos, Xos, Xos, Xos, Xos, Xos, Xos, Xos, Xos, Xos, Xos, Xos, Xos, Xos, Xos, Xos, Xos, Xos, Xos, Xos, Xos, Xos, Xos, Xos, Xos, Xos, Xos, Xos, Xos, Xos, Xos, Xos, Xos, Xos, Xos, Xos, Xos, Xos, Xos
Xos, Xos, Xos, Xos, Xos, Xos, Xos, Xos, Xos, Xos, Xos, Xos, Xos, Xos, Xos, Xos, Xos, Xos, Wog^Z\, Wog, Xos, Wog, Wog, Wog, Xos, Xos, Xos, Cud, Gs, Gs, Gg^Fet, Gs, Rp, 1 Rr, Gs, Gg, Gg^Fet, Gs, Gs, Cud, Xos, Xos, Xos, Xos, Xos, Xos, Xos, Xos, Xos, Xos, Xos, Xos, Xos, Xos, Xos, Xos, Xos, Xos, Xos, Xos, Xos, Xos, Xos, Xos, Xos, Xos, Xos, Xos, Xos, Xos, Xos, Xos, Xos, Xos, Xos, Xos, Xos, Xos, Xos, Xos, Xos, Xos, Xos, Xos
Cud, Xos, Xos, Xos, Xos, Xos, Xos, Xos, Xos, Xos, Xos, Xos, Xos, Xos, Xos, Xos, Wog, Wog, Xos, Xos, Xos, Wog, Wog, Wog, Xos, Xos, Xos, Cud, Gs, Gll^Fp, Gs, Gs, Rp^Vd, Rr, Rp, Rp^Vh, Gll^Fp, Gll^Fp, Gs, Cud, Xos, Xos, Xos, Xos, Xos, Xos, Xos, Xos, Xos, Xos, Xos, Xos, Xos, Xos, Xos, Xos, Xos, Xos, Xos, Xos, Xos, Xos, Xos, Xos, Xos, Xos, Xos, Xos, Xos, Xos, Xos, Xos, Xos, Xos, Xos, Xos, Xos, Xos, Xos, Xos, Xos, Xos, Xos, Xos
Gs, Cud, Cud, Xos, Xos, Xos, Xos, Xos, Xos, Xos, Xos, Xos, Xos, Xos, Wog^Z\, Wog, Xos, Xos, Xos, Xos, Xos, Wog, Wog, Wog, Xos, Xos, Xos, Cud, Gs, Gll^Fp, Rp^Vh, Gg, Rp, Rr, Rp, Gs, Rp^Vhc, Gs, Gs, Cud, Xos, Xos, Xos, Xos, Xos, Xos, Xos, Xos, Xos, Xos, Xos, Xos, Xos, Xos, Xos, Xos, Xos, Xos, Xos, Xos, Xos, Xos, Xos, Xos, Xos, Xos, Xos, Xos, Xos, Xos, Xos, Xos, Xos, Xos, Xos, Xos, Xos, Xos, Xos, Xos, Xos, Xos, Xos, Xos
Gs, Gs, Gs, Cud, Cud, Cud, Cud, Cud, Cud, Xos, Xos, Xos, Wwf, Wwg, Xos, Xos, Xos, Xos, Xos, Xos, Xos, Wog, Wog, Wog, Xos, Xos, Xos, Cud, Cud, Gs, Gs, Rp, Rp, Rr, Gs, Rp, Gs, Gs, Cud, Cud, Xos, Xos, Xos, Xos, Xos, Xos, Xos, Xos, Xos, Xos, Xos, Xos, Xos, Xos, Xos, Xos, Xos, Xos, Xos, Xos, Xos, Xos, Xos, Xos, Xos, Xos, Xos, Xos, Xos, Xos, Xos, Xos, Xos, Xos, Xos, Xos, Xos, Xos, Xos, Xos, Xos, Xos, Xos, Xos
Gs, Gll^Fp, Gs, Gg, Gll^Fp, Gg, Gs, Gs, Gs, Cud, Cud, Xos, Wwf, Xos, Xos, Xos, Xos, Xos, Xos, Xos, Xos, Wog, Wog, Wog, Xos, Xos, Xos, Xos, Xos, Cud, Cud, Gs, Cud, Kud, Cud, Gg, Cud, Cud, Xos, Xos, Xos, Xos, Xos, Xos, Xos, Xos, Xos, Xos, Xos, Xos, Xos, Xos, Xos, Xos, Xos, Xos, Xos, Xos, Xos, Xos, Xos, Xos, Xos, Xos, Xos, Xos, Xos, Xos, Xos, Xos, Xos, Xos, Xos, Xos, Xos, Xos, Xos, Xos, Xos, Xos, Xos, Xos, Xos, Xos
Rr, Gg, Gs, Gll^Fp, Gll^Fp, Gs, Rr, Rp^Vd, Gs, Gs, Gs, Wwf, Wwf, Xos, Xos, Xos, Xos, Xos, Xos, Xos, Wog, Wog, Wog, Wog, Xos, Xos, Xos, Xos, Xos, Xos, Xos, Cud, Urb, Rr, Urb, Cud, Xos, Xos, Xos, Xos, Xos, Xos, Xos, Xos, Xos, Xos, Xos, Xos, Xos, Xos, Xos, Xos, Xos, Xos, Xos, Xos, Xos, Xos, Xos, Xos, Xos, Xos, Xos, Xos, Xos, Xos, Xos, Xos, Xos, Xos, Xos, Xos, Xos, Xos, Xos, Xos, Xos, Xos, Xos, Xos, Xos, Xos, Xos, Xos
Rr, Rr, Rr, Gs, Re, Gs, Rp, Rp, Gs, Gg, Wwf, Wwf, Gs, Cud, Xos, Xos, Xos, Xos, Xos, Xos, Wog, Wog, Wog, Wog, Xos, Xos, Xos, Xos, Xos, Xos, Xos, Cud, Urb, Rr, Urb, Cud, Xos, Xos, Xos, Xos, Xos, Xos, Xos, Xos, Xos, Xos, Xos, Xos, Xos, Xos, Xos, Xos, Xos, Xos, Xos, Xos, Xos, Xos, Xos, Xos, Xos, Xos, Xos, Xos, Xos, Xos, Xos, Xos, Xos, Xos, Xos, Xos, Xos, Xos, Xos, Xos, Xos, Xos, Xos, Xos, Xos, Xos, Xos, Xos
Gg, Rp, Rp, Rr, Rr, Rp, Ce, Rr, Rp, Rp^Vh, Gs, Gg, Gg, Cud, Xos, Xos, Xos, Xos, Xos, Xos, Wog, Wog, Wog, Xos, Xos, Xos, Xos, Xos, Xos, Xos, Xos, Cud, Urb, Rr, Urb, Cud, Xos, Xos, Xos, Xos, Xos, Xos, Xos, Xos, Xos, Xos, Xos, Xos, Xos, Xos, Xos, Xos, Xos, Xos, Xos, Xos, Xos, Xos, Xos, Xos, Xos, Xos, Xos, Xos, Xos, Xos, Xos, Xos, Xos, Xos, Xos, Xos, Xos, Xos, Xos, Xos, Xos, Xos, Xos, Xos, Xos, Xos, Xos, Xos
Gs, Gs^Es, Gll^Fp, Rp, Rp, Ce, 2 Ke, Ce, Rr, Rr, Rr, Gs, Cud, Cud, Xol, Xos, Xos, Xos, Xos, Wog^Xo, Wog^Xo, Wog^Xo, Wog^Xo, Xos, Xos, Xos, Xos, Xos, Xos, Xos, Xol, Xol, Urb, Rr, Urb, Xol, Xol, Xos, Xos, Xos, Xos, Xos, Xu, Xu, Xu, Xos, Xos, Xos, Xos, Xos, Xos, Xos, Xos, Xos, Xos, Xos, Xos, Xos, Xos, Xos, Xos, Xos, Xos, Xos, Xos, Xos, Xos, Xos, Xos, Xos, Xos, Xos, Xos, Xos, Xos, Xos, Xos, Xos, Xos, Xos, Xos, Xos, Xos, Xos
Gll^Fp, Gs, Gll^Fp, Gs, Rr, Ce, Ce, Ce, Rr, Rp, Rp, Rr, Cud, Urb, Urb, Xol, Xol, Xos, Wwg, Wog, Wog, Wog, Xos, Xos, Xos, Xos, Xos, Xos, Xos, Xos, Xos, Urb^Bzu, Urb, Rr, Urb, Urb^Bzu, Xos, Xos, Xos, Xos, Xu, Xu, Xu, Xu, Xu, Xu, Xu, Xos, Xos, Xos, Xos, Xos, Xos, Xos, Xos, Xos, Xos, Xos, Xos, Xos, Xos, Xos, Xos, Xos, Xos, Xos, Xos, Xos, Xos, Xos, Xos, Xos, Xos, Xos, Xos, Xos, Xos, Xos, Xos, Xos, Xos, Xos, Xos, Xos
Gll^Fp, Gs, Gg, Gg, Rp, Rp, Gs, Gs, Rp, Gs^Es, Gg, Cud, Urb, Rr, Rr, Urb^Bzu, Urb, Xol, Wwg, Wog, Wog, Wog, Xos, Xos, Xol, Xos, Urb, Xol, Xol, Xos, Urb, Urb, Rr, Rr, Urb, Urb, Xos, Xos, Xu, Xu, Xu, Xu, Xu, Xu, Xu, Xu, Xu, Xu, Xu, Xos, Xos, Xos, Xos, Xos, Xos, Xos, Xos, Xos, Xos, Xos, Xos, Xos, Xos, Xos, Xos, Xos, Xos, Xos, Xos, Xos, Xos, Xos, Xos, Xos, Xos, Xos, Xos, Xos, Xos, Xos, Xos, Xos, Xos, Xos
Gg, Gll^Fp, Gg, Gg, Gs, Rr, Gs, Gs, Rp^Vh, Gs, Gs, Cud, Xos, Urb, Urb^Bzu, Rr, Rr, Wwg, Wwg, Wog, Wwg, Xos, Xos, Xol, Urb, Urb, Rr, Urb, Urb, Urb, Rr, Rr, Urb, Urb, Xos, Xos, Xos, Xos, Xu, Xuc, Xos, Xos, Xos, Xu, Xu, Xu, Xu, Xu, Xu, Xu, Xu, Xos, Xos, Xos, Xos, Xos, Xos, Xos, Xos, Xos, Xos, Xos, Xos, Xos, Xos, Xos, Xos, Xos, Xos, Xos, Xos, Xos, Xos, Xos, Xos, Xos, Xos, Xos, Xos, Xos, Xos, Xos, Xos, Xos
Gg, Gg^Es, Gg, Gs, Gs, Rp^Vhc, Rr, Wwf, Wwf, Gs, Cud, Cud, Xos, Xos, Xos, Urb, Wwg, Wwg^Bsb\, Wwg^Bsb\, Wwg, Urb, Uu^Vud, Urb, Urb, Rr, Rr, Urb, Rr, Rr, Rr, Urb, Urb, Xos, Xos, Xos, Xos, Xos, Xu, Uh, Xu, Xos, Xos, Xos, Xos, Xu, Xu, Xu, Xu, Xu, Xu, Xu, Xu, Xos, Xos, Xos, Xos, Xos, Xos, Xos, Xos, Xos, Xos, Xos, Xos, Xos, Xos, Xos, Xos, Xos, Xos, Xos, Xos, Xos, Xos, Xos, Xos, Xos, Xos, Xos, Xos, Xos, Xos, Xos, Xos
Cud, Gg, Cud, Gg, Cud, Gs, Cud, Wwf, Wwf, Cud, Xos, Xos, Xos, Xos, Xos, Xos, Wwg, Wwg, Wwg, Rr, Rr, Urb, Rr, Rr, Urb, Urb, Xos, Urb, Urb, Urb, Xos, Xos, Xol, Xol, Uh^Ebur, Uu, Uu, Uh, Uh, Uh, Xos, Xos, Xu, Xu, Xu, Xu, Xu, Xu, Xu, Xu, Xu, Xu, Xos, Xos, Xos, Xos, Xos, Xos, Xos, Xos, Xos, Xos, Xos, Xos, Xos, Xos, Xos, Xos, Xos, Xos, Xos, Xos, Xos, Xos, Xos, Xos, Xos, Xos, Xos, Xos, Xos, Xos, Xos, Xos
Xos, Cud, Xos, Cud, Xos, Cud, Xos, Cud, Xos, Xos, Xos, Xos, Xos, Xos, Xos, Wog, Wog, Wog, Xos, Urb, Urb, Rr, Urb, Rr, Urb, Xos, Xos, Xos, Xos, Xos, Xos, Xos, Urb, Uh, Uu^Vud, Uu^Uf, Cud, Cud, Urb, Uu^Vud, Uh, Xu, Xu, Xu, Xu, Xu, Xu, Xu, Xu, Uu^Ii, Xu, Xu, Xos, Xos, Xos, Xos, Xos, Xos, Xos, Xos, Xos, Xos, Xos, Xos, Xos, Xos, Xos, Xos, Xos, Xos, Xos, Xos, Xos, Xos, Xos, Xos, Xos, Xos, Xos, Xos, Xos, Xos, Xos, Xos
Xos, Xos, Xos, Xos, Xos, Xos, Xos, Xos, Xos, Xos, Xos, Xos, Xos, Xos, Xos, Wog, Wog, Wog, Xos, Xos, Xos, Urb, Urb, Rr, Urb, Xos, Xos, Xos, Xos, Xos, Xol, Xol, Cud, Urb, Urb, Uu^Em, Cud, 5 Kud, Cud, Urb, Urb, Uh, Xu, Xu, Xu, Xu, Xos, Xu, Xu, Uu^Em, Uh, Xos, Yhl^Z\, Yhl, Xos, Xos, Xos, Xos, Xos, Xos, Xos, Xos, Xos, Xos, Xos, Xos, Xos, Xos, Xos, Xos, Xos, Xos, Xos, Xos, Xos, Xos, Xos, Xos, Xos, Xos, Xos, Xos, Xos, Xos
Xos, Xos, Xos, Xos, Xos, Xos, Xos, Xos, Xos, Xos, Xos, Xos, Xos, Xos, Xos, Wog^Xo, Wog^Xo, Wog^Xo, Xos, Xos, Xos, Xos, Urb, Rr, Urb, Xos, Xos, Xos, Xos, Xos, Urb, Urb, Rr, Cud, Urb, Urb, Urb, Cud, Urb, Uh, Xu, Xos, Xos, Xu, Xos, Xos, Xos, Xos, Xos, Uh, Yhl, Yhl, Xos, Xos, Xos, Xos, Xos, Xos, Xos, Xos, Xos, Xos, Xos, Xos, Xos, Xos, Xos, Xos, Xos, Xos, Xos, Xos, Xos, Xos, Xos, Xos, Xos, Xos, Xos, Xos, Xos, Xos, Xos, Xos
Xos, Xos, Xos, Xos, Xos, Xos, Xos, Xos, Xos, Xos, Xos, Xos, Xos, Xos, Xos, Wog, Wog, Wog, Xos, Xos, Xos, Xos, Urb, Rr, Urb, Xol, Xol, Xos, Xos, Xos, Urb, Rr, Urb, Cud, Xu, Urb, Uu^Vud, Uu, Uu^Uf, Uu^Uf, Xu, Xu, Xos, Xos, Xos, Xos, Yhl, Xos, Xos, Uu^Uf, Yhl, Wwb, Wwb^Z/, Xos, Xos, Xos, Xos, Xos, Xos, Xos, Xos, Xos, Xos, Xos, Xos, Xos, Xos, Xos, Xos, Xos, Xos, Xos, Xos, Xos, Xos, Xos, Xos, Xos, Xos, Xos, Xos, Xos, Xos, Xos
Xos, Xos, Xos, Xos, Xos, Xos, Xos, Xos, Xos, Xos, Xos, Xos, Xos, Xos, Xos, Wog, Wog, Wog, Xos, Xos, Iwr, Xos, Urb, Rr, Rr, Urb, Urb, Xos, Xol, Xos, Urb, Rr, Urb, Xos, Xos, Xu, Xu, Xu, Xu, Xu, Xu, Xu, Xu, Xos, Xos, Yhl, Yhl^Z/, Yhl^Z/, Yhl, Yhl, Uu^Uf, Xos, Xos, Wwb, Wwb, Xos, Xos, Xos, Xos, Xos, Xos, Xos, Xos, Xos, Xos, Xos, Xos, Xos, Xos, Xos, Xos, Xos, Xos, Xos, Xos, Xos, Xos, Xos, Xos, Xos, Xos, Xos, Xos, Xos
Xos, Xos, Xos, Xos, Xos, Xos, Xos, Xos, Xos, Xos, Xos, Xos, Xos, Xos, Xos, Wog, Xos, Xos, Xos, Iwr, Iwr, Iwr, Xos, Urb, Urb, Rr, Rr, Urb, Urb, Xol, Urb, Rr, Urb, Xos, Xos, Xu, Xu, Xu, Xu^Uov, Xu, Xu, Xu, Xu, Xu, Xu, Xos, Xu, Yhl^Xp, Yhl, Uu^Uf, Yhl^Xp, Uu^Vud, Uh, Xos, Xos, Wwb, Wwb, Xos, Xos, Xos, Xos, Xos, Xos, Xos, Xos, Xos, Xos, Xos, Xos, Xos, Xos, Xos, Xos, Xos, Xos, Xos, Xos, Xos, Xos, Xos, Xos, Xos, Xos, Xos
Xos, Xos, Xos, Xos, Xos, Xos, Xos, Xos, Xos, Xos, Xos, Xos, Xos, Xos, Xos, Xos, Xos, Xos, Wwg, Iwr, Iwr, Xos, Xos, Xos, Xos, Urb, Urb, Rr, Rr, Urb, Rr, Rr, Urb, Xos, Xos, Xu, Xu^Uov, Xu^Uov, Xu, Xu^Uov, Xu^Uov, Xu, Xu, Xu, Xu, Xu, Xu^Uov, Xu^Uov, Xu, Uu^Emf, Uu^Uf, Yhl^Xp, Yhl, Xos, Xos, Xos, Xos, Wwb, Xos, Xos, Xos, Xos, Xos, Xos, Xos, Xos, Xos, Xos, Qxu^Xo, Xos, Xos, Xos, Xos, Xos, Xos, Xos, Xos, Xos, Xos, Xos, Xos, Xos, Xos, Xos
Xos, Xos, Xos, Xos, Xos, Xos, Xos, Xos, Xos, Xos, Xos, Xos, Xos, Xos, Xos, Xos, Xos, Xos, Xos, Iwr, Iwr, Xos, Xos, Xos, Xos, Xos, Xos, Urb^Bzu, Rr, Rr, Urb, Urb, Xos, Xos, Wog, Wog, Wog^Es, Xu, Xu, Xu, Xu, Xu^Uov, Xu^Uov, Xu, Xu^Uov, Xu^Uov, Xu, Xu, Xu, Xos, Xos, Uu^Uf, Yhl^Z/, Yhl^Z/, Yhl, Xos, Xos, Xos, Xos, Xos, Xos, Xos, Xos, Xos, Xos, Xos, Qxu^Xo, Qxu^Xo, Qxu^Xo, Qxu^Xo, Qxu^Xo, Xos, Xos, Xos, Xos, Xos, Xos, Xos, Xos, Xos, Xos, Xos, Xos, Xos
Xos, Xos, Xos, Xos, Xos, Xos, Xos, Xos, Xos, Xos, Xos, Xos, Xos, Xos, Xos, Xos, Xos, Xos, Xos, Iwr, Iwr, Iwr, Iwr, Wwg, Xos, Xos, Xos, Urb, Rr, Urb, Xos, Xos, Xos, Xos, Wog, Wog, Wog, Xos, Xos, Xu, Xu, Xu, Xu, Xu^Uov, Xu, Xu, Xu, Xu, Xos, Xos, Xos, Xos, Xos, Yhl, Xos, Xos, Xos, Xos, Xos, Xos, Xos, Xos, Xos, Xos, Qxu^Xo, Qxu^Xo, Qxu^Xo, Qxu^Xo, Gs^Fds, Qxu^Xo, Qxu^Xo, Qxu^Xo, Qxu^Xo, Xos, Xos, Xos, Xos, Xos, Xos, Xos, Xos, Xos, Xos, Xos
Cud, Cud, Cud, Cud, Cud, Xos, Xos, Xos, Xos, Xos, Xos, Xos, Xos, Xos, Xos, Xos, Xos, Xos, Xos, Xos, Xos, Iwr, Iwr, Iwr, Iwr, Xos, Xol, Urb, Rr, Urb, Xos, Xos, Wog, Wog, Wog, Wog, Xos, Wog^Z/, Wog, Xos, Xos, Xu, Xu, Xu, Xu, Xu, Xos, Xos, Xos, Xos, Xos, Xos, Xos, Xos, Xos, Xos, Xos, Xos, Xos, Xos, Xos, Xos, Qxu^Xo, Qxu^Xo, Qxu^Xo, Qxu^Xo, Gs^Fds, Gs^Fds, Cud, Gs^Fds, Gg, Qxu^Xo, Qxu^Xo, Qxu^Xo, Qxu^Xo, Xos, Xos, Xos, Xos, Xos, Xos, Xos, Xos, Xos
Gs, Gs, Gs, Gs, Gs, Cud, Cud, Xos, Xos, Xos, Xos, Xos, Xos, Xos, Xos, Xos, Xos, Xos, Xos, Xos, Xos, Wwg, Xos, Iwr, Iwr, Xol, Urb, Urb, Rr, Urb, Xos, Xos, Wog, Wog, Uu^Uf, Uu^Emf, Xu, Xos, Xos, Wog, Wog, Xos, Xos, Xu, Xos, Xos, Xos, Xos, Xos, Xos, Xos, Xos, Xos, Xos, Xos, Xos, Xos, Xos, Xos, Xos, Qxu^Xo, Qxu^Xo, Qxu^Xo, Qxu^Xo, Gs^Fms, Gs^Fms, Gs^Fds, Gs^Fds, Gg, Gg, Cud, Cud, 3 Kud, Qxu^Xo, Qxu^Xo, Qxu^Xo, Qxu^Xo, Xos, Xos, Xos, Xos, Xos, Xos, Xos
Rp, Gs, Rp, Gs, Gs, Gs, Cud, Xos, Xos, Xos, Xos, Xos, Xos, Xos, Xos, Xos, Xos, Xos, Xos, Xos, Xos, Xos, Xol, Xos, Urb^Bzu, Urb, Rr, Rr, Urb, Urb, Xos, Xos, Wog, Wog, Wog, Xu, Xu, Xu, Xos, Xos, Xos, Wog, Wog, Xos, Xos, Xos, Xos, Xos, Xos, Xos, Xos, Xos, Xos, Xos, Xos, Xos, Xos, Xos, Qxu^Xo, Qxu^Xo, Qxu^Xo, Qxu^Xo, Gs^Fds, Gs^Fms, Gs^Fms, Gs^Fms, Gg^Efm, Gg, Gg, Gg, Cud, Cud, Cud, Cud, Gg, Qxu^Xo, Qxu^Xo, Qxu^Xo, Qxu^Xo, Xos, Xos, Xos, Xos, Xos
Rr, Rr, Rr, Rr, Rp, Gs, Cud, Xos, Xos, Xos, Xos, Wo, Xos, Xos, Xos, Xos, Xos, Xos, Xos, Xos, Xol, Xol, Urb, Urb, Rr, Rr, Urb, Urb, Xos, Xos, Xos, Xos, Uu, Uu^Vud, Uh, Wog, Wog, Xos, Xos, Xos, Xos, Xos, Xos, Wog, Wog, Xos, Xos, Xos, Xos, Xos, Xos, Xos, Xos, Xos, Xos, Xos, Qxu^Xo, Qxu^Xo, Qxu^Xo, Qxu^Xo, Gs^Fms, Gs^Fms, Gs^Fds, Gs^Fds, Gg, Gg, Gg, Gg, Rp, Rp, Rp, Cud, Cud, Cud, Gg, Gg, Gs^Fds, Qxu^Xo, Qxu^Xo, Qxu^Xo, Qxu^Xo, Xos, Xos, Xos
Rr, Rr, Rr, Rr, Rr, Gs, Gs, Xos, Xos, Xos, Xos, Wo^Xo, Xos, Xos, Xos, Xos, Xos, Xos, Xol, Xol, Urb, Urb, Rr, Rr, Urb, Urb, Xos, Xos, Xos, Xos, Xu, Xos, Uh, Uh, Xu, Xos, Xos, Wog^Z/, Wog, Xos, Xos, Xos, Xos, Xos, Xos, Xos, Xos, Xos, Xos, Xos, Xos, Xos, Xos, Xos, Qxu^Xo, Qxu^Xo, Qxu^Xo, Qxu^Xo, Gs^Fms, Gs^Fds, Gs^Fms, Gs^Fds, Gg^Efm, Gg^Efm, Gg, Gg^Es, Rp, Rp, Rp, Rp, Gg^Es, Gg, Gg, Gg, Gs^Fds, Cud, Gs^Fds, Gs^Fds, Qxu^Xo, Qxu^Xo, Qxu^Xo, Qxu^Xo, Xos, Xos
Rp, Rr, Rp, Rr, Gs, Rr, Rr^Zz/, Gs^Zz/, Gs^Fds, Xos, Xos, Wo, Xos, Xos, Cud, Cud, Cud, Cud, Gs, Urb, Rr, Rr, Urb, Urb, Xos, Xos, Xos, Xos, Qxu, Qxu, Qxu, Xu, Qxu, Qxu, Xu, Xu, Xos, Xos, Xos, Wog, Wog, Xos, Xos, Xos, Xos, Xos, Xos, Xos, Xos, Xos, Xos, Xos, Xos, Xos, Xos, Qxu^Xo, Gs^Fds, Gs^Fds, Gs^Fms, Gs^Fms, Gg^Efm, Gg^Efm, Gg^Efm, Gg, Rp, Rp, Rp, Rp, Gg, Gg^Efm, Gg, Gg, Gs^Fms, Gs^Fds, Gs^Fms, Gs^Fms, Qxu^Xo, Qxu^Xo, Qxu^Xo, Qxu^Xo, Xos, Xos, Xos, Xos
Gs, Gs, Gs, Gs, Xos, Gs^Zz/, Gs^Fds, Rr, Rr, Gs^Fds, Gs, Ww, Gg, Cud, Gs, Gs, Gg, Gg^Vhc, Rr, Rp, Rp, Urb, Xos, Xos, Xos, Xos, Xos, Xos, Qxu, Xu, Qxu, Xu, Xu, Qxu, Xu, Xu, Xos, Xos, Xos, Xos, Xos, Xos, Xos, Xos, Xos, Xos, Xos, Xos, Xos, Xos, Xos, Xos, Xos, Xos, Xos, Xos, Xos, Gs^Fms, Gg^Efm, Gg, Gg, Gg, Rp, Rp, Rp, Rp, Gg, Gg^Efm, Gg^Efm, Gg^Efm, Gs^Fds, Gs^Fds, Gs^Fms, Gs^Fds, Qxu^Xo, Qxu^Xo, Qxu^Xo, Qxu^Xo, Xos, Xos, Xos, Xos, Xos, Xos
Cud, Gs, Cud, Cud, Xos, Xos, Xos, Gs^Fds, Gs^Fds, Rr, Rr, Ww, Gs^Vh, Gg, Gs^Fds, Gs^Fds, Rp, Rp, Gs, Gs^Fds, Gg^Fet, Rp, Rr, Xos, Xos, Xos, Uu^Vud, Uu^Vud, Xos, Xu, Xu, Qxu, Qxu, Qxu, Xu, Xu, Xos, Xos, Xos, Xos, Xos, Xos, Xos, Xos, Xos, Xos, Xos, Xos, Xos, Xos, Xos, Xos, Cud, Xol, Xol, Xos, Xol, Xos, Xos, Gg, Rp, Rp, Rp, Rp, Gg, Gg, Gg^Es, Gg^Efm, Gs^Fms, Gs^Fds, Gs^Fds, Gs^Fms, Qxu^Xo, Qxu^Xo, Qxu^Xo, Qxu^Xo, Xos, Xos, Xos, Xos, Xos, Xos, Xos, Xos
Xos, Cud, Xos, Xos, Xos, Xos, Xos, Xos, Xos, Gs, Ww, Ww^Bw\, Rr, Gg, Rp, Rp, Ww, Ww, Ww, Gs^Fds, Gs^Fds, Rp, Rr, Rr, Cud, Xos, Urb, Urb^Em, Xos, Xos, Xu, Xu, Xu, Xu, Xu, Xu, Xos, Xos, Xos, Xos, Xos, Xos, Xos, Xos, Xos^Zok, Xos, Xos, Xos, Xos, Xos, Cud, Cud, Wog, Wog, Wog, Cud, Cud, Xol, Xol, Xos, Xos, Rp, Gg, Gg, Gg^Efm, Gg, Gs^Fds, Gs^Fds, Gs^Fms, Gs^Fds, Qxu^Xo, Qxu^Xo, Qxu^Xo, Qxu^Xo, Xos, Xos, Xos, Xos, Xos, Xos, Xos, Xos, Xos, Xos
Xos, Xos, Xos, Xos, Xos, Xos, Xos, Xos, Wo, Ww, Cud, Gs, Gs, Rp, Gs^Fds, Ww, Ww, Ww, Ww, Ww, Rb, Rp, Rr, Rr, Cud, Cud, Urb, Uh, Xos, Xos, Xos, Xu, Xu, Xu, Xos, Xos, Xos, Xos, Xos, Xos, Xos, Xos, Xos^Zok, Xos^Zok, Yhs^Zok, Xos^Zok, Xos, Xos, Xol, Xos, Wog, Wog, Wog, Wog, Cud, Wog, Wog, Cud, Cud, Xol, Xos, Xos, Xos, Gg, Gs^Fds, Gs^Fms, Gs^Fds, Gs^Fds, Qxu^Xo, Qxu^Xo, Qxu^Xo, Qxu^Xo, Xos, Xos, Xos, Xos, Xos, Xos, Xos, Xos, Xos, Xos, Xos, Xos
Xos, Xos, Xos, Xos, Xos, Xos, Wo, Wo^Xo, Xos, Xos, Cud, Gd, Gg^Fet, Rp, Gs, Wwf, Wwf^Ewl, Wwf^Ewf, Wwf^Ewl, Wwf^Ewl, Rr, Rr, Rr, Cud, 4 Kud, Cud, Xos, Xos, Xos, Xos, Xos, Xos, Xos, Xos, Xos, Xos, Xos, Xos, Xos, Xos, Xos, Xos, Xos, Xos^Zok, Xos, Yhs^Z/, Xos^Uov, Xol, Wog, Wog, Wog, Wog, Wog, Cud, 6 Cud, Cud, Wog, Wog, Wog, Cud, Xol, Xos, Xos, Xos, Xos, Gs^Fms, Qxu^Xo, Qxu^Xo, Qxu^Xo, Qxu^Xo, Xos, Xos, Xos, Xos, Xos, Xos, Xos, Xos, Xos, Xos, Xos, Xos, Xos, Xos
Xos, Xos, Xos, Xos, Xos, Xos, Xos, Xos, Xos, Xos, Cud, Gs^Fds, Gs^Fds, Rr, Gs, Wwf, Ww, Ww, Ww, Ww, Gs^Em, Rr, Rr, Cud, Cud, Cud, Urb, Xol, Xol, Xos, Xos, Xos, Xos, Xos, Xos, Xos, Xos, Xos, Xos, Xos, Xos, Xos, Xos, Xos, Xos, Xos, Xol, Wog, Wog, Wog, Iwr^Ii, Iwr^Ii, Iwr^Ii, Cud, Cud, Cud, Wog, Wog, Wog, Wog, Wog, Xol, Xos, Xos, Xos, Xos, Xos, Qxu^Xo, Xos, Xos, Xos, Xos, Xos, Xos, Xos, Xos, Xos, Xos, Xos, Xos, Xos, Xos, Xos, Xos
Xos, Xos, Xos, Xos, Xos, Xos, Xos, Xos, Xos, Xos, Cud, Gs^Fds, Gs^Em, Rr, Rr, Rr^Vd, Gg, Ww, Gs^Fds, Gs^Fds, Gg^Fds, Rr, Rp, Gs^Fds, Cud, Cud, Urb, Uh, Uu^Vud, Xos, Xos, Xos, Wog, Xos, Xos, Xos, Xos, Xos, Xos^Zok, Xos^Zok, Xos^Zok, Xos, Xos, Xos, Xos, Xol, Cud, Cud, Iwr^Ii, Iwr^Ii, Wog, Wog, Wog, Iwr^Ii, Iwr^Ii, Wog, Wog, Wog, Wog, Wog, Cud, Cud, Xos, Xos, Xos, Xos, Xos, Xos, Xos, Xos, Xos, Xos, Xos, Xos, Xos, Xos, Xos, Xos, Xos, Xos, Xos, Xos, Xos, Xos
Xos, Xos, Xos, Xos, Xos, Xos, Xos, Xos, Xos, Xos, Gs, Gs, Rr, Rr, Rr^Vd, Rp, Rp, Gg, Gg, Gg^Fet, Gs, Rr, Rp, Gs^Fds, Xol, Xos, Xos, Urb, Uu^Vud, Xos, Xos, Xos, Wog, Wog, Wog, Xos, Xos, Xos^Zok, Xos^Zok, Yhs^Zok, Yhs^Z/, Xos, Xol, Xol, Wog, Cud, Iwr^Ii, Iwr^Ii, Wog, Iwr^Ii, Iwr^Ii, Wog, Iwr^Ii, Iwr^Ii, Wog, Wog, Wog, Wog, Xos, Cud, Xos, Xos, Xos, Xos, Xos, Xos, Xos, Xos, Xos, Xos, Xos, Xos, Xos, Xos, Xos, Xos, Xos, Xos, Xos, Xos, Xos, Xos, Xos, Xos
Xos, Xos, Xos, Xos, Xos, Xos, Xos, Xos, Gs^Fds, Gs, Rp, Rp, Gs, Gs^Es, Gs, Gg, Gg^Fds, Rp, Rp, Gg, Rp, Rr, Rr, Rp, Urb, Xol, Xol, Xos, Xos, Xos, Xos, Xos, Wog, Wog, Wog, Xos, Xos, Xos, Xos, Xol, Xol, Xos^Uov, Wog, Wog, Iwr^Ii, Iwr^Ii, Wog, Wog, Wog, Wog, Iwr^Ii, Iwr^Ii, Cud, Wog, Wog, Wog, Xos, Xos, Xos, Xos, Xos, Xos, Xos, Xos, Xos, Xos, Xos, Xos, Xos, Xos, Xos, Xos, Xos, Xos, Xos, Xos, Xos, Xos, Xos, Xos, Xos, Xos, Xos, Xos
Xos, Xos, Xos, Xos, Xos, Xos, Gs^Fds, Gs^Fds, Rr, Rr, Gs^Fds, Gs, Xos, Cud, Cud, Gs, Gs, Gs^Fds, Gs, Rp, Rp, Rr, Rr, Rr, Rr^Zz/, Urb^Zz/, Urb, Xol, Xol, Xos, Xos, Xos, Wog, Wog, Wog, Xos, Xos, Xos, Xos, Xol, Wog, Wog, Iwr^Ii, Iwr^Ii, Wog, Iwr^Ii, Iwr^Ii, Wog, Iwr^Ii, Iwr^Ii, Cud, Cud, Xos, Xos, Xos, Xos^Uov, Yhs^Z/, Xos, Xos^Zok, Xos, Xos, Xos, Xos, Xos, Xos, Xos, Xos, Xos, Xos, Xos, Xos, Xos, Xos, Xos, Xos, Xos, Xos, Xos, Xos, Xos, Xos, Xos, Xos, Xos
Gll^Fp, Gll^Fp, Gll^Fp, Xos, Gs, Gs^Zz\, Rr^Zz\, Rr, Gs^Fds, Gs^Fds, Xos, Xos, Xos, Xos, Xos, Cud, Cud, Gs, Gs, Gg^Vhc, Gs^Fds, Gs^Fds, Xos, Urb^Zz/, Urb, Rr, Rr, Urb, Urb, Xos, Wog, Wog^Xo, Wog^Xo, Wog, Wog, Xos, Xos, Xos, Xos, Xos, Xos, Iwr^Ii, Iwr^Ii, Wog, Wog, Wog, Iwr^Ii, Iwr^Ii, Wog, Wog, Xos, Xos, Xos, Xos, Xos, Xos, Xos^Zok, Yhs^Zok, Xos^Zok, Xos^Zok, Xos, Xos, Xos, Xos, Xos, Xos, Xos, Xos, Xos, Xos, Xos, Xos, Xos, Xos, Xos, Xos, Xos, Xos, Xos, Xos, Xos, Xos, Xos, Xos
Gll^Fp, Gg^Fet, Gs, Gs, Rr, Rr, Gs, Gs^Zz\, Xos, Xos, Xos, Xos, Xos, Xos, Xos, Xos, Xos, Cud, Cud, Cud, Xos, Xos, Xos, Xos, Xos, Urb, Urb, Rr, Wwg^Bsb\, Wwg, Wog, Wog, Wog, Wog^Xo, Xos, Xos, Xos, Xos, Xos, Xos, Iwr^Xo, Cud, Kud, Iwr^Ii, Iwr^Ii, Iwr^Ii, Wog, Wog, Xos^Uov, Xos, Xos, Xos, Xos, Xos, Xos, Xos, Xos, Xos^Zok, Xos, Xos, Xos, Xos, Xos, Xos, Xos, Xos, Xos, Xos, Xos, Xos, Xos, Xos, Xos, Xos, Xos, Xos, Xos, Xos, Xos, Xos, Xos, Xos, Xos, Xos
Gs, Gs, Rr, Rr, Gs, Gs, Xos, Xos, Xos, Xos, Xos, Xos, Xos, Xos, Xos, Xos, Xos, Xos, Xos, Xos, Xos, Xos, Xos, Xos, Xos, Xos, Wwg, Wwg, Wog, Wog^Bsb\, Wwg^Bsb\, Wwg, Urb, Xos, Xol, Xos, Xos, Xos, Iwr^Ebur, Iwr^Ebur, Iwr, Iwr^Xo, Iwr^Xo, Cud, Xos, Wog, Xos, Xos, Xos, Yhs^Z/, Yhs^Zok, Xos^Zok, Xos^Zok, Xos, Xos, Xos, Xos, Xos, Xos, Xos, Xos, Xos, Xos, Xos, Xos, Xos, Xos, Xos, Xos, Xos, Xos, Xos, Xos, Xos, Xos, Xos, Xos, Xos, Xos, Xos, Xos, Xos, Xos, Xos
Rr, Rr, Gs, Gs, Gll^Fp, Xos, Xos, Xos, Xos, Xos, Xos, Xos, Xos, Xos, Xos, Xos, Xos, Xos, Xos, Xos, Xos, Xos, Xos, Xos, Wog^Xo, Wwg, Wog, Wog, Wwg, Wwg, Urb, Rr, Rr, Urb, Urb, Xol, Cud^Xo, Iwr^Xo, Iwr^Xo, Iwr, Iwr, Iwr, Xos, Xos, Xos, Xos, Xos, Xos, Xos, Xos^Zok, Xos^Zok, Xos^Zok, Xos, Xos, Xos, Xos, Xos, Xos, Xos, Xos, Xos, Xos, Xos, Xos, Xos, Xos, Xos, Xos, Xos, Xos, Xos, Xos, Xos, Xos, Xos, Xos, Xos, Xos, Xos, Xos, Xos, Xos, Xos, Xos
Gs, Gs, Gll^Fp, Gg^Fet, Gll^Fp, Xos, Xos, Xos, Xos, Xos, Xos, Xos, Xos, Xos, Xos, Xos, Xos, Xos, Xos, Xos, Xos, Xos, Xos, Xos, Wog, Wog^Xo, Wog^Xo, Wog, Xos, Xos, Xos, Urb, Urb, Rr, Rr, Urb, Urb, Kud, Cud^Xo, Iwr^Xo, Xos, Xos, Xos, Xos, Xos, Xos, Xos, Xos, Xos, Xos, Xos, Xos, Xos, Xos, Xos, Xos, Xos, Xos, Xos, Xos, Xos, Xos, Xos, Xos, Xos, Xos, Xos, Xos, Xos, Xos, Xos, Xos, Xos, Xos, Xos, Xos, Xos, Xos, Xos, Xos, Xos, Xos, Xos, Xos
Gs, Gll^Fp, Gll^Fp, Gll^Fp, Xos, Xos, Xos, Xos, Xos, Xos, Xos, Xos, Xos, Xos, Xos, Xos, Xos, Xos, Xos, Xos, Xos, Xos, Xos, Xos, Wog, Wog, Wog, Xos, Xos, Xos, Xos, Xos, Xos, Urb, Urb, Rr, Rr, Rr, Urb, Xos, Xos, Xos, Xos, Xos, Xos, Xos, Xos, Xos, Xos, Xos, Xos, Xos, Xos, Xos, Xos, Xos, Xos, Xos, Xos, Xos, Xos, Xos, Xos, Xos, Xos, Xos, Xos, Xos, Xos, Xos, Xos, Xos, Xos, Xos, Xos, Xos, Xos, Xos, Xos, Xos, Xos, Xos, Xos, Xos
Gll^Fp, Gll^Fp, Gll^Fp, Gll^Fp, Xos, Xos, Xos, Xos, Xos, Xos, Xos, Xos, Xos, Xos, Xos, Xos, Xos, Xos, Xos, Xos, Xos, Xos, Xos, Xos, Wog, Wog, Wog, Xos, Xos, Xos, Xos, Xos, Xos, Xos, Xos, Urb, Urb, Rr, Urb, Xol, Xol, Xos, Xos, Xos, Xos, Xos, Xos, Xos, Xos, Xos, Xos, Xos, Xos, Xos, Xos, Xos, Xos, Xos, Xos, Xos, Xos, Xos, Xos, Xos, Xos, Xos, Xos, Xos, Xos, Xos, Xos, Xos, Xos, Xos, Xos, Xos, Xos, Xos, Xos, Xos, Xos, Xos, Xos, Xos
Gll^Fp, Gll^Fp, Gll^Fp, Xos, Xos, Xos, Xos, Xos, Xos, Xos, Xos, Xos, Xos, Xos, Xos, Xos, Xos, Xos, Xos, Xos, Xos, Xos, Xos, Xos, Wog, Wog, Wog, Xos, Xos, Xos, Xos, Xos, Xos, Xos, Xos, Xos, Urb, Rr, Urb, Uu, Uh^Em, Xu, Xu, Xos, Xos, Xos, Xos, Xos, Xos, Xos, Xos, Xos, Xos, Xos, Xos, Xos, Xos, Xos, Xos, Xos, Xos, Xos, Xos, Xos, Xos, Xos, Xos, Xos, Xos, Xos, Xos, Xos, Xos, Xos, Xos, Xos, Xos, Xos, Xos, Xos, Xos, Xos, Xos, Xos
Gll^Fp, Gll^Fp, Xos, Xos, Xos, Xos, Xos, Xos, Xos, Xos, Xos, Xos, Xos, Xos, Xos, Xos, Xos, Xos, Xos, Xos, Xos, Xos, Xos, Xos, Xos, Wog, Wog, Xos, Xos, Xos, Xos, Xos, Xos, Xos, Xol, Xol, Urb, Rr, Urb^Bzu, Uu^Vud, Uu^Uf, Xu, Xu, Xos, Xos, Xos, Xos, Xos, Xos, Xos, Xos, Xos, Xos, Xos, Xos, Xos, Xos, Xos, Xos, Xos, Xos, Xos, Xos, Xos, Xos, Xos, Xos, Xos, Xos, Xos, Xos, Xos, Xos, Xos, Xos, Xos, Xos, Xos, Xos, Xos, Xos, Xos, Xos, Xos
Gll^Fp, Xos, Xos, Xos, Xos, Xos, Xos, Xos, Xos, Xos, Xos, Xos, Xos, Xos, Xos, Xos, Xos, Xos, Xos, Xos, Xos, Xos, Xos, Xos, Xos, Xos, Xos, Xos, Xos, Xos, Xos, Xos, Xos, Xos, Urb^Zz\, Urb, Rr, Rr, Urb, Uh, Xu, Xu, Xu, Xos, Xos, Xos, Xos, Xos, Xos, Xos, Xos, Xos, Xos, Xos, Xos, Xos, Xos, Xos, Xos, Xos, Xos, Xos, Xos, Xos, Xos, Xos, Xos, Xos, Xos, Xos, Xos, Xos, Xos, Xos, Xos, Xos, Xos, Xos, Xos, Xos, Xos, Xos, Xos, Xos
Xos, Xos, Xos, Xos, Xos, Xos, Xos, Xos, Xos, Xos, Xos, Xos, Xos, Xos, Xos, Xos, Xos, Xos, Xos, Xos, Xos, Xos, Xos, Xos, Xos, Xos, Xos, Xos, Xos, Xos, Xos, Xos, Xos, Urb, Rr, Rr^Zz\, Urb^Zz\, Urb, Xos, Xu, Xu, Xu, Xos, Xos, Xos, Xos, Xos, Xos, Xos, Xos, Xos, Xos, Xos, Xos, Xos, Xos, Xos, Xos, Xos, Xos, Xos, Xos, Xos, Xos, Xos, Xos, Xos, Xos, Xos, Xos, Xos, Xos, Xos, Xos, Xos, Xos, Xos, Xos, Xos, Xos, Xos, Xos, Xos, Xos
Xos, Xos, Xos, Xos, Xos, Xos, Xos, Xos, Xos, Xos, Xos, Xos, Xos, Xos, Xos, Xos, Xos, Xos, Xos, Xos, Xos, Xos, Xos, Xos, Xos, Xos, Xos, Xos, Xos, Xos, Xos, Xos, Xos, Urb, Rr, Urb, Xos, Xos, Xos, Xos, Xos, Xos, Xos, Xos, Xos, Xos, Xos, Xos, Xos, Xos, Xos, Xos, Xos, Xos, Xos, Xos, Xos, Xos, Xos, Xos, Xos, Xos, Xos, Xos, Xos, Xos, Xos, Xos, Xos, Xos, Xos, Xos, Xos, Xos, Xos, Xos, Xos, Xos, Xos, Xos, Xos, Xos, Xos, Xos
