Xos, Xos, Xos, Xos, Xos, Xos, Xos, Xos, Xos, Xos, Xos, Xos, Xos, Xos, Xos, Xos, Xos, Xos, Xos, Xos, Xos, Xos, Xos, Xos, Xos, Xos, Xos, Xos, Xos, Xos, Xos, Xos, Xos, Xos, Xos, Xos, Xos, Xos, Urb, Urb, Urb, Xos, Xos, Xos, Xos, Xos, Xos, Xos, Xos, Xos, Xos, Xos, Xos, Xos, Xos, Xos, Xos, Xos, Xos, Xos, Xos, Xos, Xos, Xos, Xos, Xos, Xos, Xos, Xos, Xos, Xos, Xos
Xos, Xos, Xos, Xos, Xos, Xos, Xos, Xos, Xos, Xos, Xos, Xos, Xos, Xos, Xos, Xos, Xos, Xos, Xos, Xos, Xos, Xos, Xos, Xos, Xos, Xos, Xos, Xos, Xos, Xos, Xos, Xos, Xos, Xos, Xos, Xos, Xos, Xos, Urb, Urb, Urb, Xos, Xos, Xos, Xos, Xos, Xos, Xos, Xos, Xos, Xos, Xos, Xos, Xos, Xos, Xos, Xos, Xos, Xos, Xos, Xos, Xos, Xos, Xos, Xos, Xos, Xos, Xos, Xos, Xos, Xos, Xos
Xos, Xos, Xos, Xos, Xos, Xos, Xos, Xos, Xos, Xos, Xos, Xos, Xos, Xos, Xos, Xos, Xos, Xos, Xos, Xos, Xos, Xos, Xos, Xos, Xos, Xos, Xos, Xos, Xos, Xos, Xos, Xos, Xos, Xos, Xos, Xos, Xos, Xos, Urb, Urb, Urb, Xos, Xos, Xos, Xos, Xos, Xos, Xos, Xos, Xos, Xos, Xos, Xos, Xos, Xos, Xos, Xos, Xos, Xos, Xos, Xos, Xos, Xos, Xos, Xos, Xos, Xos, Xos, Xos, Xos, Xos, Xos
Xos, Xos, Xos, Xos, Xos, Xos, Xos, Xos, Xos, Xos, Xos, Xos, Xos, Xos, Xos, Xos, Xos, Xos, Xos, Xos, Xos, Xos, Xos, Xos, Xos, Xos, Xos, Xos, Xos, Xos, Xos, Xos, Xos, Xos, Xos, Xos, Xos, Xos, Urb, Urb, Urb, Xos, Xos, Xos, Xos, Xos, Xos, Xos, Xos, Xos, Xos, Xos, Xos, Xos, Xos, Xos, Xos, Xos, Xos, Xos, Xos, Xos, Xos, Xos, Xos, Xos, Xos, Xos, Xos, Xos, Xos, Xos
Xos, Xos, Xos, Xos, Xos, Xos, Xos, Xos, Xos, Xos, Xos, Xos, Xos, Xos, Xos, Xos, Xos, Xos, Xos, Xos, Xos, Xos, Xos, Xos, Xos, Xos, Xos, Xos, Xos, Xos, Xos, Xos, Xos, Xos, Xu, Xos, Xos, Xos, Urb, Rr, Urb, Xos, Xos, Xos, Xos, Xos, Xos, Xos, Xos, Xos, Xos, Xos, Xos, Xos, Xos, Xos, Xos, Xos, Xos, Xos, Xos, Xos, Xos, Xos, Xos, Xos, Xos, Xos, Xos, Xos, Xos, Xos
Xos, Xos, Xos, Xos, Xos, Xos, Xos, Xos, Xos, Xos, Xos, Xos, Xos, Xos, Xos, Xos, Xos, Xos, Xos, Xos, Xos, Xos, Xos, Xos, Xos, Xos, Xos, Xos, Xos, Xos, Xos, Xos, Xu, Xu, Xu, Xu, Xu, Xos, Urb, Rr, Urb^Xo, Xos, Xos, Xos, Xos, Xos, Xos, Xos, Xos, Xos, Xos, Xos, Xos, Xos, Xos, Xos, Xos, Xos, Xos, Xos, Xos, Xos, Xos, Xos, Xos, Xos, Xos, Xos, Xos, Xos, Xos, Xos
Xos, Xos, Xos, Xos, Xos, Xos, Xos, Xos, Xos, Xos, Xos, Xos, Xos, Xos, Xos, Xos, Xos, Xos, Xos, Xos, Xos, Xos, Xos, Xos, Xos, Xos, Xu, Xos, Xos, Xos, Xos, Xu, Xu, Xu, Xu, Xu, Xu, Xos, Wog^Xo, Rr^Xo, Urb, Xos, Xos, Xos, Xos, Xos, Xos, Xos, Xos, Xos, Xos, Xos, Xos, Xos, Xos, Xos, Xos, Xos, Xos, Xos, Xos, Xos, Xos, Xos, Xos, Xos, Xos, Xos, Xos, Xos, Xos, Xos
Xos, Xos, Xos, Xos, Xos, Xos, Xos, Xos, Xos, Xos, Xos, Xos, Xos, Xos, Xos, Xos, Xos, Xos, Xos, Xos, Xos, Xos, Xos, Xos, Xu, Xu, Xu, Xu, Xu, Xos, Xos, Xos, Uh, Xu, Xu, Xu, Xu, Xos, Wog, Wog, Urb, Xos, Xos, Xos, Xos, Xos, Xos, Xos, Xos, Xos, Xos, Xos, Xos, Xos, Xos, Xos, Xos, Xos, Xos, Xos, Xos, Xos, Xos, Xos, Xos, Xos, Xos, Xos, Xos, Xos, Xos, Xos
Xos, Xos, Xos, Xos, Xos, Xos, Xos, Xos, Xos, Xos, Xos, Xos, Xos, Xos, Xos, Xos, Xos, Xos, Xos, Xos, Xos, Xos, Xos, Xu, Xu, Xu, Xu, Xu, Xu, Xu, Xu, Xos, Yhl, Uh, Xu, Xu, Xos, Wog, Urb, Wog, Wog, Xos, Xos, Xos, Xos, Xos, Xos, Xos, Xos, Xos, Xos, Xos, Xos, Xos, Xos, Xos, Xos, Xos, Xos, Xos, Xos, Xos, Xos, Xos, Xos, Xos, Xos, Xos, Xos, Xos, Xos, Xos
Xos, Xos, Xos, Xos, Xos, Xos, Xos, Xos, Xos, Xos, Xos, Xos, Xos, Xos, Xos, Wog, Wog, Xos, Xos, Xos, Xos, Xos, Xos, Xu, Xu, Xu, Xu, Xu, Xu, Xu, Xu, Xos, Uu, Uh, Xu, Xos, Urb^Ebur, Wog, Urb, Rr, Urb, Xos, Xos, Xos, Xos, Xos, Xos, Xos, Xos, Xos, Xos, Xos, Xos, Xos, Xos, Xos, Xos, Xos, Xos, Xos, Xos, Xos, Xos, Xos, Xos, Xos, Xos, Xos, Xos, Xos, Xos, Xos
Xos, Xos, Xos, Xos, Xos, Xos, Xos, Xos, Xos, Xos, Xos, Xos, Xos, Xos, Xos, Xos, Xos, Wog, Wog, Xos, Xos, Xos, Xos, Xu, Xu, Xu, Xu, Xu, Xu, Xu, Xu, Xu, Ur, Uu, Uh, Qxu, Uh, Urb, Rr, Rr, Urb, Xos, Cud, Xos, Xos, Xos, Xos, Xos, Xos, Xos, Xos, Xos, Xos, Xos, Xos, Xos, Xos, Xos, Xos, Xos, Xos, Xos, Xos, Xos, Xos, Xos, Xos, Xos, Xos, Xos, Xos, Xos
Xos, Xos, Xos, Xos, Xos, Xos, Xos, Xos, Xos, Xos, Xos, Xos, Xos, Xos, Xos, Xos, Xos, Xos, Xos, Wog, Rr^Pr/, Xos, Uh, Wwf, Wwf^Es, Xu, Tb^Tf, Wwf, Uu, Xu, Xu, Xu, Ur, Ur, Uh, Uh, Ur, Rr, Urb, Rr, Rr, Urb, Urb, Xos, Cud, Xos, Xos, Xos, Xos, Xos, Xos, Xos, Xos, Xos, Xos, Xos, Xos, Xos, Xos, Xos, Xos, Xos, Xos, Xos, Xos, Xos, Xos, Xos, Xos, Xos, Xos, Xos
Xos, Xos, Xos, Xos, Xos, Xos, Xos, Xos, Xos, Xos, Xos, Yhr, Yhr, Xos, Xos, Xos, Xos, Xos, Xos, Xos, Xos, Wog, Uh, Uh, Wwf, Uu^Tf, Tb^Tf, Ur, Xu, Xu, Xu, Xu, Uh, Qxu, Xos, Uu, Xos, Urb, Xos, Urb, Urb, Rr, Rr, Urb, Urb, Xos, Cud, Xos, Xos, Xos, Xos, Xos, Xos, Xos, Xos, Xos, Xos, Xos, Xos, Xos, Xos, Xos, Xos, Xos, Xos, Xos, Xos, Xos, Xos, Xos, Xos, Xos
Xos, Xos, Xos, Xos, Xos, Xos, Xos, Xos, Xos, Xos, Xos, Xos, Xu, Yhr, Yhr, Xuc, Xu, Xos, Xu, Xu, Xos, Wog, Wog, Uh, Ur, Ur, Uh, Uh, Xu, Xu, Xu, Xu, Uh, Uu, Xu, Xos, Xos, Xos, Xos, Cud, Xos, Urb, Urb, Rr, Rr, Urb, Urb, Xos, Xos^Efs, Xos, Xos, Xos, Xos, Xos, Xos, Xos, Xos, Xos, Xos, Xos, Xos, Xos, Xos, Xos, Xos, Xos, Xos, Xos, Xos, Xos, Xos, Xos
Xos, Xos, Xos, Xos, Xos, Xos, Xos, Xos, Xos, Xos, Xos, Xos, Xu, Xuc, Yhr^Pr/, Xuc, Xuc, Xu, Xuc, Xos^Xzm/, Wwg, Wog, Wog, Uu, Uh, Uh, Xu, Uh, Xu, Xu, Xu, Xu, Xos, Xu, Xu, Xu, Xu, Xos, Xos, Xos, Xos, Cud, Xos, Urb, Urb, Rr, Rr, Urb, Urb, Xos^Efs, Xos, Xos, Xos, Xos, Xos, Xos, Xos, Xos, Xos, Xos, Xos, Xos, Xos, Xos, Xos, Xos, Xos, Xos, Xos, Xos, Xos, Xos
Xos, Xos, Xos, Xos, Xos, Xos, Xos, Xos, Xos, Xos, Yhr, Xos, Xos, Xuc, Yhr, Yhr, Yhr^Xp, Xuc, Ss, Ss, Wwg, Wog, Wog, Wog, Xos, Xos, Xos, Xu, Xu, Xu, Xos, Xos, Xos, Xu, Xu, Xu, Xos, Xos, Xos, Xos, Xos, Xos, Xos, Cud, Xos, Urb, Urb, Rr, Kud, Cud, Urb, Xos^Efs, Xos^Efs, Xos, Xos, Xos, Xos, Xos, Xos, Xos, Xos, Xos, Xos, Xos, Xos, Xos, Xos, Xos, Xos, Xos, Xos, Xos
Xos, Xos, Xos, Xos, Xos, Xos, Xos, Xos, Xos, Yhr, Yhr^Pr/, Xos^Xzm/, Uu^Tf, Uh, Urb, Yhr^Xp, Urb, Xu, Ss, Ss, Ss, Uh, Xos, Wog^Pr/, Wog, Xos, Xu, Xu, Xu, Xu, Xu, Xos, Xos, Xos, Xos, Xos, Xos, Xos, Xos, Xos, Xos, Xos, Xos, Xos, Xos, Xos, Xos, Cud, Urb, Rr, Rr, Urb, Xos, Xos, Xos, Xos, Xu, Xos, Xos, Xos, Xos, Xos, Xos, Xos, Xos, Xos, Xos, Xos, Xos, Xos, Xos, Xos
Xos, Xos, Xos, Xos, Xos, Xos, Wwb, Xos, Xos, Xos, Xos, Yhr, Yhr^Xp, Urb^Emf, Urb, Urb, Urb, Uh, Xu, Ss, Xu, Xu, Xos, Wog, Wog, Wog, Wog, Xu, Xu, Xu, Xu, Xu, Xu, Xos, Xos, Xos, Xos, Xos, Xos, Xos, Xos, Xos, Xos, Xos, Urb, Xos, Xos, Xos, Xos, Urb, Rr, Urb, Xos, Xos, Xu, Xu, Xu, Xu, Xu, Xos, Xos, Xos, Xos, Xos, Xos, Xos, Xos, Xos, Xos, Xos, Xos, Xos
Xos, Xos, Xos, Xos, Xos, Xos, Xos, Wwb^Pr/, Wwb, Xos, Uh, Yhr, Urb, Urb, Urb, Urb, Urb, Uh, Xuc, Xuc, Xuc, Xu, Xos, Xos, Xu, Wog, Wog, Wog, Wog, Xu, Xu, Xu, Xu, Xos, Xos, Xos, Xos, Xos, Xos, Xos, Xos, Xos, Xos, Xos, Urb, Rr, Urb, Xos, Xos, Urb, Rr, Urb, Xos, Xos, Xu, Xu, Qxu, Xu, Xu, Xu, Xu, Xos, Xos, Xos, Xos, Xos, Xos, Xos, Xos, Xos, Xos, Xos
Xos, Xos, Xos, Xos, Xos, Xos, Xos, Xos, Yhl, Wwb, Wwb, Urb, Urb, Urb, Urb, Urb, Urb, Urb, Urb, Wwf, Wwf, Xos, Xos, Xu, Xu, Xu, Xu, Wog, Xu, Xu, Xu, Xu, Xos, Xos, Xos, Xos, Xos, Xos, Xos, Xos, Xos, Xos, Xos, Xos, Urb^Xo, Rr^Xo, Urb^Xo, Xos, Xos, Urb, Rr, Urb, Xos^Efs, Xos, Xu, Xu, Qxu^Xo, Qxu, Qxu, Xu, Xu, Xos, Xos, Xos, Xos, Xos, Xos, Xos, Xos, Xos, Xos, Xos
Xos, Xos, Xos, Xos, Xos, Xos, Yhl, Yhl^Pr\, Xot, Xos, Wwb, Wwb, Wwb, Urb, Urb, Uu^Tf, Uu^Tf, Urb, Urb, Urb, Wwf, Xos, Xos^Efs, Uh, Uu^Tf, Xu, Xu, Xu, Xu, Xu, Xos, Xos, Xos, Xos, Iwo^Ebme, Xos, Xos, Xos, Xos, Xos, Xos, Xos, Xos, Xos, Urb, Rr, Urb, Xos, Xos, Urb, Rr, Urb, Urb, Xos^Efs, Xu, Xu, Qxu, Qxu^Xo, Qxu^Xo, Xu, Xu, Xos, Xos, Xos, Xos, Xos, Xos, Xos, Xos, Xos, Xos, Xos
Xos, Xos, Xos, Xos, Yhl, Yhl, Xos, Xos, Yhl^Pr\, Yhl, Xos, Wwb, Wwb, Wwb, Urb, Uu^Tf, Xu, Xu, Xu, Urb, Wwf, Urb, Urb, Uh, Yhr^Xp, Xu, Xu, Xu, Xos, Xos, Xos, Xos, Xos, Iwo, Rb^Ii, Iwo, Xos, Xos, Xos, Xos, Xos, Xos, Xos, Xos, Urb, Rr, Urb, Xos, Xos, Urb, Urb, Rr, Rr, Urb, Uh, Xu, Qxu, Qxu, Qxu, Xu, Xu, Xos, Xos, Xos, Xos, Xos, Xos, Xos, Xos, Xos, Urb, Urb
Xos, Xos, Xos, Yhl, Xos, Xos, Yhl, Yhl, Xos, Xos, Yhl, Yhl^Xp, Wwb, Wwb, Xos, Uh, Xu, Xu, Xos, Xos, Xos, Wwf, Wwf^Xo, Urb^Xo, Urb^Xo, Uh, Xos, Xos, Xos, Xos, Iwo^Ebme, Xos, Iwr, Iwr, Iwo, Iwo, Iwr, Xos, Xos, Xos, Xos, Xos, Xos, Xos, Urb, Rr, Urb, Xos, Xos, Xos, Xos, Urb, Urb, Rr, Uh, Qxu, Qxu, Qxu, Xu, Xu, Xu, Xos, Xos, Xos, Xos, Xos, Xos, Xos, Urb, Urb, Urb, Urb
Xos, Xos, Xos, Xos, Xos, Yhl, Xos, Xos, Xos, Xos, Wwb, Wwb, Xos, Xos, Xos, Xu, Xu, Xos, Xos, Xos, Xos, Xos, Wwf, Urb, Urb, Xos, Xos^Xzm\, Xos, Xos, Iwo, Rb^Ii, Iwo, Xos, Xos, Xos, Xos, Xos, Iwo, Iwo, Iwr^Ebme, Iwo, Xos, Xos, Xos, Urb, Rr, Urb, Xos, Xos, Xos, Xos, Xos, Xos, Urb, Qxu, Qxu, Qxu, Qxu, Urb, Xu, Xos, Xos, Xos, Xos, Xos, Xos, Urb, Urb, Urb, Urb, Urb, Urb
Xos, Xos, Xos, Xos, Xos, Xos, Xos, Xos, Wwb, Wwb^Pr\, Xos, Xos, Xos, Xos, Xos, Xu, Xos, Xos, Xos, Xos^Xzm/, Uu^Tf, Uu^Tf, Wwf, Urb, Urb, Urb, Urb^Eb, Xos^Xzm\, Urb^Xo, Iwr, Iwo, Iwo, Iwr, Xos, Iwo^Ebme, Xos, Xos, Xos, Iwo, Rb^Ii, Iwr, Xos, Xos, Xos, Urb, Rr, Urb, Xos, Xos, Xos, Xu, Xos, Xu, Xu, Qxu^Xo, Qxu, Qxu, Uh, Rr, Uh, Urb, Xos, Xos^Efs, Xos, Xos, Xos, Urb, Urb, Urb, Urb, Xos, Xos
Xos, Xos, Xos, Xos, Xos, Xos, Xos, Wwb, Xos, Xos, Xos, Xos, Xos, Xos, Xos, Xos, Xos^Xzm/, Xos^Xzm/, Wwf, Wwf, Wwf, Xos, Wwf, Urb, Urb, Urb, Urb, Urb, Urb, Xos, Xos, Xos, Xos, Iwo, Rb^Ii, Iwo, Xos, Xos, Xos, Iwo, Xos, Xos, Xos, Xos, Urb, Rr, Urb, Xos, Xos, Xu, Xu, Xos, Xu, Xu, Qxu, Qxu^Xo, Qxu^Xo, Uh, Uh, Rr, Rr, Urb, Urb, Xos^Efs, Xos, Xos, Urb, Urb, Urb, Xos, Xos, Xos
Xos, Xos, Xos, Xos, Xos, Xos, Xos, Xos, Xos, Xos, Xos, Xos, Xos, Xos, Xos, Xos, Xu, Uu^Tf, Wwf, Wwf^Es, Wwf^Es, Wwf, Urb, Urb, Urb, Urb, Urb, Urb, Urb, Urb^Eb, Urb, Xos, Xos^Xzm\, Iwo, Iwo, Iwo, Xos, Xos, Xos, Xos, Xos, Xos, Xos, Xos, Urb, Rr, Urb, Xos, Xos, Wwg, Wwf, Xu, Xu, Xu, Qxu, Qxu, Xu, Xu, Xos, Urb, Urb, Rr, Rr^Xo, Urb^Xo, Urb, Xos, Urb, Urb, Urb, Xos, Xos, Xos
Xos, Xos, Xos, Xos, Xos, Xos, Xos, Xos, Xos, Xos, Xu, Xos, Xos^Xzm/, Xos, Wwf, Xu, Xu, Rb^Tf, Urb, Wwf, Wwf, Urb, Urb, Urb, Urb, Urb, Urb, Urb, Urb, Urb, Urb, Urb, Xos, Xos, Xos, Xos, Xos, Xos, Xu, Xos, Xos, Xos, Xos, Xos, Urb, Rr, Urb, Xos, Xos, Wwg, Wwrg, Wwf, Xu, Xu, Qxu, Qxu, Xu, Xu, Xos, Xos, Xos, Urb^Xo, Urb, Rr, Rr, Urb, Urb, Urb, Urb, Xos, Xos, Xos
Xos, Xos, Xos, Xos, Xos, Xos, Xos, Xos, Xos, Xu, Xu, Xu, Xu, Wwf, Wwf^Es, Xu, Xu, Rb, Urb, Urb, Urb, Urb, Urb, Urb, Urb, Urb, Rb, Xos, Urb, Urb, Xos, Xos, Xos, Xos, Xos^Xzm/, Xos^Xzm/, Uh, Xu, Xu, Xu, Xu, Xos, Xos, Xos, Urb^Xo, Rr, Urb^Xo, Xos, Xos, Wwg, Wwg, Uh, Xu, Xu, Xu, Xu, Xuc, Xu, Xos, Xos, Xos, Xos, Xos, Urb, Urb, Urb, Urb, Urb, Urb, Xos, Xos, Xos
Xos, Xos, Xos, Xos, Xos, Xos, Xos, Xos, Xos, Xos, Uh, Xu, Urb, Urb, Wwf, Urb, Urb, Urb, Urb, Urb, Urb, Urb, Urb, Urb, Uh, Rb, Rb, Urb, Xos, Xos, Xos, Xos, Xu, Xu, Xuc, Uu^Tf, Tb^Tf, Uh, Xu, Xu, Xu, Xu, Xos, Xos, Urb, Rr^Xo, Urb, Xos, Xos, Xu, Wwf, Wwg, Wwrg, Xu, Xu, Xuc, Uh, Xos, Xos, Xos, Xos, Xos, Xos, Xos, Xos, Urb, Urb, Urb, Urb, Urb, Urb, Xos
Xos, Xos, Xos, Xos, Xos, Xos, Xos, Xos, Xu, Uh, Uh, Xos, Urb, Urb, Urb, Wwf^Es, Urb, Urb, Urb, Urb, Wwf, Wwf, Xos, Urb, Uh, Rb, Xos, Xos, Xos, Xos, Uu, Uu, Urb, Xuc, Wwf, Uu^Emf, Uu^Tf, Tb^Tf, Uh, Uh, Xos, Xos, Xos, Xos, Urb, Rr, Urb, Xos, Xos, Xu, Xu, Wwg, Wwg, Wwf^Es, Wog, Wog, Uu^Tf, Xos, Xos, Xos, Xos, Xos, Xos, Xos, Xos, Xos, Xos, Urb, Urb, Urb, Urb, Urb
Xos, Xos, Xos, Xos, Xos, Xos, Xos, Xu, Xu, Xu, Uu^Tf, Tb^Tf, Uu^Tf, Urb, Urb, Urb, Urb, Urb, Urb, Urb, Xu, Wwf, Wwf, Urb, Xos, Xos, Xos, Xos, Uu, Uu, Xu, Rb, Urb, Urb, Wwf, Uu^Em, Uh, Uh, Xu, Xos, Xos, Xos, Xos, Xos, Xos, Xos, Xos, Xos, Xos, Xu, Xu, Xu, Xu, Wwg^Es, Wog, Wwg^Es, Uh, Xos, Xos, Xos, Xos, Xos, Xos, Xos, Xos, Xos, Xos, Xos, Xos, Urb, Urb, Urb
Xos, Xos, Xos, Xos, Xos, Xos, Xos, Xos, Xos, Urb, Xu, Uh, Urb, Urb, Urb, Urb, Urb, Urb, Uh, Rb, Xu, Xu, Xos, Xos, Xos, Xos, Uh, Uh, Uh, Uu, Rb, Rb, Urb, 1 Urb, Rb, Wwf, Wwf, Xuc, Xu, Xos, Xos, Xos, Xos, Xos, Xos, Xos, Xos, Xos, Xos, Xos, Xos, Xu, Xos, Wog, Wwg^Es, Wwf, Xu, Xos, Xos, Xos, Xos, Xos, Xos, Xos, Xos, Xos, Xos, Xos, Xos, Xos, Xos, Urb
Xos, Xos, Xos, Xos, Xos, Xos, Xos, Xos, Xos, Xos, Xos, Uh, Uh, Xu, Xu, Urb, Wwf^Es, Xos, Uh, Rb^Tf, Xos, Xu, Xos, Xos, Xos, Xos, Xu, Uh, Uh, Uh, Urb, Uh, Urb, Urb, Urb, Urb, Qxu, Qxu, Qxu, Qxu, Xu, Xos, Xos, Xos, Xos, Xos, Xos, Xos, Xos, Xos, Xu, Xos, Wwrg, Wwg, Wwf, Xu, Xu, Xos, Xos, Xom, Xom, Xos, Xos, Xos, Xos, Xos, Xos, Xos, Xos, Xos, Xos, Xos
Xos, Xos, Xos, Xos, Xos, Xos, Xos, Xos, Xos, Xos, Xos, Xos, Xos, Xu, Xu, Wwf, Wwf, Wwf, Xos, Xos, Xos, Xos, Uh, Uh, Xos, Xu, Xu, Xuc, Rb^Es, Rb, Uh, Uh, Uu, Urb, Rb, Urb, Qxu, Qxu, Qxu, Qxu, Xu, Xu, Xos, Xos, Xos, Xos, Xos, Xos, Xos, Xu, Xu, Xuc, Wwrg, Wwg, Wwf, Xu, Xos, Xos, Xom, Xos, Gd^Fdw, Xom, Xom, Xos, Xos, Xos, Xos, Xos, Xos, Xos, Xos, Xos
Xos, Xos, Xos, Xos, Xos, Xos, Xos, Xos, Xos, Xos, Xos, Xos, Xos, Xos, Xos, Wwf^Es, Xos, Xos, Xu, Xu, Uh, Urb, Urb, Uh, Xos, Xos, Urb, Urb, Xu, Xos, Xos, Uh, Uh, Uu, Xu, Xu, Xu, Qxu, Qxu, Qxu, Urb, Xu, Xos, Xos, Xos, Xos, Xos, Xos, Xos, Xos, Xos, Xuc, Xu, Wwg, Wwg, Xos, Iwr, Iwr^Eb, Iwo, Gd^Fdw, Gd^Fdw, Gd^Fdf, Xos, Xos, Xos, Xos, Xos, Xos, Xos, Xos, Xos, Xos
Xos, Xos, Xos, Xos, Xos, Xos, Xos, Xos, Xos, Xos, Xos, Xos, Xos, Xos, Xos^Zok, Xos, Xos, Xos, Xu, Xu, Uh, Urb, Urb, Urb, Urb, Xos, Xos, Xos, Xos, Xos, Xos, Uh, Xu, Uu, Xu, Xu, Xu, Qxu, Qxu, Qxu, Xu, Urb, Urb, Xos, Xos, Xos, Xos, Xos, Xos, Xos, Xos, Xu, Xos, Xos, Iwo, Wwg, Wwg, Wwg, Wwg, Iwo, Iwr, Xos, Xos, Xos, Xos, Xos, Xos, Xos, Xos, Xos, Xos, Xos
Xos, Xos, Xos, Xos, Xos, Xos, Xos, Xos, Xos, Xos, Xos, Xos, Xos, Xos^Zok, Yhl^Zok, Xos^Zok, Xos, Xu, Uh, Uh, Xu, Xu, Uh, Urb, Urb, Urb, Urb, Xos, Xos, Xos, Xos, Xu, Xu, Xu, Xu, Xu, Xu, Qxu, Qxu, Xu, Xu, Xu, Urb, Xos, Xu, Xos, Xos, Xos, Xos, Xos, Xos, Xos, Iwr^Ebn, Iwr, Wwg, Wwg, Wwg, Wwg, Wwg, Wwg, Iwr, Iwr^Ebn, Xos, Xos, Xos, Xos, Xos, Xos, Xos, Xos, Xos, Xos
Xos, Xos, Xos, Xos, Xos, Xos, Xos, Xos, Xos, Xos, Xos, Xos, Xos, Xos^Zok, Yhl^Zok, Xos^Zok, Xos, Xos, Xos, Xu, Xu, Uh, Uh, Uh, Uh, Urb, Urb, Xu, Xu, Xos, Xos, Xu, Xu, Xu, Xu, Xu, Xu, Xos, Xos, Xu, Xos, Xu, Urb, Xu, Xu, Xu, Xos, Xos, Xos, Xos, Xos, Xos, Xos, Iwr, Iwo, Wwg, Wwg, Wwg, Iwo, Iwo, Xos^Efs, Xos, Xos, Xos, Xos, Xos, Xu, Xu, Xu, Xos, Xos, Xos
Xos, Xos, Xos, Xos, Xos, Xos, Xos, Xos, Xos, Xos, Xos, Xos, Xos, Xos^Zok, Yhl^Zok, Xos^Zok, Xos, Xos, Xos, Xu, Xos, Xos, Xos, Xu, Xu, Uh, Xos, Xu, Xu, Xu, Xu, Xu, Xu, Xu, Xu, Xu, Xu, Xos, Xos, Xos, Xos, Xos, Xos, Xu, Xu, Xos, Xos, Xos, Xos, Xos, Xos, Xos, Gd^Fdw, Gd^Fdf, Gd^Fdw, Iwr, Iwr^Ebn, Iwr, Xos, Rr, Rr, Xos^Efs, Xom, Xom, Xom, Xos, Xos, Xu, Xuc, Xu, Xu, Xos
Xos, Xos, Xos, Xos, Xos, Xos, Xos, Xos, Yhr, Xos, Xos, Xos, Xos, Xos, Yhl, Xos, Xos, Xos, Xos, Xos, Xos, Xos, Xos, Xu, Xu, Xos, Xos, Xos, Xu, Xu, Xu, Xu, Xu, Xu, Xu, Xu, Xos, Xos, Xos, Xos, Xos, Xos, Xos, Xu, Xos, Urb, Urb, Xos, Xos, Xos, Xos, Xos, Xos, Gd^Fdf, Xos, Xos, Xos, Xos, Xos, Xos, Xos, Rr, Rr, Urb, Urb, Xos^Efs, Uu, Uh, Uh, Xuc, Xu, Xu
Xos, Xos, Xos, Xos, Xos, Xos, Wwb, Xos, Xos, Yhr, Yhr, Xos, Xos, Xos, Yhl, Xos, Xos, Xot, Yhr, Wwb, Wwb, Xos, Xot, Xos, Xos, Xos, Xos, Xos, Xos, Xu, Xu, Xu, Xu, Xu, Uh, Xot, Xos, Xos, Uu^Tf, Xos, Xos, Xos, Xos, Xos, Xos, Xos, Xos, Urb^Pr/, Urb, Urb^Ebur, Urb, Xos^Efs, Xos^Efs, Xos, Xos, Xos, Xos, Xos, Xos, Xos, Xos^Efs, Urb, Urb, Rr, Urb, Urb, Wwf, Wwf^Es, Wwg, Xu, Xu, Xu
Xos, Xos, Xos, Xos, Xos, Xos, Xos, Wwb, Wwb^Pr/, Xos, Xos, Yhr, Yhr^Pr/, Xos, Yhr, Yhr, Yhr, Yhr, Yhr, Yhr^Xp, Yhr^Xp, Wwb, Wwb, Xos, Xos, Xos, Wwb, Xos, Xos, Xos, Xos, Xu, Xos, Uh, Yhr^Xp, Yhr^Xp, Yhr, Uu^Tf, Uh, Xos, Xu, Xu, Uu, Uu, Uu^Vud, Urb, Urb, Urb, Rr, Rr, Rr, Urb, Urb, Xos, Xos^Efs, Xos, Xos, Xos, Xos, Xos^Efs, Urb, Urb, Rr, Rr, Urb, Urb, Wwf, Wwg, Uu^Tf, Xu, Xu, Xu
Xos, Xos, Xos, Xos, Xos, Xos, Xos, Xos, Xos, Wwb, Wwb, Xot, Yhr, Yhr, Yhr, Yhr, Xos, Yhr, Yhr^Xp, Yhr, Yhr, Yhr, Yhr, Wwb, Wwb, Wwb^Pr\, Xos, Wwb, Wwb, Xos, Xos, Xos, Xos, Xos, Xos, Yhr, Yhr, Yhr^Xp, Yhr, Xu, Xu, Xu, Cud, Uh, Uu, Urb, Rr, Rr, Urb, Urb, Urb, Rr, Cud, Cud, Urb, Xos^Efs, Xos^Efs, Xos^Efs, Urb, Urb, Rr, Rr, Urb, Urb, Xos, Xos, Xos, Uu^Vu, Xu, Xu, Xu, Xu
Xos, Xos, Xos, Xos, Xos, Xos, Xos, Xos, Xos, Wwb, Wwb, Uh, Yhr, Yhr, Xos, Xos, Xos, Xos, Yhr, Yhr, Xos, Yhr, Yhr, Yhr^Xp, Yhr, Wwb, Xot, Xos, Xos, Wwb, Wwb, Xos, Xos, Xos, Xos, Xos, Yhr^Xp, Yhr, Yhr, Xu, Xu, Yhr^Xp, Uu, Uh, Urb, Uu, Cud, Urb, Uu, Urb, Xos, Cud, Urb, Rr, Urb, Xos, Urb, Urb, Rr, Rr, Urb, Urb, Xos, Xos, Xos, Xos, Xos, Xos, Xos, Xu, Xu, Xu
Xos, Xos, Xos, Xos, Xos, Xos, Xos, Xos, Xos, Wwb, Xos, Yhr, Yhr, Xos, Xos, Xos, Xos, Xos, Yhr, Xos, Xos, Xos, Yhr^Xp, Yhr, Yhr, Yhr, Yhr, Xos, Yhr^Xp, Xos, Xos, Wwb, Wwb^Pr/, Xos, Xos, Xos, Yhr, Yhr, Xos, Xu, Xu, Yhr^Xp, Urb, Uu^Vud, Urb, Cud, 2 Kud, Cud, Uh, Uu^Vud, Xos, Xos, Urb, Rr, Rr, Urb, Rr, Rr, Urb, Urb, Xos, Xos, Xos, Xos, Xos, Xos, Xos, Xos, Xos, Xos, Xos, Xu
Xos, Xos, Xos, Xos, Xos, Xos, Xos, Xos, Xos, Wwb, Xos, Yhr, Uh, Xos, Xos, Xos, Yhr, Yhr^Pr\, Xos, Xos, Xos, Xos, Yhr, Yhr, Xos, Yhr, Yhr, Yhr, Yhr, Yhr^Xp, Yhr^Xp, Xot, Xos, Wwb, Yhr, Yhr, Xos, Xos, Xos, Xu, Xu, Cud, Urb, Urb, Rr, Cud, Cud, Cud, Uh, Uu, Xos, Xos, Xos, Urb, Urb, Rr, Urb, Urb, Xos, Xos, Xos, Xos, Xos, Xos, Urb, Urb, Urb, Urb, Urb, Xos, Xos, Xos
Xos, Xos, Xos, Xos, Xos, Xos, Xos, Xos, Xos, Wwb^Pr\, Xos, Yhr, Yhr, Xos, Xot^Xzm\, Xos, Xos, Xos, Xos, Xos, Yhr, Yhr^Pr\, Xos, Xos, Xos, Xos, Yhr^Xp, Yhr, Yhr, Yhr, Yhr, Yhr^Xp, Yhr, Yhr, Xos, Wwb, Wwb^Pr/, Xos, Xos, Xos, Xos^Efs, Uu, Rr, Rr, Cud, Uh, Urb, Rr, Urb, Urb, Xos^Efs, Xos, Xos, Xos, Xos, Urb, Xos, Xos, Xos, Xos, Xos, Xos, Urb, Urb, Urb, Urb, Urb, Urb, Urb, Urb, Urb, Xos
Xos, Xos, Xos, Xos, Xos, Xos, Xos, Xos, Wwb, Wwb, Xos, Yhr^Xp, Yhr, Yhr, Yhr, Xos, Tb^Tf, Xos^Xzm\, Xos^Xzm\, Xos, Xos, Xos, Xos, Xot, Yhl, Yhr, Yhr^Xp, Yhr, Xos, Yhr, Yhr, Yhr, Tb^Tf, Uh, Xos, Xos, Xos, Wwb, Xos, Xos^Efs, Urb^Pr\, Urb, Rr, Urb, Uh, Urb, Urb, Rr, Rr, Urb, Urb^Pr/, Xos^Efs, Xos, Xos, Xos, Xos, Xos, Xos, Xos, Xos, Urb, Urb, Urb, Urb, Urb, Urb, Urb, Urb, Urb, Urb, Urb, Urb
Xos, Xos, Xos, Xos, Xos, Xos, Wwb, Wwb, Xos, Xos, Xu, Yhr^Xp, Uh, Yhr^Xp, Uu^Ii, Yhr, Yhr^Xp, Uh, Xu, Xos, Xos, Xos, Yhl, Yhl^Pr\, Yhl^Pr\, Yhl, Xos, Xos, Xos, Xos, Xos, Uu^Tf, Uh, Uh, Xos, Xos, Xos, Xos, Urb, Urb, Rr, Rr^Pr\, Urb^Pr\, Uh, Uu, Uu^Vud, Xos, Urb, Urb^Pr/, Rr^Pr/, Rr, Urb, Urb, Xos, Xos, Xos, Xos, Xos, Urb, Urb, Urb, Urb, Urb, Urb, Xos, Xos, Xos, Xos, Xos, Urb, Urb, Urb
Xos, Xos, Xos, Xos, Xos, Xos, Xos, Xos, Xu, Xu, Xu, Tb^Tf, Uh, Uu^Em, Uu^Em, Uu^Emf, Uh, Uh, Xu, Xu, Yhl, Yhl, Yhl, Yhl, Xos, Xos, Xos, Xos, Xos, Xos, Xos, Xos, Xos, Xos, Xos, Xos, Urb, Urb, Rr, Rr, Urb, Urb, Xos, Xos, Xos, Xos, Xos, Xos, Xos, Urb, Urb, Rr, Rr, Urb, Urb, Xos, Urb, Urb, Urb, Urb, Urb, Urb, Xos, Xos, Xos, Xos, Xos, Xos, Xos, Xos, Xos, Urb
Xos, Xos, Xos, Xos, Xos, Xos, Xos, Xos, Xos, Xu, Xu, Xu, Xu, Uh, Uh, Tb^Tf, Xos, Xu, Xu, Xu, Yhl, Yhl, Xos, Xos, Xos, Xos, Xos, Xos, Urb, Urb, Urb, Xos, Xos, Xos, Urb, Urb, Urb, Urb, Urb, Urb, Xos, Xos, Xos, Xos, Xos, Xos, Xos, Xos, Xos, Xos, Xos, Urb, Urb, Urb, Urb, Urb, Urb, Urb, Urb, Urb, Xos, Xos, Xos, Xos, Xos, Xos, Xos, Xos, Xos, Xos, Xos, Xos
Xos, Xos, Xos, Xos, Xos, Xos, Xos, Xos, Xos, Xos, Xos, Xu, Xu, Xu, Xu, Xos, Xos, Xos, Xu, Xu, Xos, Xos, Xos, Xos, Xos, Xos, Xos, Urb, Urb, Urb, Urb, Urb, Urb, Urb, Urb, Urb, Urb, Urb, Xos, Xos, Xos, Xos, Xos, Xos, Xos, Xos, Xos, Xos, Xos, Xos, Xos, Xos, Xos, Urb, Urb, Urb, Urb, Urb, Xos, Xos, Xos, Xos, Xos, Xos, Xos, Xos, Xos, Xos, Xos, Xos, Xos, Xos
Xos, Xos, Xos, Xos, Xos, Xos, Xos, Xos, Xos, Xos, Xos, Xos, Xos, Xu, Xos, Xos, Xos, Xos, Xos, Xu, Xos, Xos, Xos, Xos, Xos, Xos, Xos, Xos, Xos, Urb, Urb, Urb, Urb, Urb, Urb, Urb, Xos, Xos, Xos, Xos, Xos, Xos, Xos, Xos, Xos, Xos, Xos, Xos, Xos, Xos, Xos, Xos, Xos, Xos, Urb, Urb, Urb, Xos, Xos, Xos, Xos, Xos, Xos, Xos, Xos, Xos, Xos, Xos, Xos, Xos, Xos, Xos
Xos, Xos, Xos, Xos, Xos, Xos, Xos, Xos, Xos, Xos, Xos, Xos, Xos, Xos, Xos, Xos, Xos, Xos, Xos, Xos, Xos, Xos, Xos, Xos, Xos, Xos, Xos, Xos, Xos, Xos, Xos, Urb, Urb, Urb, Urb, Urb, Urb, Xos, Xos, Xos, Xos, Xos, Xos, Xos, Xos, Xos, Xos, Xos, Xos, Xos, Xos, Xos, Xos, Xos, Urb, Urb, Urb, Xos, Xos, Xos, Xos, Xos, Xos, Xos, Xos, Xos, Xos, Xos, Xos, Xos, Xos, Xos
Xos, Xos, Xos, Xos, Xos, Xos, Xos, Xos, Xos, Xos, Xos, Xos, Xos, Xos, Xos, Xos, Xos, Xos, Xos, Xos, Xos, Xos, Xos, Xos, Xos, Xos, Xos, Xos, Xos, Xos, Xos, Xos, Xos, Urb, Urb, Urb, Urb, Urb, Urb, Xos, Xos, Xos, Xos, Xos, Xos, Xos, Xos, Xos, Xos, Xos, Xos, Xos, Xos, Xos, Urb, Urb, Urb, Xos, Xos, Xos, Xos, Xos, Xos, Xos, Xos, Xos, Xos, Xos, Xos, Xos, Xos, Xos
