Wwg, Gg, Gg, Gg, Gs, Gs, Yhs, Yhs, Yhs, Yhs, Qxe, Qxe, Ds^Es, Ds, Ds, Gs, Gs, Ds, Gs, Ds, Ds, Qxe, Ds, Ds, Ds, Ds, Hhd, Hhd, Gs, Gd, Gs, Qxe, Qxe, Ds, Gs, Gd, Gs, Ds, Ds^Esd, Gg, Gd, Hhd, Hhd, Hhd, Hhd, Hhd, Mm, Mm, Mm, Mm, Mm^Xm, Mm^Xm, Mm, Mm, Mm, Mm, Mm, Mm, Mm^Xm, Mm^Xm, Mm^Xm, Mm, Mm, Mm^Xm, Mm^Xm, Mm^Xm, Mm^Xm
Wwrg, Wwg, Ww^Ewl, Gg, Gg, Chr, Gs, Gg, Gs^Esd, Yhs, Qxe, Ds^Es, Ds^Esd, Gs^Esd, Gs, Gs, Hhd, Hhd, Ds, Ds^Es, Chr, Gs, Gs, Gs^Esd, Gd, Gd, Gd^Es, Gd, Gs, Gd, Gd, Ds^Esd, Qxe, Gs, Ds^Es, Gd, Gd, Ds^Esd, Gs, Gd, Gg, Hhd, Hhd, Hhd, Hhd, Hhd, Mm, Mm, Hh, Mm^Xm, Mm^Xm, Mm^Xm, Hh, Hh, Hh, Hh, Mm, Mm^Xm, Mm^Xm, Mm^Xm, Mm, Mm, Hh, Mm, Mm^Xm, Mm^Xm, Mm
Wwg, Wwrg, Wwg, Ds, Ds^Es, Ds, Ds^Esd, Gs, Gs^Esd, Ds, Ds, Ds, Ds^Esd, Gs, Yhs, Yhs, Ds^Es, Hhd, Ds^Es, Ds, Yhs^Esd, Yhs, Ds, Gd, Ds, Gd^Esd, Gs, Gs, Yhs, Chr, Gd, Gs, Gs, Gs, Gs, Gs, Gd, Gs, Gs, Gs, Hhd, Hhd, Hhd, Hhd, Mm, Mm, Hh, Hh, Hh, Mm, Mm, Mm, Hh, Hh^Fp, Hh^Fp, Hh, Mm, Mm, Mm^Xm, Mm, Hh, Hh, Hh, Mm, Mm^Xm, Mm^Xm, Mm
Wog, Wwg, Wog, Wwg, Wwg, Ds, Ds^Es, Gs, Gs, Ds^Esd, Gs, Gs^Es, Gs, Yhs^Esd, Yhs^Xp, Yhs^Xp, Ds^Esd, Gs, Ds, Ds, Yhs^Xp, Yhs^Xp, Ds, Ds^Es, Ds, Ds, Ds, Qxe, Yhs^Xp, Yhs, Gs, Gd, Hhd, Ds^Es, Gs, Gs, Gs, Gs^Fdw, Gs, Gs, Hhd, Hhd, Mm, Mm, Hh, Hh, Hh, Hh^Fp, Hh, Hh, Mm, Hh, Hh^Fp, Hh, Hh, Hh, Mm, Mm, Hh, Hh, Hh, Hh, Hh, Mm, Mm, Mm, Hh
Wwg, Wog, Wog, Wog, Wog, Wwg, Wwrg, Ds, Gg, Gs, Gs, Gd, Gd, Yhs, Yhs, Qxe, Gs, Gd, Ds^Esd, Gs, Gd, Qxe, Ds, Ds, Ds, Ds^Es, Yhs^Esd, Yhs^Xp, Yhs^Esd, Ds, Gs, Hhd, Ds^Esd, Ds^Esd, Qxe, Qxe, Gs, Gd, Gg, Gs, Hh, Mm, Hh, Hh, Hh, Hh^Fp, Hh^Fmw, Hh, Mm, Mm, Hh, Hh, Hh^Fmw, Hh^Fmw, Mm, Mm, Hh, Hh^Fp, Hh, Hh, Gg, Hh, Hh, Hh, Mm, Mm, Hh
Wwg, Wwg, Wwg, Wog, Wog, Wwg, Wwg, Wwrg, Wwg^Ewl, Gg, Gs, Gs^Es, Gd, Chr, Gs^Es, Gs, Gd, Ds, Ds^Es, Gs, Gd, Ds^Esd, Gs, Chr, Ds, Ds^Esd, Yhs^Xp, Yhs^Xp, Gs^Esd, Ds^Es, Gs, Gs^Esd, Gs, Ds^Es, Qxe, Qxe, Gs, Gd^Fdw, Gg, Gs, Hh, Hh, Gs, Gs, Hh, Gll^Fmw, Gll^Fp, Gll^Fp, Hh, Hh, Gll^Fmw, Gll^Fmw, Hh^Fp, Mm, Hh, Hh, Gll^Fp, Hh^Fp, Hh, Gg, Gs, Gg, Hh, Hh, Mm, Hh, Hh
Ds, Wwg, Wwrg, Wwg, Wwg, Wog, Wwg, Wwg, Wwrg, Ds^Esd, Gs^Esd, Gs, Ds^Esd, Gd, Gs^Es, Gd, Gd, Ds^Es, Ds, Hhd, Hhd, Gd, Qxe, Yhs, Yhs^Esd, Gs, Gg, Gs, Gs, Gs, Qxe, Gs, Ds^Es, Gs, Gs, Gs, Gd^Fdw, Gd, Gs, Hh, Gg, Gs, Gs, Gs, Gs, Gll^Fp, Gs, Gll^Fp, Gs, Gll^Fp, Gg, Gll^Fmw, Hh^Fp, Gg, Gg, Gg, Gs, Gll^Fp, Gs, Gg, Gs, Gs, Gg, Hh, Hh, Hh, Gll^Fp
Rd^Esd, Ds^Es, Ds, Wwrg, Wwg, Wog, Wog, Wwg, Wwg, Ds, Ds^Esd, Gs, Gg, Gs, Ds^Esd, Gs, Yhs^Xp, Yhs, Ds^Esd, Hhd, Gs, Ds^Esd, Yhs^Xp, Yhs^Xp, Ds^Esd, Gs^Esd, Gd, Gd, Gs, Qxe, Ds^Esd, Ds^Esd, Gs, Gs, Gs, Gg, Gs, Gd^Fdw, Gs, Gg, Gg, Gs, Gll^Fmw, Gll^Fp, Gll^Fp, Gll, Gs, Gg, Gs, Gg, Gll^Fp, Gll^Fp, Gs, Gs, Gs, Gs, Gs, Gll, Gll^Fmw, Gll^Fp, Gg, Gs, Gg, Hh, Hh, Hh^Fp, Gll^Fp
Ds, Rd^Esd, Ds^Esd, Ds, Wwg, Wog, Wog, Wog, Wwg, Wwrg, Ds, Gs, Gs, Gd, Gs, Gs, Yhs, Yhs^Esd, Ds, Gs, Gs, Ds^Esd, Yhs, Yhs, Ds^Es, Gs, Gd, Gs, Qxe, Qxe, Ds^Es, Gs^Esd, Gs, Gd, Gs^Fdw, Gs, Gs, Gg, Gs, Gs, Gll^Fp, Gll^Fp, Gll^Fp, Gll^Fp, Gll^Fmw, Gs, Gs, Gll^Fp, Gll^Fp, Gs, Gs, Gs, Gs, Gll^Fp, Gs, Gll^Fp, Gll^Fmw, Gll, Gll^Fp, Gg, Gs, Gg^Efm, Gg^Efm, Gg, Gg, Gll^Fp, Gd^Fmw
Yhs, Rd, Ds, Ds^Es, Wwrg, Wwg, Wog, Wog, Wwg, Wwg, Ds, Ds, Gs, Gd^Fdw, Gd^Fdw, Ds^Esd, Gs^Esd, Ds^Es, Ds^Es, Ds^Esd, Qxe, Ds, Ds^Es, Ds, Gs, Gs, Ds^Esd, Qxe, Gs, Ds^Esd, Gd, Gd, Gd^Fdw, Gd, Gs^Fdw, Gs, Gg, Gg, Ch, Gg, Ch, Gll^Fp, Gll^Fp, Gg, Gll^Fp, Gll^Fp, Gg, Gs, Gll^Fmw, Gs, Gll^Fp, Gll^Fp, Gg, Gs, Gg, Gll, Gll^Fp, Gll, Gs, Gll^Fmw, Gs, Gs, Gg, Gll^Fp, Gll^Fp, Gd^Fmw, Gll^Fmw
Yhs, Yhs^Xp, Yhs, Ds, Ds, Wwrg, Wwg, Wog, Wog, Wwg, Ds, Ds^Esd, Gs, Gs^Fdw, Gd^Fdw, Gs, Gs, Gs, Chr, Ds, Yhs, Yhs^Xp, Ds, Ds^Esd, Gs, Ds^Esd, Gs, Gs, Gs, Gs, Gd^Fdw, Gd, Gs, Gd, Gg, Gs, Ch, Ch, Gs, Ch, Gg, Ch, Ch, Ch, Ch, Gll^Fp, Ch, Gg, Gll^Fp, Gll^Fp, Gll^Fp, Gll^Fp, Ch, Ch, Ch, Gs, Gs, Gll^Fp, Gs, Gg, Ch, Gg, Gs, Gs, Gll^Fmw, Gll^Fp, Gll^Fmw
Re^Fdw, Yhs, Yhs^Xp, Gd^Fmw, Gs^Fdw, Wwrg, Wwg, Wog, Wog, Wwg, Wwg, Gs, Gg, Gs, Gs, Gs, Gs, Gg, Gs, Ds, Yhs^Xp, Yhs^Esd, Gs, Ch, Rr, Ds^Esd, Gg, Gs, Gg^Es, Gs^Fdw, Gs^Fdw, Gs, Gs, Gs, Gs, Ch, Gs^Fds, Gll^Fp, Gg, Gs, Rr, Rr, Ch, 8 Kh, Ch, Ch, Gll^Fp, Ch, Ch, Ch, Ch, Ch, Yhs, Yhs, Gll^Fp, Ch, Ch, Gs, Ch, Ch, Gg, Ch, Ch, Gll^Fp, Gs, Gd^Fmw, Gll^Fp
Re^Fdw, Re^Fdw, Re^Fdw, Gd^Fmw, Gd, Gll^Fp, Wwg, Wwg, Wog, Wwg, Wwg, Gg, Gs, Gg, Ds, Gs, Gs, Gd^Fdw, Gs, Gs, Gd, Gs, Gs, Gs, Gs, Ch, Rr, Gs, Gs, Gs, Gs^Fdw, Gs^Fdw, Gs, Gg, Gs, Ch, Gs^Fms, Gs^Fds, Gs^Vh, Rr, Rp, Gg, Gg, Ch, Rr, Rp, Gll^Fp, Gll^Fp, Ch, Yhs, Ch, Yhs, Yhs, Gll^Fp, Gll^Fp, Ch, Yhs, Ch, Gg, Gg, Gll^Fmw, Gg, Gg, Ch, Gs, Gd^Fmw, Gg
Yhs, Re^Fdw, Re^Fdw, Re, Re, Gd, Gg, Wwg, Wwg, Wog, Wwg, Ds, Ds^Esd, Gg, Ds^Esd, Gg, Gs, Gd, Gs, Gs, Gd^Fdw, Gd, Gd^Fdw, Gs, Gs, Gs, Gs, Ch, Rr, Gs, Gs, Gs, Gg, Gs, Ch, Ch, Gg, Gg, Rr, Rr, Ch, Gg, Wwg, Wwg^Ewl, Rp, Rr, Rr, Rr, Ch, Ch, Gs^Fds, Yhs, Gll^Fp, Gs^Fds, Gg^Fet, Ch, Ch, Ch, Gll^Fp, Gll^Fmw, Gg, Gg, Gg, Ch, Gg, Gll^Fp, Gg
Yhs, Yhs^Xp, Yhs, Re, Gd, Gd, Gg, Wwrg, Wwg, Wog, Wog, Wwg, Ds^Es, Ds, Ds, Gg, Gg^Esd, Gs, Ds, Gs, Gs, Gs, Gs, Gd, Gs^Es, Gs^Es, Gs^Es, Gs, Gs, Ch, Rr, Gs, Ch, Ch, Gg, Gg, Rr, Rr, Gll^Fp, Gg^Efm, Gg, Wwg, Wwg^Ewl, Gg, Rp, Rr, Rr, Ch, Gs^Fms, Gs^Fds, Gg^Fet, Gs^Fms, Gg^Fet, Gs^Fds, Gs^Fms, Gll^Fp, Gll^Fp, Rr, Gg, Gg, Gll^Fp, Gll^Fmw, Gg, Ch, Ch, Gs, Gs
Yhs, Yhs^Xp, Yhs, Yhs^Xp, Gd, Gg, Gg, Wwg^Ewl, Wwrg, Wwg, Wog, Wwg, Wwg, Ds, Ds, Ds^Esd, Ds^Es, Ds, Ds^Esd, Gg, Gg, Gg, Gs, Gd, Gs, Gs, Gs, Gs, Gs, Gs, Ch, Ch, Gs, Gg^Fet, Gs^Vh, Rr, Rp, Gg, Gs^Fms, Gll^Fp, Wwg, Wwg, Gs, Gg^Efm, Gg^Efm, Rr, Rr, Gll^Fp, Gg^Fet, Gs^Fms, Gll^Fp, Gll^Fp, Gll^Fp, Gs^Fms, Rr^Vd, Gll^Fp, Ch, Rr, Rr^Vhc, Gg, Gg, Gg, Gll^Fp, Gg, Gg, Ch, Ch
Gs^Fdw, Gs^Fdw, Gd^Fdw, Gd, Gd^Fdw, Gs, Gs, Ww^Ewl, Wwg^Ewl, Wwrg, Wwg, Wog, Wog, Wwg, Wwg, Ds, Ds, Ds, Ds, Ds^Es, Ds^Esd, Gs, Gg, Gs, Gs^Es, Gg, Ch, Ch, Ch, Ch, Rp, Gs, Rp, Gg, Rr, Rr, Rr, Gg, Wwg, Wwg, Ch, Gs, Gg, Rr^Vd, Rr, Rr, Ch, Gll^Fp, Gll^Fp, Gll^Fp, Ch, Ch, Ch, Gll^Fp, Rr, Rp, Rr, Rr, Rr, Rp, Ch, Gg, Gll^Fmw, Gg, Gll^Fp, Gll^Fp, Gll^Fp
Gs^Em, Gs^Fdw, Gd^Fmw, Gd^Fdw, Gd^Fdw, Gs, Gs, Gg, Gg, Wwrg, Wwg, Wog, Wog, Wog, Wog, Wwg, Wwg, Wwrg, Wwrg, Ds, Ds^Esd, Gg, Gg, Gs, Gg, Gs, Ch, 7 Kh, Ch, Rr, Rr, Rr, Rr, Rr, Gg^Efm, Gg, Wwg, Wwg^Bsb\, Rr, Gg, Gg, Gs, Rr, Rr, Rr, Rr, Rr, Gll^Fp, Ch, Ch, Kh, Ch, Ch, Ch, Rr, Rr, Gll^Fp, Gll^Fp, Gll^Fp, Rr, Rr, Rp, Rr, Gg, Gg, Gll^Fp, Gll^Fp
Gd^Fmw, Gd^Fmw, Gd^Fmw, Gd^Fdw, Gd^Fmw, Gd, Gs, Gg, Gg, Gg, Wwg, Wwg, Wwg, Wog, Wwg, Wog, Wog, Wog, Wwrg, Wwg, Wwg^Ewl, Ds^Esd, Gg, Gs, Gs, Gs, Gs, Ch, Ch, Rr, Gs, Gs^Vh, Gg, Gg, Wwg^Ewl, Wwg, Ch, Gg, Gs, Rr, Rr, Rr, Gg^Efm, Rr^Vhc, Rp, Rr, Rr, Ch, Rr, Kh, 3 Kh, Kh, Rr, Rr, Rr, Rr, Rr^Vd, Gll^Fp, Ch, Yhs, Yhs^Xp, Rr, Ch, Rr, Rr, Gg^Efm, Gg
Gll^Fp, Gd^Fmw, Gll^Fp, Gd^Fmw, Gd^Fmw, Gs^Fdw, Gs, Gg, Gg, Gg, Gg, Wwg, Wwg, Wog, Wwg, Wwg, Wwg, Wwg, Wwg, Wwg, Wwg, Wwrg, Wwg^Ewl, Gs, Gg^Esd, Gs, Gs, Gs, Gs, Ch, Ch, Gs, Ds, Ds^Esd, Wwg, Wwg, Ds, Gs, Gs, Gg, Gg, Rr^Vhc, Rr, Gg, Gs, Ch, Ch, Rr, Rr, Kh, Kh, Kh, Ch, Ch, Rp, Rr, Rp, Gs^Fet, Wwf^Ewf, Yhs, Yhs, Yhs^Xp, Yhs, Rp, Gs^Vh, Rr, Rr
Gll^Fp, Gll^Fp, Gd^Fmw, Gs^Fdw, Gs^Fdw, Gs, Gd^Vhr, Gs, Re^Es, Re^Vhr, Re, Gs^Fdw, Wwg, Wog, Wwg, Ds^Es, Ds^Esd, Gs, Gll, Wwrg, Wwg, Ds, Wwg^Ewl, Ds, Ds, Gg, Gs, Gs^Es, Gs, Gs, Ds, Ch, Ch, Wwrg, Wwg, Wwg, Wwg, Ds, Wwg, Wwrg, Wwg, Wwg^Bw/, Wwg^Bw/, Rr^Vhc, Wwrg, Gll^Fp, Wwf^Ewl, Ch, Rr, Rr, Ch, Ch, Gd^Fmw, Gll^Fp, Rp, Rr, Rp, Gs^Fet, Wwf, Wwg, Chw, Yhs, Yhs^Xp, Gd^Fetd, Gll^Fmw, Gll^Fp, Re
Gll^Fp, Gll^Fp, Gll^Fp, Gs^Fdw, Gs, Gs, Re, Re^Es, Re, Re^Es, Re^Vhr, Gs^Fmw, Gs^Fmw, Wwg, Wwg, Wwg, Wwg, Gll^Fp, Gll^Fp, Gll, Gs, Wwg, Wwg, Wwg, Wwg, Gg, Gg, Gs, Gs, Ds^Esd, Ds, Ds, Wwrg, Wwrg, Wog, Wog, Wog, Wwg, Wog, Wog, Wog, Wwg, Wog, Wwg, Wwg, Wwg, Wwrg, Rr, Rr, Rr, Wwg^Ewl, Wwf^Ewl, Wwf^Ewf, Gd^Fmw, Ch, Rr, Rp, Gs^Fet, Wwg, Wwg^Ewl, Wwg, Yhs^Xp, Yhs, Gll^Fdw, Gll^Fp, Gll^Fmw, Re
Gll^Fp, Gll^Fp, Gd^Fmw, Gd^Fmw, Gs^Fdw, Gs, Gs, Re, Re^Es, Re, Gg, Gs^Fmw, Gs^Fdw, Wwrg, Wwg, Wog, Wwg, Ds, Ds, Gll^Fp, Gs^Es, Ds, Wwg, Wog, Wog, Wwg, Wwg, Ds, Ds, Ds^Esd, Wwg, Wwg, Wog, Wog, Wwg, Wog, Wwg, Wog, Wwg, Wog, Wwg, Wog, Wwg, Wog, Wog, Wwg, Wwg, Ch, Rr, Ch, Wwg, Wwg, Wwg, Wwg, Wwg^Bsb/, Rr, Ch, Gs^Fet, Wwg, Wwg^Ewf, Wwf^Ewl, Yhs, Yhs, Gd^Fetd, Gll^Fp, Re, Gd^Fmw
Gg, Gg^Em, Gg^Em, Gd^Fmw, Gd^Fmw, Gs, Gs, Gg, Gg, Re, Re, Gg, Re^Vwm, Gg, Wwg^Ewl, Wog, Wog, Wwg, Wwrg, Gll^Fp, Ds^Esd, Gs^Esd, Wwg, Wog, Wog, Wog, Wog, Wwg, Wwg, Wwg, Wwg, Wog, Wog, Wog, Wwrg, Wwrg, Wwg, Wwg, Wwg^Bw\, Wwg, Wwg^Bw/, Wwg, Wwrg, Wwg, Wog, Wwg, Wwg, Wwrg, Wwg^Bsb|, Wwg, Wwrg, Wwg, Wwg^Bsb/, Wwg^Bsb/, Wwg, Wwrg, Wwrg, Wwrg, Wwg^Ewl, Wwf, Yhs, Yhs, Yhs^Xp, Gll^Fp, Gs, Gs^Vh, Gll^Fp
Gg, Gd^Fmw, Gs^Fdw, Gd^Fmw, Gd^Fmw, Gs, Gs^Fdw, Gs, Re^Gvs, Re^Gvs, Re^Gvs, Re^Gvs, Re, Gg, Gg, Wwg, Wwg, Wog, Wwg, Wwg, Wwg, Ds, Wwg, Wwg, Wwg, Wog, Wog, Wog, Wog, Wog, Wog, Wog, Wwg, Wwg, Wwg, Wwg, Wwg^Bw\, Wwg^Bw\, Rp, Rr^Vhc, Gg, Ds, Ds, Wwrg, Wog, Wog, Wwg, Wwg, Ch, Ch, Ch, Wwg^Bsb/, Wwg, Wwg, Wog, Wwg, Wwg, Wwg, Wwg, Wwrg, Yhs, Yhs^Xp, Wwf, Wwf^Ewl, Wwf, Gs, Gll^Fp
Gd^Fmw, Gd^Fmw, Gll^Fp, Gd^Fdw, Gs^Fdw, Gs^Fdw, Gs^Fdw, Gg, Gg, Re, Re^Gvs, Re^Gvs, Gg, Re, Gg, Gg, Gg, Wwg, Wwrg, Wog, Wwg, Wwrg, Wwrg, Wwg, Wwg, Wwg, Wwg, Wog, Wwg, Wwg, Wwg, Wwg, Ds, Ch, Wwrg, Wwg, Wwrg, Rr^Vhc, Rr, Rp, Gs^Vh, Ds, Wwf, Wwrg, Wog, Wog, Wwg, Ch, Ch, Kh, Ch, Wwrg, Wwrg, Wwg, Wog, Wog, Wog, Wwg, Wwg, Wwrg, Wwg^Bw|r, Wwrg, Wwg, Wwf, Wwrg, Chw, Gll^Fp
Gll^Fp, Gll^Fp, Gd^Fdw, Gd^Fmw, Gd^Fmw, Gs^Fdw, Gll^Fp, Gg, Gs, Gg, Gg, Gg, Gg, Re, Re, Gg, Gg, Gg, Gg, Wwg^Ewl, Ds^Esd, Ds, Ds, Ds^Esd, Gg, Wwg^Ewl, Gg, Wwg, Ch, Wwrg, Gg, Ds^Esd, Gll^Fp, Ch, Ch, Wwg^Ewl, Rr^Vd, Rp, Rr, Rp, Gg, Ds, Wwf, Wwg, Wwg, Wog, Wog, Wwg, Wwrg, Ch, 9 Kh, Ch, Ch, Wwg, Wwg, Wog, Wog, Wwg, Wwg, Wwg, Wwg^Es, Wwg, Wwg, Wwg, Wwg, Wwg, Wwg
Gll^Fp, Gd^Fmw, Gll^Fp, Gll^Fp, Gll^Fp, Gll^Fp, Gll^Fp, Gs, Gll^Fp, Gs, Gg, Gg, Re^Gvs, Re^Gvs, Re^Gvs, Re^Vwm, Re, Re, Re, Gg, Gg, Ds^Es, Gg, Gg, Gg, Gg, Gg, Gg, Gg, Rp, Rp, Gg, Gll^Fp, Gll^Fp, Ch, Gs^Fms, Gs^Fms, Rp, Rp, Rr, Rr, Gs^Fds, Gs^Fms, Wwf, Wwrg, Wwg, Wwg, Wwg, Wwg, Ch, Ch, Ch, Rr^Vhc, Ch, Wwg, Wog, Wog, Wog, Wwg, Wwg, Rp, Wwg, Gs, Wwf^Ewl, Wwg^Ewl, Wwg, Wwg
Gg, Gll^Fp, Gll^Fp, Gll^Fp, Qxe, Qxe, Qxe, Gll^Fp, Gll^Fp, Gg, Gg, Re^Gvs, Re, Re^Gvs, Re^Gvs, Re, Gg, Re, Gg, Re, Re, Gg, Gg, Gg^Vwm, Re^Gvs, Re^Gvs, Re^Gvs, Gg, Gg, Rp, Rp, Gll^Fp, Gll^Fp, Gll^Fp, Ch, Gll^Fp, Gll^Fp, Gs^Vh, Gs^Fms, Rr, Rr, Rr, Rr, Gs^Fmw, Gs^Fds, Wwg^Ewl, Ch, Wwg, Wwg^Bsb/, Wwg^Bsb/, Wwg, Wwrg, Wwg, Rr^Vhc, Wwg, Wwg, Wog, Wwg, Wwg, Wwf, Rp, Gd^Vhr, Gd^Fmw, Wwf^Ewl, Wwf, Wwrg, Wwf
Qxe, Qxe, Qxe, Qxe, Gg, Gll^Fp, Gg, Gs, Gg, Gg, Gg, Gg, Gg, Re, Gg, Gg, Gg, Gs, Qxe, Gg, Gg, Re, Re, Re, Re^Gvs, Re^Gvs, Re^Gvs, Re^Gvs, Re^Vh, Gg, Gg, Rp, Gll^Fp, Gll^Fp, Ch, Gll^Fp, Gll^Fp, Gll^Fp, Gs^Fms, Gs^Fds, Gs^Fds, Rr, Rr, Rr, Rr, Rp, Rr, Rr, Ch, Wwg, Wwg^Ewl, Wwg, Wog, Wwg, Wog, Wwg, Wwg, Wwg, Wwg, Wwrg, Chw, Gd^Fmw, Gd^Fmw, Gs, Gd^Vhr, Gs, Gg
Qxe, Qxe, Gg, Gll^Fp, Gll^Fp, Gll^Fp, Gll^Fp, Gll^Fp, Gg, Gs, Gs, Gs, Gs, Gg, Gg, Gg, Gll^Fp, Qxe, Gd^Fmw, Qxe, Qxe, Gg, Gg, Re, Re, Re^Gvs, Re^Vh, Re, Re, Gg, Gg, Rp, Rp, Gll^Fp, Gg, Ch, Ch, Ch, Ch, Gs^Fms, Rr^Vhc, Gs^Fds, Rp, Rr, Rr, Rr, Rr, Rp, Gg, Wwrg, Wwrg, Wwg, Wwg, Wog, Wwg, Wwg, Chr, Wwg, Wwg^Bw/r, Wwg, Wwrg, Chw, Khw, Gd^Fmw, Gd^Fetd, Gs, Gd^Fmw
Qxe, Gs, Gll^Fp, Gll^Fp, Gll^Fp, Gll^Fp, Gll^Fp, Gll^Fp, Gd^Fmw, Gll^Fp, Gg, Gs, Gg, Gs, Gg, Gg, Gg, Gll^Fp, Gd^Fmw, Gll^Fp, Gg, Gg, Gs, Re, Gs, Re, Gs^Fms, Gs^Fms, Gs^Fds, Rp, Rp, Rp, Gg, Rp, Rp, Gg, Ch, 4 Kh, Ch, Gg, Rp, Rr, Rr, Rr, Rr, Rr, Rr, Rr, Rp, Gg, Gs^Fds, Gs^Fds, Wwg, Wwg, Wwg, Chr, Gd^Fetd, Khr, Chr, Wwg, Wwrg, Wog, Chw, Gd^Fmw, Gs^Fdw, Gd^Fmw, Gd^Fmw
Qxe, Gll^Fp, Gll^Fp, Gll^Fp, Gd^Fmw, Gd^Fmw, Gd^Fmw, Gll^Fp, Gll^Fp, Gll^Fp, Gg, Gg, Chr, Gg, Gg, Gg, Gs^Vh, Gll^Fp, Gll^Fp, Gs, Gs, Gs^Es, Re, Re, Gg, Gs^Es, Gll^Fp, Gll^Fms, Gll^Fms, Gll^Fms, Ch, Rp, Gs^Fds, Gg, Rp, Gg, Gg, Ch, Gg, Ch, Rr, Rr, Rp, Rr, Rr^Vhc, Gs^Fds, Gs^Fds, Rr, Rp, Gg, Gs^Fms, Gll^Fp, Gg, Wwrg, Wwg, Wwg, Wwrg, Chr, Gd^Fetd, Wwg, Wwg, Wwrg, Wog, Khw, Chw, Gs, Gs
Gs, Gs, Gg^Em, Gll^Fp, Gd^Fmw, Gd^Fmw, Gll^Fp, Gll^Fp, Gll^Fmw, Gs, Gs, Gs, Gs, Rp, Rp, Gg, Gg, Gll^Fp, Gg, Gs, Gs, Gs^Es, Gg, Gg, Rp, Gs, Rp, Rp, Rp, Rp, Gll^Fp, Gs^Fms, Gs^Fms, Gs, Gg, Rp, Rp, Gg, Rp, Rp, Rr, Rp, Gg, Gg, Gg, Gs^Fms, Gg, Rr, Rr, Gs^Fms, Gll^Fp, Gll^Fp, Gs, Wwrg, Wwg^Ewf, Wwg, Wwg, Wwrg, Wwg, Wwg, Wwg^Ewf, Wog, Wog, Wog, Wog, Wwrg, Wwg
Gg, Gll^Fp, Gs^Em, Gll^Fp, Gd^Fmw, Gll^Fp, Gll^Fp, Gll^Fp, Gll^Fp, Gg, Gs, Gg, Gs^Vh, Gs, Rp, Gg, Gg, Gg, Gg, Gg, Rp, Rp, Rp, Rp, Gg, Rp, Gs^Vhr, Rp, Gs, Rp, Rp, Gll^Fp, Gs, Gs, Gg, Gg, Gg^Fet, Rp, Rr, Rr, Rp, Ch, Ch, Ch, Ch, Gs, Gs, Rr, Rr, Gg, Gs, Gs, Gg, Wwf^Ewl, Ss, Ss, Ss, Wwg, Wwg^Ewf, Wwg, Wwg^Ewl, Wwg, Wwg, Wwg, Wwg, Wog, Wog
Gll^Fp, Gll^Fp, Gll^Fp, Gll^Fp, Gll^Fp, Gll^Fmw, Gg, Gg, Gll^Fp, Gll^Fp, Gg, Gg, Gs, Gs, Gs, Rp, Gs, Gg, Rp, Rp, Gg, Rp, Gg, Gg, Qxe, Gs, Gs, Gg, Gg, Gs, Gg, Rp, Rp, Ch, Rp, Gg, Rp, Rr, Rp, Rr, Gg, Gll^Fp, Ch, 5 Kh, Ch, Gs, Gs^Vh, Rp, Rr, Rp, Gs, Gs, Ss, Gg, Ss, Ss, Ss, Wwf^Ewl, Wwf, Wwf^Ewl, Gs, Gll^Fp, Gll^Fp, Wwrg, Gd^Fmw, Wwg, Wwg
Gll^Fp, Gd^Fmw, Gs, Gll^Fp, Gll^Fmw, Gs^Fdw, Gg, Gg, Gll^Fmw, Gs, Gg, Gg, Gs, Gs, Gg, Rp, Rp, Rp, Gg, Gg, Gg, Gg, Gg, Gg, Qxe, Gs, Gg, Gg, Gll^Fp, Gs, Gg, Gg, Gll^Fp, Rp, Gg, Rp, Rp, Rp, Gg, Gg, Gll^Fp, Gll^Fp, Gll^Fp, Ch, Gll^Fp, Gll^Fp, Gs, Gg, Rp, Rr, Gg, Gg, Chs, Ss, Ss, Ss, Ss, Chr, Chr, Gs, Gs, Gll^Fp, Gll^Fp, Gd^Fmw, Gs^Fdw, Gd^Fmw, Gll^Fp
Gs, Gs, Gd^Fmw, Gll^Fp, Gg, Gg, Gg, Gs, Gs, Gg, Gg, Re^Es, Re, Gg, Rr^Vd, Rp, Gg, Rp, Rp, Gg, Gg, Gg, Gg, Qxe, Gg, Gg, Gg, Gll^Fp, Gs, Gg, Gs, Gg, Gll^Fp, Gll^Fp, Gg, Gg, Rp, Rp, Gg, Gll^Fp, Gg, Gd^Fdw, Gd^Fmw, Ch, Gll^Fp, Gll^Fdw, Gll^Fp, Gg, Rp, Rr, Rr, Chr, Ss, Ss, Ss, Ss, Ss, Ss, Chs, Gg, Gs, Gs, Gll^Fp, Gd^Fmw, Gs^Fdw, Gd^Fmw, Gll^Fp
Gs, Gg, Gg, Gg, Gg, Gg, Gll^Fp, Gs, Gg, Wwrg, Rb^Dr, Re^Es, Gs, Gs, Rr, Rp, Gg, Gg, Gg, Chr, Gd^Fmw, Gs^Vh, Gg, Qxe, Gg, Gll^Fp, Gll^Fp, Gll^Fp, Gll^Fp, Gll^Fp, Gg, Gs, Gll^Fp, Gs, Ch, Gg, Rp, Gs^Vh, Gg, Gs, Gg, Gll^Fp, Gd^Fdw, Ch, Ch, Gd^Fmw, Gll^Fp, Gg, Rr^Vd, Rp, Rr, Khr, Rp, Ss, Chs, Khs, Ss, Ss, Ss, Gg, Ss, Gg, Gg, Gd^Fmw, Gll^Fp, Gll^Fp, Gg
Gg, Gg, Gg, Gg, Gg, Gg, Gg, Gs, Gg, Wwg, Rb^Es, Re, Gg^Fet, Ce, Ce, Gg, Gg, Gg, Gg, Gg, Gll^Fp, Gll^Fp, Gd^Fmw, Qxe, Gg, Gll^Fp, Gll^Fp, Gll^Fp, Gll^Fp, Gll^Fp, Gs, Gs, Gll^Fp, Gg, Gs, Rp, Rp, Gs, Gs, Gs, Gll^Fp, Gd^Fmw, Gll^Fp, Gll^Fp, Qxe, Ch, Ch, Gs, Gs, Gg, Gg, Chr, Rp, Rp, Rr, Chs, Ss, Ss, Ss, Ss, Ss, Ss, Gs, Gll^Fp, Gs, Gs, Gg
Gg, Gg, Gg, Gg, Gg, Gg, Ce, Gs, Gg, Ww^Ewl, Wwg, Re, Rr, Rr, Ce, Gs, Gs, Gs, Gg, Gs^Vh, Gll^Fp, Gll^Fp, Gd^Fmw, Qxe, Qxe, Gs, Gg, Gll^Fp, Gd, Gd, Gs, Gll^Fp, Gs, Gg, Rp, Rp, Gs, Gs, Gs, Gll^Fp, Gd^Fmw, Gd^Fmw, Gg, Gg, Qxe, Qxe, Qxe, Ch, Gs, Gs, Gll^Fp, Gg, Gg^Efm, Rp, Rp, Chr, Ss, Ss, Ss, Ss, Ss, Chs, Gs, Gll^Fp, Gg, Gg, Ch
Gg, Gg, Gg, Gg, Gg, Gs, Ce, Ce, Rr, Gg, Ch, Ch, Ch, Rr, Re^Dr, Re, Gs, Gg, Gg, Gd^Fmw, Gll^Fp, Gll^Fp, Gd^Fmw, Gs, Gs, Qxe, Gll^Fp, Gll^Fp, Gg, Gs, Gg, Gg, Rp, Rp, Gg, Rp, Gs, Gs, Gd, Gd, Gll^Fp, Gs, Gg, Qxe, Qxe, Qxe, Gll^Fp, Ch, Gs, Gs, Gll^Fp, Gll^Fp, Gg, Gg^Vhr, Rr, Rp, Ss, Ss, Ss, Ss, Chs, Chs, Gg, Gs, Ch, Ch, Gs^Fdw
Gg, Ch, Gg, Gg, Re, Gs, Gs, Rr, Ch, Ch, 2 Kh, Ch, Gg^Fet, Ch, Chr, Re, Re, Gs, Gs, Gg, Gg, Gg, Gg, Gs, Gs, Qxe, Gg, Gll^Fp, Gg, Gs, Rp, Rp, Gg, Gg, Gg, Rp, Gs, Gs, Gg, Gg, Gs, Gs, Qxe, Qxe, Qxe, Gll^Fp, Gll^Fdw, Ch, Gg, Gs, Gll^Fp, Gll^Fp, Gll^Fp, Gg^Efm, Rp, Gs^Vhr, Gg, Ss, Ss, Ss, Ss, Gg, Gs, Gs, Ch, Gs^Fdw, Gs^Fdw
Gg, Rp, Gg, Gg, Re^Dr, Re^Es, Rp^Vhcr, Gg^Fet, Ch, Ch, Gg^Fet, Wwrg, Wwrg, 1 Khr, Qxe, Ch, Chr, Gd^Fetd, Re^Vhr, Gs, Gg, Gg, Gg, Gg, Gg, Qxe, Gs, Gg, Rp, Rp, Gg, Gs, Gs^Fdw, Gs^Fdw, Gs, Ch, Gs, Gs, Gg, Gg, Gs^Fdw, Gs, Qxe, Qxe, Gg, Gll^Fmw, Gll^Fdw, Ch, Ch, Gll^Fp, Gll^Fp, Gll^Fp, Gs, Gg, Gg, Rp, Gs, Gg, Gs, Ss, Ss, Gg, Gg, Gs, Ch, Gs^Fdw, Gs^Fdw
Rp, Rp, Rp, Gs, Rp, Rp, Rp, Rp, Wwg, Ch, Ch, Wwg^Ewl, Gg^Fet, Chr, Qxe, Qxe, Chr, Re, Re^Dr, Gs, Rp, Ch, Gg, Gs, Gg, Gs, Gg, Gg, Rp, Rp, Gs, Gs, Gs^Fdw, Gg, Gs, Gg, Gs, Gs^Fdw, Gs^Fdw, Gs^Fdw, Gs^Fdw, Gs, Qxe, Qxe, Gg, Gg, Gll^Fmw, Gs^Fdw, Gll^Fdw, Ch, Ch, Gll^Fp, Ch, Ch, Ch, Gg, Gs, Gg, Gg, Ss, Ss, Gs, Ch, Ch, Gg, Gs^Fdw, Gs^Fdw
Gg, Gg, Gg^Vhr, Rp, Gs, Gs, Wwf, Wwf^Es, Wwrg, Gs, Rp, Ch, Chr, Chr, Chr, Qxe, Re^Dr, Re, Rp, Rp, Gs, Rr, Rp, Gs, Rp, Rp, Rp, Rp, Gg, Gs, Gs, Gs^Fdw, Gs, Gd, Gs, Gs, Gg, Gg, Gd^Fdw, Gd^Fdw, Gs^Fdw, Gg, Gs, Qxe, Qxe, Gg, Gg, Gs, Gll^Fdw, Gll^Fdw, Gs^Fdw, Ch, Ch, 6 Kh, Ch, Ch, Ch, Ch, Ch, Ss, Ch, Ch, Gs^Fdw, Gs^Fdw, Gg, Gs^Fdw, Gg
Gg, Gg, Gs, Gs, Wwg, Wwrg, Wwg, Wwg, Gg, Gg^Fet, Rp, Gg, Gg, Re, Re^Fdw, Chr, Re^Fdw, Re, Gd^Vhr, Gs, Gs, Gs, Gs, Rp, Gs, Rp, Gg, Gg, Gd, Gs, Gg, Gs, Gs, Gd, Gs, Gs, Gd, Gd, Gd, Gd^Fdw, Gg, Gs^Fdw, Gs, Gs, Qxe, Gg, Gg, Gs, Gs, Gll^Fdw, Gs^Fdw, Gs^Fdw, Rp, Ch, Wwf, Wwf, Wwf^Es, Wwf, Wwf, Ch, Gs^Fdw, Gd^Fmw, Gs^Fdw, Gd, Gd, Gd, Gg
Wwg, Wwf, Wwg, Wwg, Wwf^Es, Wwg, Gs^Vhr, Gg, Gg, Ce, Ce, Rp, Rr^Vd, Re, Re^Fdw, Re^Fdw, Re^Fdw, Re^Fdw, Yhs, Gs, Uue, Gg, Gg, Gg, Gg, Gg, Gg, Gs, Gs, Gg, Gs^Fdw, Gg, Gs, Gd, Gs^Es, Gs, Gs, Gg, Gd, Gg, Gs^Fdw, Gs^Fdw, Gs^Fdw, Gs, Qxe, Gs, Gs, Gs, Gd, Gll^Fdw, Gs, Gs, Rp, Gll^Fdw, Yhs^Xp, Wwf, Wwf, Wwf, Wwf, Wwf, Gs^Fdw, Gd^Fmw, Gd, Gd, Gd, Gd, Gg
Wwg, Wwg, Gg, Wwf^Es, Gg, Gg, Gs, Gg, Rp, Rp, Gg, Gg, Gs^Fdw, Gs^Fdw, Re^Fdw, Re^Fdw, Yhs^Xp, Yhs^Xp, Yhs, Uue, Uue, Qxe, Gd^Fdw, Gs, Gs, Gg, Gll^Fp, Gs, Gd^Fmw, Gd^Fmw, Gs, Gs, Gs^Es, Gd, Yhs^Xp, Yhs, Gs^Es, Gs^Es, Gd, Gg, Gs^Fdw, Gll^Fp, Gd^Fmw, Gs^Fdw, Gg, Qxe, Gs, Gs, Gd, Gs, Gs, Gs, Gd, Gll^Fdw, Yhs, Yhs, Yhs, Wwf, Wwf, Wwf^Es, Gs^Fdw, Gs, Gd, Gd, Chr, Gd, Yhs
Gg, Gg, Gg, Gg, Gg, Gg, Gd^Fmw, Gll^Fp, Rp, Gg, Gg, Gg, Gs^Fdw, Gs^Fdw, Rb^Fdw, Rb^Fdw, Yhs, Yhs, Uue, Uue, Qxe, Qxe, Gd^Fdw, Gg, Gg, Gs, Gll^Fp, Gs, Gd^Fmw, Gs, Gs, Gs^Es, Gd, Yhs^Xp, Gd^Es, Gs, Gd, Gs, Gg, Gd^Fmw, Gd^Fmw, Gll^Fp, Gd^Fmw, Gs^Fdw, Gs^Fdw, Qxe, Gs, Gd, Gs, Gs, Gs, Gs, Gs, Yhs, Yhs, Yhs^Xp, Gs, Wwf^Es, Wwf, Wwf, Gs, Gd, Gs, Hhd, Yhs^Xp, Yhs^Xp, Gd
Gg, Gg, Gg, Gg, Gd^Fmw, Gll^Fp, Gs^Fdw, Rp, Rp, Gs^Fdw, Gs^Fdw, Gs^Fdw, Rb^Fdw, Rb^Fdw, Rb^Fdw, Rb^Fetd, Rb^Fdw, Rb^Fdw, Rb^Fetd, Qxe, Yhs^Xp, Qxe, Gd^Fmw, Gd^Fdw, Gd^Fmw, Gll^Fp, Gd^Fmw, Gs^Fdw, Gd^Fmw, Gs^Fdw, Gd, Gs^Es, Gs, Gs^Es, Yhs^Xp, Yhs, Gs^Es, Gs, Gd^Fdw, Gd^Fmw, Gs^Fdw, Gs^Fdw, Gll^Fp, Gd^Fmw, Gs^Fdw, Qxe, Gd, Gd, Gs, Gs, Gs, Gs, Chr, Gd, Gs, Gs, Gs, Yhs^Xp, Yhs^Xp, Wwf, Yhs, Gs, Hhd, Yhs, Yhs, Gs, Gd
Gs, Gg, Gg, Gll^Fp, Gd^Fmw, Gll^Fdw, Gs^Fdw, Rp, Gs^Fdw, Gs^Fdw, Gs^Fdw, Rb^Fdw, Yhs, Rb^Fdw, Uue, Rb^Fdw, Rb^Fetd, Rb^Fdw, Rb^Fdw, Yhs^Xp, Yhs, Qxe, Qxe, Gd^Fdw, Gd^Fetd, Gll^Fp, Gll^Fp, Gd^Fmw, Gll^Fp, Gs^Fdw, Gs^Fdw, Gs, Gd, Yhs, Gs, Gd^Es, Gg, Gd, Gg, Gg, Gs^Fdw, Gd^Fmw, Gll^Fp, Gd^Fmw, Gs^Fdw, Qxe, Gs, Gs, Gs, Hhd, Gs, Gs, Yhs, Gd, Gd, Gd, Gd, Gd, Gs, Wwf, Wwf, Wwf, Yhs, Yhs, Gg, Gd, Hhd
Gs, Gg, Gg, Gd^Fmw, Gll^Fp, Gll^Fdw, Ch, Rp, Rp, Gs^Fdw, Rb^Fdw, Rb^Fdw, Yhs^Xp, Yhs^Xp, Uue, Qxe, Rb^Fdw, Rb^Fdw, Yhs, Yhs^Xp, Uue, Uue, Qxe, Gd^Fdw, Gd^Fmw, Gll^Fp, Gll^Fp, Gll^Fp, Gd^Fmw, Gll^Fp, Gs^Fdw, Gd^Fdw, Gs^Fdw, Gd, Gs, Gd^Es, Gd^Fdw, Gs^Fdw, Gg, Gg, Gg, Gd^Fmw, Gd^Fmw, Gs^Fdw, Qxe, Qxe, Gs, Gs, Gs, Gs, Gd, Gd, Yhs^Xp, Yhs, Gd, Gd, Gd, Gs, Gs, Gs, Hhd, Wwf, Wwf, Yhs, Wwf, Gd, Hhd
Gs, Re, Re, Gll^Fp, Gs, Gs, Gg, Gs, Rp, Gs^Fdw, Gs^Fdw, Yhs^Xp, Yhs, Yhs, Uue, Qxe, Rb^Fdw, Rb^Fetd, Rb^Fdw, Uue, Yhs^Xp, Yhs^Xp, Uue, Qxe, Gll^Fp, Gll^Fp, Gd^Fmw, Gd^Fmw, Gd^Fmw, Gll^Fp, Gll^Fp, Gs^Fdw, Gll^Fp, Gd^Fmw, Gs^Fdw, Gs^Fdw, Gs^Fdw, Gs^Fdw, Gg, Gg, Gll^Fdw, Gs^Fdw, Gd^Fmw, Gg, Gs, Gs, Gd, Gs, Gs, Gs, Gd, Gs, Yhs, Yhs, Gd, Gd, Gd, Gs, Gs, Chr, Yhs, Yhs, Yhs, Wwf, Wwf, Yhs, Wwf
Gs, Re, Re, Gs, Re, Gs, Gs, Gs, Rp, Gs, Gs^Fdw, Yhs, Uue, Uue, Qxe, Qxe, Uue, Rb^Fdw, Rb^Fdw, Yhs, Uue, Uue, Yhs, Qxe, Qxe, Gd^Fdw, Gll^Fp, Gll^Fp, Gll^Fp, Gll^Fp, Gll^Fp, Gd^Fmw, Gd^Fmw, Gg, Gs^Fdw, Gs^Fdw, Gd^Fmw, Gll^Fp, Gd^Fmw, Gd^Fmw, Gd^Fmw, Gd^Fmw, Gs, Gg, Gs, Gd, Gd, Hhd, Gd, Gd, Gs, Gs, Gs, Gd, Gs, Gd, Gs, Gs, Hhd, Hhd, Yhs^Xp, Yhs^Xp, Gs, Gs, Gd, Wwf, Wwf
Gs, Ch, Gs, Re, Re, Gg^Vhr, Rr, Rp, Re, Gs, Gs^Fdw, Gs^Fdw, Gs^Fdw, Gs^Fdw, Gs^Fdw, Uue, Yhs^Xp, Yhs^Xp, Uue, Uue, Yhs^Xp, Yhs^Xp, Gd^Fdw, Qxe, Gd^Fmw, Gd^Fdw, Gll^Fp, Gll^Fp, Gll^Fp, Gll^Fp, Gll^Fp, Gd^Fmw, Gd^Fmw, Gd^Fmw, Gll^Fp, Gll^Fp, Qxe, Qxe, Qxe, Qxe, Gll^Fp, Gll^Fdw, Gd^Fmw, Gs, Gg, Gd, Gs, Gs, Gd, Gs, Hhd, Gs, Gs, Gs, Gs, Gs, Gs, Gs, Hhd, Yhs, Gs, Gd, Gd, Gd, Gd, Gs, Gs
Gd^Fmw, Gll^Fp, Re, Gg, Rr, Rr, Gs, Gs, Gs, Gs, Gs, Gs^Fdw, Gs^Fdw, Gs^Fdw, Yhs, Yhs, Yhs, Yhs, Qxe, Qxe, Qxe, Gd^Fdw, Gd^Fmw, Gd^Fmw, Gd^Fmw, Gd^Fmw, Gll^Fp, Gll^Fp, Gll^Em, Gll^Fp, Gll^Fp, Gll^Fp, Qxe, Gs^Fdw, Qxe, Qxe, Gll^Fp, Gll^Fmw, Gll^Fp, Gll^Fp, Gd^Fetd, Gll^Fp, Gll^Fmw, Gs, Gs, Gs, Gd, Gs, Gs, Hhd, Hhd, Gs, Hhd, Gs, Gs, Hhd, Gs, Gs, Hhd, Yhs, Gs, Gs, Yhs^Xp, Gs, Gd, Hhd, Gs
Gll^Fp, Gll^Fp, Re, Gg, Rr, Gs, Gg, Gs, Gs, Gll^Fp, Gd^Fmw, Gs^Fdw, Gs^Fdw, Gs^Fdw, Yhs, Yhs^Xp, Uue, Uue, Qxe, Qxe, Gd^Fmw, Gd^Fmw, Gd^Fmw, Gd^Fetd, Gll^Fp, Gll^Fp, Gg, Gll^Fp, Gg, Gg, Qxe, Qxe, Qxe, Qxe, Gg, Gll^Fp, Gg, Gll^Fp, Gll^Fp, Gll^Fp, Gll^Fp, Gd^Fmw, Gg, Gg, Gs, Gs, Gd, Gd, Gs, Gs, Gs, Gs, Hhd, Gs, Hhd, Hhd, Gs, Hhd, Hhd, Hhd, Hhd, Yhs, Yhs, Gs, Gd, Gd, Gd
