border_size=1
usage=map

Xu, Xu, Xu, Xu, Xu, Xu, Xu, Xu, Xu, Xu, Xu, Xu, Xu, Xu, Xu, Xu, Xu, Xu, Xu, Xu, Xu, Xu, Xu, Xu, Xu, Xu, Xu, Xu, Xu, Xu, Xu, Xu, Xu, Xu, Xu, Xu, Xu, Xu, Xu, Xu, Xos, Xu, Xu, Xu, Xu, Xu, Xu, Xu, Xu, Xu, Xu, Xu, Xu, Xu, Xu, Xu, Xu, Xu, Xu, Xu, Xu, Xu, Xu, Xu, Xu, Xu, Xu, Xu
Xu, Xu, Xu, Xu, Xu, Xu, Xu, Xu, Xu, Xu, Xu, Xu, Xu, Xu, Xu, Xu, Xu, Xu, Xu, Xu, Xu, Xu, Xu, Xu, Xu, Xu, Xu, Xu, Xu, Xu, Xu, Xu, Xu, Xu, Xu, Xu, Xu, Xu, Uu^Uf, Xos, Xos, Xos, Xos, Xu, Xu, Xu, Xu, Xu, Xu, Xu, Xu, Xu, Xu, Xu, Xu, Xu, Xu, Xu, Xu, Xu, Xu, Xu, Xu, Xu, Xu, Xu, Xu, Xu
Xu, Xu, Xu, Xu, Xu, Xu, Xu, Xu, Xu, Xu, Xu, Xu, Xu, Xu, Xu, Xu, Xu, Xu, Xu, Xu, Xu, Xu, Xu, Xu, Xu, Xu, Xu, Xu, Xu, Xu, Xu, Xu, Xu, Xu, Xos, Xu, Uh, Uh, Uu^Uf, Uu^Uf, Uh, Xos, Xos, Xos, Xu, Xu, Xu, Xu, Xu, Xu, Xu, Xu, Xu, Xu, Xu, Xu, Xu, Xu, Xu, Xu, Xu, Xu, Xu, Xu, Xu, Xu, Xu, Xu
Xu, Xu, Xu, Xu, Xu, Xu, Xu, Xu, Xu, Xu, Xu, Xu, Xu, Xu, Xu, Xu, Xu, Xu, Xu, Xu, Xu, Xu, Xu, Xu, Xu, Xu, Xu, Xu, Xu, Xu, Xu, Xu, Xu, Xos, Xos, Xos, Uu^Uf, Uh, Uu^Ii, Uu^Uf, Uu^Uf, Uh, Xu, Xu, Xu, Xu, Xu, Xu, Xu, Xu, Xu, Xu, Xu, Xu, Xu, Xu, Xu, Xu, Xu, Xu, Xu, Xu, Xu, Xu, Xu, Xu, Xu, Xu
Xu, Xu, Xu, Xu, Xu, Xu, Xu, Xu, Xu, Xu, Xu, Xu, Xu, Xu, Xu, Xu, Xu, Xu, Xu, Xu, Xu, Xu, Xu, Xu, Xu, Xu, Xu, Xu, Xu, Xu, Xu, Xu, Xos, Xos, Xos, Cud, Yhr^Emf, Uu^Uf, Yhr, Yhr^Xp, Uu^Uf, Uh, Ss, Uh, Uh, Xu, Xu, Xu, Xu, Xu, Xu, Xu, Xu, Xu, Xu, Xu, Xu, Xu, Xu, Xu, Xu, Xu, Xu, Xu, Xu, Xu, Xu, Xu
Xu, Xu, Xu, Xu, Xu, Xu, Xu, Xu, Xu, Xu, Xu, Xu, Xu, Xu, Xu, Xu, Xu, Xu, Xu, Xu, Xu, Xu, Xu, Xu, Xu, Xu, Xu, Xu, Xu, Xu, Xu, Xos, Xos, Xos, Yhr^Xp, Yhr^Xp, Yhr, Yhr^Em, Cud, Yhr^Xp, Xu, Ss, Ss, Ss, Uh, Xu, Xu, Xu, Xu, Xu, Xu, Xu, Xu, Xu, Xu, Xu, Xu, Xu, Xu, Xu, Xu, Xu, Xu, Xu, Xu, Xu, Xu, Xu
Xu, Xu, Xu, Xu, Xu, Xu, Xu, Xu, Xu, Xu, Xu, Xu, Xu, Xu, Xu, Xu, Xu, Xu, Xu, Xu, Xu, Xu, Xu, Xu, Xu, Xu, Xu, Xu, Xu, Xu, Xu, Xos, Xos, Yhr^Xp, Yhr, Yhr, Xos, Xos, Xos, Xu, Xu, Ss, Uh, Uu, Xu, Xu, Xu, Xu, Xu, Xu, Xu, Xu, Xu, Xu, Xu, Xu, Xu, Xu, Xu, Xu, Xu, Xu, Xu, Xu, Xu, Xu, Xu, Xu
Xu, Xu, Xu, Xu, Xu, Xu, Xu, Xu, Xu, Xu, Xu, Xu, Xu, Xu, Xu, Xu, Xu, Xu, Xu, Xu, Xu, Xu, Xu, Xu, Xu, Xu, Xu, Xu, Xu, Xu, Xu, Xu, Xu, Yhr, Yhr, Xos, Xu, Xos, Xos, Xu, Xu, Xu, Xu, Xu, Xu, Xu, Xu, Xu, Xu, Xu, Xu, Xu, Xu, Xu, Xu, Xu, Xu, Xu, Xu, Xu, Xu, Xu, Xu, Xu, Xu, Xu, Xu, Xu
Xu, Xu, Xu, Xu, Xu, Xu, Xu, Xu, Xu, Xu, Xu, Xu, Xu, Xu, Xu, Xu, Xu, Xu, Xu, Xu, Xu, Xu, Xu, Xu, Xu, Xu, Xu, Xu, Xu, Xu, Uh, Uh, Yhr, Yhr, Yhr, Xu, Xu, Xu, Xu, Xu, Xu, Xu, Xu, Xu, Xos, Xos, Xos, Xu, Xu, Xu, Xu, Xu, Xu, Xu, Xu, Xu, Xu, Xu, Xu, Xu, Xu, Xu, Xu, Xu, Xu, Xu, Xu, Xu
Xu, Xu, Xu, Xu, Xu, Xu, Xu, Xu, Xu, Xu, Xu, Xu, Xu, Xu, Xu, Xu, Xu, Xu, Xu, Xu, Xu, Xu, Xu, Xu, Xu, Xu, Xu, Xu, Xu, Xu, Yhr, Yhr^Xp, Yhr, Yhr, Yhr, Uh, Yhr, Xu, Xos, Xos, Xos, Xu, Xu, Xos, Xos, Xos, Xos, Xos, Xos, Xu, Xu, Xu, Xu, Xu, Xu, Xu, Xu, Xu, Xu, Xu, Xu, Xu, Xu, Xu, Xu, Xu, Xu, Xu
Xu, Xu, Xu, Xu, Xu, Xu, Xu, Xu, Xu, Xu, Xu, Xu, Xu, Xu, Xu, Xu, Xu, Xu, Xu, Xu, Xu, Xu, Xu, Xu, Xu, Xu, Xu, Xu, Xu, Xu, Xos, Uh, Yhr^Xp, Yhr, Yhr, Yhr, Yhr, Yhr, Cud, Xos, Xos, Xu, Xu, Xos, Xos, Xos, Xos, Xos, Xos, Xos, Xos, Xu, Xu, Xu, Xu, Xu, Xu, Xu, Xu, Xu, Xu, Xu, Xu, Xu, Xu, Xu, Xu, Xu
Xu, Xu, Xu, Xu, Xu, Xu, Xu, Xu, Xu, Xu, Xu, Xu, Xu, Xu, Xu, Xu, Xu, Xu, Xu, Xu, Xu, Xu, Xu, Xu, Xu, Xu, Xu, Xu, Xu, Xu, Xu, Xos, Cud, Yhr, Yhr, Yhr, Cud, Cud, Yhl, Yhl, Yhl, Xu, Xu, Xu, Xos, Xos, Xos, Wwb, Wwb, Xos, Xos, Xos, Xos, Xu, Xu, Xu, Xu, Xu, Xu, Xu, Xu, Xu, Xu, Xu, Xu, Xu, Xu, Xu
Xu, Xu, Xu, Xu, Xu, Xu, Xu, Xu, Xu, Xu, Xu, Xu, Xu, Xu, Xu, Xu, Xu, Xu, Xu, Xu, Xu, Xu, Xu, Xu, Xu, Xu, Xu, Xu, Qlf, Xu, Xu, Xos, Yhl, Cud, Cud, Xos, Xos, Yhl, Yhl, Yhl, Yhl, Uh, Xu, Xu, Xu, Xos, Xos, Xos, Xos, Wwb^Z/, Wwb, Xos, Xos, Xos, Xos, Xu, Xu, Xu, Xu, Xu, Xu, Xu, Xu, Xu, Xu, Xu, Xu, Xu
Xu, Xu, Xu, Xu, Xu, Xu, Xu, Xu, Xu, Xu, Xu, Xu, Xu, Xu, Xu, Xu, Xu, Xu, Xu, Xu, Xu, Xu, Xu, Xu, Xu, Xu, Qlf, Xu, Xu, Cud, Yhl^Xp, Yhl, Yhl, Yhl, Yhl, Xos, Xos, Xos, Xos, Yhl, Yhl, Uu^Vu, Xu, Xu, Xu, Xos, Xos, Xos, Xos, Xos, Yhl, Wwb, Wwb, Xos, Xos, Xos, Xos, Xu, Xu, Xu, Xu, Xu, Xu, Xu, Xu, Xu, Xu, Xu
Xu, Xu, Xu, Xu, Xu, Xu, Xu, Xu, Xu, Xu, Xu, Xu, Xu, Xu, Xu, Xu, Xu, Xu, Xu, Xu, Xu, Xu, Xu, Xu, Qlf, Xu, Xu, Cud, Yhl^Xp, Yhl^Xp, Yhl, Yhl, Yhl, Yhl, Yhl, Xos, Xos, Xos, Xos, Yhl, Yhl, Uh, Uu^Vu, Xu, Xu, Xu, Uh, Uh, Uh, Uu^Uf, Uu^Uf, Yhl, Xos, Wwb^Z/, Wwb, Xos, Xos, Xos, Xos, Xu, Xu, Xu, Xu, Xu, Xu, Xu, Xu, Xu
Xu, Xu, Xu, Xu, Xu, Xu, Xu, Xu, Xu, Xu, Xu, Xu, Xu, Xu, Xu, Xu, Xos, Xos, Xos, Xu, Xu, Xu, Qlf, Xu, Xu, Cud, Yhl^Xp, Yhl^Xp, Yhl, Yhl, Yhl, Yhl, Xu, Xu, Xu, Xos, Xu, Xu, Xu, Yhl, Yhl, Yhl, Yhl, Uh, Yhl^Xp, Yhl^Xp, Uue^Uf, Uue^Uf, Uue^Uf, Uu^Uf, Uh, Xos, Xos, Xos, Xos, Wwb, Xos, Xos, Xos, Xos, Xu, Xu, Xu, Xu, Xu, Xu, Xu, Xu
Xu, Xu, Xu, Xu, Xu, Xu, Xu, Xu, Xu, Xu, Xu, Xu, Xu, Xu, Xos, Xos, Xos, Xos, Xos, Xos, Xos, Xos, Xos, Cud, Yhl^Xp, Yhl^Xp, Yhl, Yhl, Yhl, Yhl, Xos, Xos, Xos, Xu, Xu, Xu, Xu, Xu, Xu, Uh, Uue^Uf, Uue, Uue, Yhl, Yhl, Yhl, Yhl, Uue^Emf, Uue, Uh, Xos, Xos, Xu, Xos, Xos, Xos, Xos, Xos, Xu, Xu, Xu, Xu, Xu, Xu, Xu, Xu, Xu, Xu
Xu, Xu, Xu, Xu, Xu, Xu, Xu, Xu, Xu, Xu, Xu, Xu, Xos, Xos, Xos, Xos, Ur^Br\, Uu, Uu, Xos, Xos, Xos, Xos, Xos, Yhl, Yhl, Yhl, Yhl, Xos, Yhl^Z/, Yhl, Xos, Xos, Xos, Xos, Xos, Xos, Xu, Uu^Vu, Uh, Uue^Uf, Uue^Em, Uue^Uf, Yhl, Yhl, Yhl, Yhl, Yhl^Em, Uu, Yhl^Xp, Xos, Xu, Xu, Xu, Xu, Xos, Xu, Xu, Xu, Xu, Xu, Xu, Xu, Xu, Xu, Xu, Xu, Xu
Xu, Xu, Xu, Xu, Xu, Xu, Xu, Xu, Xu, Xu, Xu, Xu, Xu, Xos, Xos, Uu, Uu, Ur^Br\, Ur^Z/, Uu^Z/, Uu^Emf, Xos, Yhr, Yhl, Yhl, Yhl, Xos, Xos, Xos, Yhl, Yhl, Yhl, Xos, Xos, Xos, Xos, Xos, Xos, Xos, Uue^Uf, Uh, Uh, Xu, Yhl, 1 Yhl, Yhl, Yhl, Uh, Uh, Yhl, Qxu, Qxu, Qxu, Xu, Xu, Xu, Xu, Xu, Xu, Xu, Xu, Xu, Xu, Xu, Xu, Xu, Xu, Xu
Xu, Xu, Xu, Xu, Xu, Xu, Xu, Xu, Xu, Xu, Xu, Xu, Xu, Xu, Xu, Xos, Xos, Uu^Z/, Uu, Ur^Br\, Ur^Br\, Yhr, Yhr, Yhl, Xos, Yhl^Z/, Yhl, Yhl, Yhl, Xos, Xos, Xos, Xos, Xos, Xos, Xos, Xos, Xos, Xos, Xos, Xos, Xu, Xu, Xu, Yhl, Yhl, Yhl^Emf, Uu^Uf, Uh, Yhl, Yhl, Qxu, Qxu, Xos, Xos, Xu, Xu, Xu, Xu, Xu, Xu, Xu, Xu, Xu, Xu, Xu, Xu, Xu
Xu, Xu, Xu, Xu, Xu, Xu, Xu, Xu, Xu, Xu, Xu, Xu, Xu, Xu, Xu, Xu, Xu, Xos, Uu^Uf, Yhr^Xp, Yhr^Xp, Ur^Br\, Yhr, Xos, Xos, Xos, Xos, Yhl, Xos, Xos, Xos, Xos, Xos, Xos, Xos, Xos, Uu, Uu, Uu, Xos, Xos, Xos, Xos, Xos, Yhl, Xos, Xos, Uu^Uf, Uu^Uf, Yhl, Yhl, Yhl, Yhl, Xos, Xos, Xos, Xos, Xu, Xu, Xu, Xu, Xu, Xu, Xu, Xu, Xu, Xu, Xu
Xu, Xu, Xu, Xu, Xu, Xu, Xu, Xu, Xu, Xu, Xu, Xu, Xu, Xu, Ss, Ss, Ss, Uh, Uh, Uu^Uf, Yhr^Xp, Ur^Br|, Uu, Xos, Xos, Xos, Xos, Xos, Xos, Xos, Uu, Xos, Xos, Xos, Xos, Xu, Uu, Urb^Ii, Uu, Xu, Xu, Xos, Xos, Xos, Yhl, Xos, Xos, Xos, Xos, Yhl, Yhl, Yhl, Cud, Cud, Yhl, Xos, Xos, Xos, Xos, Xu, Xu, Xu, Xu, Xu, Xu, Xu, Xu, Xu
Xu, Xu, Xu, Xu, Xu, Xu, Xu, Xu, Xu, Xu, Xu, Xu, Xu, Xu, Ss, Ss, Xu, Ss, Xu, Uu^Uf, Uu, Ur^Br|, Uu, Xos, Xos, Xos, Xos, Xos, Uu, Ur^Br\, Ur^Br\, Uu, Uu^Z/, Xos, Xos, Xu, Xu, Uu, Uu, Xu, Xu, Xos, Xos, Xos^Zok, Yhl^Zok, Xos^Zok, Xos, Xos, Xos, Xos, Xos, Cud, Yhl, Yhl, Yhl^Xp, Yhl, Xos, Xos, Yhl^Xp, Uh, Xu, Xu, Xu, Xu, Xu, Xu, Xu, Xu
Xu, Xu, Xu, Xu, Xu, Xu, Xu, Xu, Xu, Xu, Xu, Xu, Xu, Xu, Xu, Ss, Xu, Xu, Xos, Xos, Uh, Ur^Br\, Ur^Br\, Uu^Uf, Uh, Xos, Xos, Xos, Xos, Uu, Uu^Z/, Ur^Z/, Ur^Br\, Uu, Uu, Xu, Xu, Qlf, Xu, Xu, Xu, Xos, Xos, Xos^Zok, Yhl^Zok, Xos^Zok, Xos, Xos, Xos, Xos, Xos, Xos, Xos, Yhl, Yhl^Xp, Yhl, Yhl, Yhl, Yhl^Xp, Uh, Xu, Xu, Xu, Xu, Xu, Xu, Xu, Xu
Xu, Xu, Xu, Xu, Xu, Xu, Xu, Xu, Xu, Xu, Xu, Xu, Xu, Xu, Xu, Xu, Xos, Xos, Uu^Z\, Uu, Ur^Br/, Ur^Br/, Uu^Emf, Ur^Br\, Ur^Br\, Uh, Uu^Zz/, Xos, Xos, Xos, Xos, Uu^Emf, Uu^Em, Ur^Br\, Ur^Br\, Uu, Xu, Qlf^Xo, Xu, Xu, Xu, Xos, Xos, Xos^Zok, Xos^Zok, Xos^Zok, Xos, Xos, Xos, Xos, Xos, Xos, Uh, Yhl, Yhl, Yhl, Yhl, Yhl, Xos, Xu, Xu, Xu, Xu, Xu, Xu, Xu, Xu, Xu
Xu, Xu, Xu, Xu, Xu, Xu, Xu, Xu, Xu, Xu, Xu, Xu, Xu, Xu, Xos, Xos, Uu, Uu, Ur^Br/, Ur^Z\, Uu^Z\, Uu^Uf, Xos, Uu, Uu^Zz/, Ur^Zz/, Ur^Br\, Uu^Em, Xos, Xos, Ur, Uu^Em, Xos, Uu, Uu, Uu^Br\, Uu^Br\, Uu, Uh, Xu, Xu, Xu, Xu, Xos, Xos, Xos, Xos, Xos, Xos, Xos, Xos, Xos, Uu^Ii, Yhl, Yhr, Yhr, Uu^Ii, Uu^Vud, Xos, Xos, Xos, Xu, Xu, Xu, Xu, Xu, Xu, Xu
Xu, Xu, Xu, Xu, Xu, Xu, Xu, Xu, Xu, Xu, Xu, Xu, Xu, Xos, Xos, Xos, Xos, Ur^Br/, Uu, Uu, Xos, Xos, Xos, Xos, Xos, Uu, Ur^Br|, Uu, Ur, Uu, Xos, Xos, Xos, Xos, Xu, Uu, Uu, Qxu, Qxu, Ur, Ur, Xu, Xu, Xu, Xu, Xos, Xos, Xos, Xos, Xos, Xos, Uh, Uu, Yhl, Urb, Yhr, Uu^Vud, Uh, Uh, Xos, Xos, Xos, Xos, Xu, Xu, Xu, Xu, Xu
Xu, Xu, Xu, Xu, Xu, Xu, Xu, Xu, Xu, Xu, Xu, Xu, Xu, Xu, Xu, Xos, Xos, Xos, Xos, Xos, Xos, Xos, Xos, Xos, Xos, Uh, Ur^Br|, Ur^Br\, Ur^Br\, Xos, Xos, Xos, Xos, Xu, Xu, Qlf, Qxu, Qxu, Qxu, Uh, Wwf, Wwf, Wwg, Xu, Xu, Xu, Xu, Xos, Xos, Xos, Xos, Xos, Xos, Uu^Ii, Urb, Uu^Ii, Uh, Uh, Uu, Uu, Qlf^Xo, Xos, Xos, Xos, Xos, Xu, Xu, Xu
Xu, Xu, Xu, Xu, Xu, Xu, Xu, Xu, Xu, Xu, Xu, Xu, Xu, Xu, Xu, Xu, Xu, Xos, Xos, Xos, Xos, Xos, Xos, Xos, Uu^Z\, Uh, Ur^Br/, Ur^Br\, Ur^Br\, Ur^Br\, Ur^Z/, Xos, Xos, Xu, Xu, Qlf, Qlf, Qxu, Xu, Wwf, Wwg, Uu^Uf, Wwf, Xu, Xu, Xu, Xu, Xu, Xos, Xos, Xos, Xos, Urb, Urb, Urb, Uu^Vud, Xos, Uu, Qlf^Xo, Qlf^Xo, Uu, Uu, Uu, Xos, Xos, Xos, Xos, Xu
Xu, Xu, Xu, Xu, Xu, Xu, Xu, Xu, Xu, Xu, Xu, Xu, Xu, Xu, Xu, Xu, Xu, Xu, Xu, Xos, Xos, Xos, Uu, Uu, Ur^Br/, Ur^Z\, Uu^Z\, Uu, Xos, Ur^Z/, Ur^Br\, Ur^Br\, Ur^Br\, Xu, Xu, Xu, Qlf^Xo, Xu, Xu, Uu^Uf, Uu^Uf, Ur^Em, Uh, Wwf, Xos, Xos, Xos, Xos, Xos, Xos, Urb, Urb^Zz\, Urb^Zz\, Urb, Urb, Uh, Xos, Xos, Xos, Uu, Uu, Urb^Ii, Uu, Uu, Xos, Xos, Xos, Xos
Xu, Xu, Xu, Xu, Xu, Xu, Xu, Xu, Xu, Xu, Xu, Xu, Xu, Xu, Xu, Xu, Xu, Xu, Xu, Xu, Xos, Xos, Xos, Ur^Br/, Uu, Uu, Xos, Xos, Xos, Xos, Xu, Ur^Br\, Xu, Xu, Xu, Xu, Qlf, Xu, Xu, Uu^Uf, Uh, Ur, Uu, Uh, Xos, Xos, Xos, Xos, Rb, Urb, Urb, Rb, Rb, Urb^Zz\, Xos, Xos, Xos, Xos, Xos, Xos, Xos, Uu, Xos, Xos, Xos, Xos, Xu, Xu
Xu, Xu, Xu, Xu, Xu, Xu, Xu, Xu, Xu, Xu, Xu, Xu, Xu, Xu, Xu, Xu, Xu, Xu, Xu, Xu, Xu, Xos, Xos, Xos, Xos, Xos, Xos, Xos, Xu, Xu, Xu, Xu, Xu, Xu, Qlf, Qlf, Xu, Xu, Xu, Xu, Xu, Uh, Xos, Xos, Xos, Xos, Urb, Wwg, Wwf, Rb^Em, Urb, Urb, Rb, Xos, Xos, Xos, Xos, Xos, Xos, Xos, Xos, Xos, Xos, Xos, Xu, Xu, Xu, Xu
Xu, Xu, Xu, Xu, Xu, Xu, Xu, Xu, Xu, Xu, Xu, Xu, Xu, Xu, Xu, Xu, Xu, Xu, Xu, Xu, Xu, Xu, Xu, Xos, Xos, Xos, Xu, Xu, Xu, Xu, Uu, Uu, Uu, Qlf, Xu, Xu, Xu, Xu, Xu, Xu, Xu, Xos, Xos, Xos, Urb, Urb, Xu, Wwg, Rb, Rb, Wwf, Xu, Xu, Wwf, Uh, Xos, Xos, Xos, Xu, Xu, Xu, Xos, Xu, Xu, Xu, Xu, Xu, Xu
Xu, Xu, Xu, Xu, Xu, Xu, Xu, Xu, Xu, Xu, Xu, Xu, Xu, Xu, Xu, Xu, Xu, Xu, Xu, Xu, Xu, Xu, Xu, Xu, Xu, Xu, Xu, Xu, Xu, Xu, Uu, Urb^Ii, Uu, Uu, Xu, Xu, Xu, Xu, Xu, Xu, Xu, Xos, Uh, Uh, Urb, Xu, Urb, Wwf, Rb^Em, Xu, Xu, Urb, Urb, Uu^Uf, Xu, Xu, Xu, Xu, Xu, Xu, Xu, Xu, Xu, Xu, Xu, Xu, Xu, Xu
Xu, Xu, Xu, Xu, Xu, Xu, Xu, Xu, Xu, Xu, Xu, Xu, Xu, Xu, Xu, Xu, Xu, Xu, Xu, Xu, Xu, Xu, Xu, Xu, Xu, Xu, Xu, Xu, Xu, Xu, Xu, Uu, Qlf, Xu, Xu, Xu, Xu, Xu, Xu, Xu, Xu, Xu, Uh, Xu, Wwf, Urb, Urb, Xu, Xu, Rb, Rb, Rb, Xu, Uh, Wwg, Xu, Xu, Xu, Xu, Xu, Xu, Xu, Xu, Xu, Xu, Xu, Xu, Xu
Xu, Xu, Xu, Xu, Xu, Xu, Xu, Xu, Xu, Xu, Xu, Xu, Xu, Xu, Xu, Xu, Xu, Xu, Xu, Xu, Xu, Xu, Xu, Xu, Xu, Xu, Xu, Xu, Xu, Xu, Xu, Xu, Xu, Qlf, Qlf, Xu, Xu, Xu, Xu, Xu, Xu, Xu, Xu, Xu, Wwg, Xu, Xu, Rb^Uf, Rb^Em, Xu, Xu, Uh, Uu, Xu, Wwg, Xu, Xu, Xu, 5 Cud, Xu, Xu, Xu, Xu, Xu, Xu, Xu, Xu, Xu
Xu, Xu, Xu, Xu, Xu, Xu, Xu, Xu, Xu, Xu, Xu, Xu, Xu, Xu, Xu, Xu, Xu, Xu, Xu, Xu, Xu, Xu, Xu, Xu, Xu, Xu, Xu, Xu, Xu, Xu, Xu, Xu, Xu, Xu, Xu, Qlf, Qlf, Xu, Xu, Xu, Xu, Xu, Xu, Xu, Xu, Wwg, Uu, Rb^Em, Xu, Xu, Xu, Uu, Xu, Wwf, Uu, Xu, Xu, Cud, Wwg, Wwg, Uu^Uf, Xu, Xu, Xu, Xu, Xu, Xu, Xu
Xu, Xu, Xu, Xu, Xu, Xu, Xu, Xu, Xu, Xu, Xu, Xu, Xu, Xu, Xu, Xu, Xu, Xu, Xu, Xu, Xu, Xu, Xu, Xu, Xu, Xu, Xu, Xu, Xu, Xu, Xu, Xu, Xu, Xu, Xu, Xu, Xu, Qlf, Qlf^Xo, Xu, Xu, Xu, Uh, Xu, Xu, Xu, Rb, Uu, Rb, Xu, Wwg, Wwf, Xu, Xu, Uu^Uf, Uu, Uu^Em, Uu^Uf, Uu^Uf, Uh, Uu^Emf, Xu, Xos, Xu, Xu, Xu, Xu, Xu
Xu, Xu, Xu, Xu, Xu, Xu, Xu, Xu, Xu, Xu, Xu, Xu, Xu, Xu, Xu, Xu, Xu, Xu, Xu, Xu, Xu, Xu, Xu, Xu, Xu, Xu, Xu, Xu, Xu, Xu, Xu, Xu, Xu, Xu, Xu, Xu, Xu, Xu, Xu, Qlf, Qlf, Uh, Uh, Xu, Xu, Xu, Uu, Uu^Uf, Xu, Uu, Wwg, Xu, Xu, Xu, Rb, Rb, Uu, Uu^Emf, Uh, Uh, Uh, Uh, Xos, Xos, Xu, Xu, Xu, Xu
Xu, Xu, Xu, Xu, Xu, Xu, Xu, Xu, Xu, Xu, Xu, Xu, Xu, Xu, Xu, Xu, Xu, Xu, Xu, Xu, Xu, Xu, Xu, Xu, Xu, Xu, Xu, Xu, Xu, Xu, Xu, Xu, Xu, Xu, Xu, Xu, Xu, Xu, Xu, Uh, Uh, Qlf, Qlf, Xu, Urb, Uu, Uu, Xu, Xu, Xu, Xu, Wwf, Uu, Uu, Xu, Rb^Es, Uu, Uu, Uu, Xu, Uh, Uh, Xos, Xos, Xu, Xu, Xu, Xu
Xu, Xu, Xu, Xu, Xu, Xu, Xu, Xu, Xu, Xu, Xu, Xu, Xu, Xu, Xu, Xu, Xu, Xu, Xu, Xu, Xu, Xu, Xu, Xu, Xu, Xu, Xu, Xu, Xu, Xu, Xu, Xu, Xu, Xu, Uh, Uh, Xu, Xu, Uh, Uh, Uu, Qlf, Qlf, Xu, Xu, Rb^Em, Rb, Uu, Rb, Uu^Uf, Xu, Wwf, Xu, Xu, Uu, Xu, Uu, Uu, Uu, Uh, Xu, Xu, Xu, Xu, Xu, Xu, Xu, Xu
Xu, Xu, Xu, Xu, Xu, Xu, Xu, Xu, Xu, Xu, Xu, Xu, Xu, Xu, Xu, Xu, Xu, Xu, Xu, Xu, Xu, Xu, Xu, Xu, Xu, Xu, Xu, Xu, Xu, Xu, Xu, Xu, Xu, Xu, Uh, Uh, Urb, Uh, Urb, Urb, Uh, Qlf, Qlf, Xu, Xu, Rb^Emf, Uu, Xu, Xu, Uu^Uf, Wwf, Xu, Xu, Xu, Uu^Ii, Uu, Xu, Xu, Rb^Em, Rb, Cud, Xu, Xu, Xu, Xu, Xu, Xu, Xu
Xu, Xu, Xu, Xu, Xu, Xu, Xu, Xu, Xu, Xu, Xu, Xu, Xu, Xu, Xu, Xu, Xu, Xu, Xu, Xu, Xu, Xu, Xu, Xu, Xu, Xu, Xu, Xu, Xu, Xu, Xu, Xu, Xos, Xu, Urb, Uh, Urb, Urb, Urb, Uh, Xu, Uh, Uh, Qlf, Qlf, Xu, Xu, Uu, Xu, Xu, Wwg, Uu, Xu, Xu, Xu, Uu, Xu, Xu, Xu, Rb, Cud, 6 Cud, Xu, Xu, Xu, Xu, Xu, Xu
Xu, Xu, Xu, Xu, Xu, Xu, Xu, Xu, Xu, Xu, Xu, Xu, Xu, Xu, Xu, Xu, Xu, Xu, Xu, Xu, Xu, Xu, Xu, Xu, Xu, Xu, Xu, Xu, Xu, Xu, Uh, Xu, Uh, Xos, Xos, Urb, Urb, Urb, Uh, Uh, Xu, Uh, Xu, Uh, Qlf, Xu, Xu, Xu, Xu, Wwg, Uh, Uh, Rb^Es, Xu, Xu, Xu, Uu^Uf, Uu^Uf, Uu, Uu, Xu, Xu, Xu, Xu, Xu, Xu, Xu, Xu
Xu, Xu, Xu, Xu, Xu, Xu, Xu, Xu, Xu, Xu, Xu, Xu, Xu, Xu, Xu, Xu, Xu, Xu, Xu, Xu, Xu, Xu, Xos, Xos, Xos, Xu, Xu, Xu, Qxu, Qxu, Uu, Ur^Es, Uh, Uh, Urb, Xos, Xos, Xu, Xu, Uh, Xu, Xu, Xu, Xu, Qlf^Xo, Xu, Xu, Xu, Xu, Xu, Uu^Emf, Uu^Em, Uu, Rb, Uu, Uu, Rb, Uu^Uf, Uu, Uh, Xos, Xu, Xu, Xu, Xu, Xu, Xu, Xu
Xu, Xu, Xu, Xu, Xu, Xu, Xu, Xu, Xu, Xu, Xu, Xu, Xu, Xu, Xu, Xu, Xu, Xu, Xu, Xu, Xos, Xos, Xos, Xos, Xos, Xos, Qxu, Uu, Uu, Qxu, Urb, Ur^Es, Urb, Urb, Urb, Uu, Uh, Xos, Xos, Xu, Xu, Xu, Xu, Xu, Xu, Qlf, Qlf, Xu, Xu, Uu^Uf, Uu^Emf, Uu^Em, Cud, Wwf, Wwf, Uu, Xu, Uu, Xos, Xos, Xos, Xos, Xu, Xu, Xu, Xu, Xu, Xu
Xu, Xu, Xu, Xu, Xu, Xu, Xu, Xu, Xu, Xu, Xu, Xu, Xu, Xu, Xu, Xu, Xu, Xu, Xos, Xos, Xos, Xos, Uh, Xos, Xos, Xos, Urb^Es, Urb^Es, Uu^Es, Cud, Urb, Urb^Bzu, Urb, Urb, Urb, Urb, Uh, Uh, Uh, Xos, Xos, Xu, Xu, Xu, Xu, Xu, Qlf, Xu, Xu, Xu, Xuc, Cud, 4 Cud, Cud, Xuc, Xu, Xu, Xos, Xos, Xos, Xu, Xu, Xu, Xu, Xu, Xu, Xu, Xu
Xu, Xu, Xu, Xu, Xu, Xu, Xu, Xu, Xu, Xu, Xu, Xu, Xu, Xu, Xu, Xu, Xu, Xos, Xos, Xos, Urb, Urb, Uu, Uu, Xos, Urb, Urb, Urb^Es, Qxu, Cud, Cud, Urb, Urb, Urb, Urb, Urb, Urb, Ur, Ur, Xos, Xos, Xu, Xu, Xu, Xu, Xu, Uu, Xu, Xu, Xu, Xu, Xuc, Xu, Xuc, Xu, Xu, Xu, Xu, Xu, Xu, Xu, Xu, Xu, Xu, Xu, Xu, Xu, Xu
Xu, Xu, Xu, Xu, Xu, Xu, Xu, Xu, Xu, Xu, Xu, Xu, Xu, Xu, Xu, Xu, Xu, Xos, Xos, Urb, Urb, Urb, Cud, Ur, Xos, Urb, Urb, Urb, Qxu, Uu^Uf, Ur^Em, Urb, Urb, Urb, Urb, Urb^Bzu, Uh, Uu, Uu, Xos, Xos, Xu, Xu, Xu, Xu, Uu, Urb^Ii, Uu, Xu, Xu, Xu, Xuc, Xu, Xuc, Xu, Xu, Xu, Xu, Xu, Xu, Xu, Xu, Xu, Xu, Xu, Xu, Xu, Xu
Xu, Xu, Xu, Xu, Xu, Xu, Xu, Xu, Xu, Xu, Xu, Xu, Xu, Xu, Xu, Xu, Xu, Xos, Xos, Urb, Ur, Cud, 3 Cud, Ur, Xos, Urb, Urb, Qxu, Urb, Uu^Uf, Uu, Urb, Urb, Urb, Urb, Urb, Uu^Uf, Uh, Uh, Xos, Xu, Xu, Xu, Xu, Xu, Uu, Uu, Uu, Xu, Xu, Xu, Xuc, Xu, Xuc, Xu, Xu, Xu, Xu, Xu, Xu, Xu, Xu, Xu, Xu, Xu, Xu, Xu, Xu
Xu, Xu, Xu, Xu, Xu, Xu, Xu, Xu, Xu, Xu, Xu, Xu, Xu, Xu, Xu, Xu, Xu, Xos, Xos, Urb, Uh, Cud, Ur, Uu, Xos, Urb, Urb, Urb, Urb, Urb^Es, Urb, Urb, Urb, Urb, Cud, Urb^Em, Uu^Uf, Uu^Uf, Qxu, Xu, Xu, Xu, Xu, Xu, Xu, Xu, Xu, Xu, Xu, Xu, Xu, Xuc, Xu, Xuc, Xu, Xu, Xu, Xu, Xu, Xu, Xu, Xu, Xu, Xu, Xu, Xu, Xu, Xu
Xu, Xu, Xu, Xu, Xu, Xu, Xu, Xu, Xu, Xu, Xu, Xu, Xu, Xu, Xu, Xu, Xu, Xos, Xos, Urb, Uu, Uu, Uh, Ur, Xos, Urb, Urb, Urb^Es, Urb, Urb, Urb, Urb, Urb, Urb, Cud, Urb^Emf, Uh, Uh, Qxu, Xu, Xu, Xu, Xu, Xu, Xu, Xu, Xu, Xu, Xu, Xu, Xu, Xuc, Xu, Xuc, Xu, Xu, Xu, Xu, Xu, Xu, Xu, Xu, Xu, Xu, Xu, Xu, Xu, Xu
Xu, Xu, Xu, Xu, Xu, Xu, Xu, Xu, Xu, Xu, Xu, Xu, Xu, Xu, Xu, Xu, Xu, Xos, Xos, Xos, Xos, Uu, Uu, Ur, Xos, Urb, Urb, Urb, Urb^Es, Urb, Uu^Uf, Urb, Urb^Bzu, Uh, Uh, Cud, Urb, Qxu, Xu, Xu, Xu, Xu, Xu, Xu, Xu, Xu, Xu, Xu, Xu, Xu, Xu, Xuc, Xu, Xuc, Xu, Xu, Xu, Xu, Xu, Xu, Xu, Xu, Xu, Xu, Xu, Xu, Xu, Xu
Xu, Xu, Xu, Xu, Xu, Xu, Xu, Xu, Xu, Xu, Xu, Xu, Xu, Xu, Xu, Xu, Xu, Xu, Xu, Xos, Xos, Xu, Xu, Urb, Xos, Urb, Urb^Bzu, Urb, Uh, Uh, Ur, Uh, Urb, Qxu, Uh, Urb, Xu, Xu, Xu, Xu, Xu, Xu, Xu, Xu, Xu, Xu, Xu, Xu, Xu, Xu, Xu, Xuc, Xu, Xuc, Xu, Xu, Xu, Xu, Xu, Xu, Xu, Xu, Xu, Xu, Xu, Xu, Xu, Xu
Xu, Xu, Xu, Xu, Xu, Xu, Xu, Xu, Xu, Xu, Xu, Xu, Xu, Xu, Xu, Xu, Xu, Xu, Xu, Xu, Xu, Xu, Xu, Xu, Xu, Qxu, Qxu, Urb, Uu^Es, Uh, Uh, Uu, Urb, Qxu, Qxu, Xos, Xos, Xu, Xu, Xu, Xu, Xu, Xu, Xu, Xu, Xu, Xu, Xu, Xu, Xu, Xu, Xuc, Xu, Xuc, Xu, Xu, Xu, Xu, Xu, Xu, Xu, Xu, Xu, Xu, Xu, Xu, Xu, Xu
Xu, Xu, Xu, Xu, Xu, Xu, Xu, Xu, Xu, Xu, Xu, Xu, Xu, Xu, Xu, Xu, Xu, Xu, Xu, Xu, Xu, Xu, Xu, Xu, Xu, Qxu, Xu, Xu, Xu, Uu, Qxu, Qxu, Qxu, Qxu, Qxu, Xos, Xos, Xu, Xu, Xu, Xu, Xu, Xu, Xu, Xu, Xu, Xu, Xu, Xu, Xu, Xu, Xuc, Xu, Xuc, Xu, Xu, Xu, Xu, Xu, Xu, Xu, Xu, Xu, Xu, Xu, Xu, Xu, Xu
Xu, Xu, Xu, Xu, Xu, Xu, Xu, Xu, Xu, Xu, Xu, Xu, Xu, Xu, Xu, Xu, Xu, Xu, Xu, Xu, Xu, Xu, Xu, Xu, Xu, Xu, Xu, Xu, Xu, Xu, Xu, Qxu, Qxu, Qxu, Qxu, Xos, Xu, Xu, Xu, Xu, Xu, Xu, Xu, Xu, Xu, Xu, Xu, Xu, Xu, Xu, Xu, Xuc, Xu, Xuc, Xu, Xu, Xu, Xu, Xu, Xu, Xu, Xu, Xu, Xu, Xu, Xu, Xu, Xu
Xu, Xu, Xu, Xu, Xu, Xu, Xu, Xu, Xu, Xu, Xu, Xu, Xu, Xu, Xu, Xu, Xu, Xu, Xu, Xu, Xu, Xu, Xu, Xu, Xu, Xu, Xu, Xu, Xu, Xu, Xu, Qxu, Qxu, Qxu, Xu, Xu, Xu, Xu, Xu, Xu, Xu, Xu, Xu, Xu, Xu, Xu, Xu, Xu, Xu, Xu, Xu, Xuc, Xu, Xuc, Xu, Xu, Xu, Xu, Xu, Xu, Xu, Xu, Xu, Xu, Xu, Xu, Xu, Xu
Xu, Xu, Xu, Xu, Xu, Xu, Xu, Xu, Xu, Xu, Xu, Xu, Xu, Xu, Xu, Xu, Xu, Xu, Xu, Xu, Xu, Xu, Xu, Xu, Xu, Xu, Xu, Xu, Xu, Xu, Xu, Xu, Xu, Xu, Xu, Xu, Xu, Xu, Xu, Xu, Xu, Xu, Xu, Xu, Xu, Xu, Xu, Xu, Xu, Xu, Xu, Xuc, Xu, Xuc, Xu, Xu, Xu, Xu, Xu, Xu, Xu, Xu, Xu, Xu, Xu, Xu, Xu, Xu
Xu, Xu, Xu, Xu, Xu, Xu, Xu, Xu, Xu, Xu, Xu, Xu, Xu, Xu, Xu, Xu, Xu, Xu, Xu, Xu, Xu, Xu, Xu, Xu, Xu, Xu, Xu, Xu, Xu, Xu, Xu, Xu, Xu, Xu, Xu, Xu, Xu, Xu, Xu, Xu, Xu, Xu, Xu, Xu, Xu, Xu, Xu, Xu, Xu, Xu, Xu, Xuc, Xu, Xuc, Xu, Xu, Xu, Xu, Xu, Xu, Xu, Xu, Xu, Xu, Xu, Xu, Xu, Xu
Xu, Xu, Xu, Xu, Xu, Xu, Xu, Xu, Xu, Xu, Xu, Xu, Xu, Xu, Xu, Xu, Xu, Xu, Xu, Xu, Xu, Xu, Xu, Xu, Xu, Xu, Xu, Xu, Xu, Xu, Xu, Xu, Xu, Xu, Xu, Xu, Xu, Xu, Xu, Xu, Xu, Xu, Xu, Xu, Xu, Xu, Xu, Xu, Xu, Xu, Xu, Xuc, Xu, Xuc, Xu, Xu, Xu, Xu, Xu, Xu, Xu, Xu, Xu, Xu, Xu, Xu, Xu, Xu
Xu, Xu, Xu, Xu, Xu, Xu, Xu, Xu, Xu, Xu, Xu, Xu, Xu, Xu, Xu, Xu, Xu, Xu, Xu, Xu, Xu, Xu, Xu, Xu, Xu, Xu, Xu, Xu, Xu, Xu, Xu, Xu, Xu, Xu, Xu, Xu, Xu, Xu, Xu, Xu, Xu, Xu, Xu, Xu, Xu, Xu, Xu, Xu, Xu, Xu, Xu, Xuc, Xu, Xuc, Xu, Xu, Xu, Xu, Xu, Xu, Xu, Xu, Xu, Xu, Xu, Xu, Xu, Xu
Xu, Xu, Xu, Xu, Xu, Xu, Xu, Xu, Xu, Xu, Xu, Xu, Xu, Xu, Xu, Xu, Xu, Xu, Xu, Xu, Xu, Xu, Xu, Xu, Xu, Xu, Xu, Xu, Xu, Xu, Xu, Xu, Xu, Xu, Xu, Xu, Xu, Xu, Xu, Xu, Xu, Xu, Xu, Xu, Xu, Xu, Xu, Xu, Xu, Xu, Xu, Xuc, Xu, Xuc, Xu, Xu, Xu, Xu, Xu, Xu, Xu, Xu, Xu, Xu, Xu, Xu, Xu, Xu
Xu, Xu, Xu, Xu, Xu, Xu, Xu, Xu, Xu, Xu, Xu, Xu, Xu, Xu, Xu, Xu, Xu, Xu, Xu, Xu, Xu, Xu, Xu, Xu, Xu, Xu, Xu, Xu, Xu, Xu, Xu, Xu, Xu, Xu, Xu, Xu, Xu, Xu, Xu, Xu, Xu, Xu, Xu, Xu, Xu, Xu, Xu, Xu, Xu, Xu, Xu, Xuc, Xu, Xuc, Xu, Xu, Xu, Xu, Xu, Xu, Xu, Xu, Xu, Xu, Xu, Xu, Xu, Xu
