Xu, Xu, Xu, Xu, Xu, Xu, Xu, Xu, Xu, Xu, Xu, Xu, Xu, Xu, Xu, Xu, Xu, Xu, Xu, Xu, Xu, Xu, Xu, Xu, Xu, Xu, Xu, Xu, Xu, Xu, Xu, Xu, Xu, Xu, Xu, Xu, Xu, Xu, Xu, Xu, Xos, Xu, Xu, Xu, Xu, Xu, Xu, Xu, Xu, Xu, Xu, Xu, Xu, Xu, Xu, Xu, Xu, Xu, Xu, Xu, Xu, Xu, Xu, Xu, Xu, Xu, Xu, Xu
Xu, Xu, Xu, Xu, Xu, Xu, Xu, Xu, Xu, Xu, Xu, Xu, Xu, Xu, Xu, Xu, Xu, Xu, Xu, Xu, Xu, Xu, Xu, Xu, Xu, Xu, Xu, Xu, Xu, Xu, Xu, Xu, Xu, Xu, Xu, Xu, Xu, Xu, Tb^Tf, Xos, Xot^Xzm\, Xos, Xos, Xu, Xu, Xu, Xu, Xu, Xu, Xu, Xu, Xu, Xu, Xu, Xu, Xu, Xu, Xu, Xu, Xu, Xu, Xu, Xu, Xu, Xu, Xu, Xu, Xu
Xu, Xu, Xu, Xu, Xu, Xu, Xu, Xu, Xu, Xu, Xu, Xu, Xu, Xu, Xu, Xu, Xu, Xu, Xu, Xu, Xu, Xu, Xu, Xu, Xu, Xu, Xu, Xu, Xu, Xu, Xu, Xu, Xu, Xu, Xos, Xu, Uh, Uh, Tb^Tf, Tb^Tf, Uh, Xos, Xos^Xzm\, Xos, Xu, Xu, Xu, Xu, Xu, Xu, Xu, Xu, Xu, Xu, Xu, Xu, Xu, Xu, Xu, Xu, Xu, Xu, Xu, Xu, Xu, Xu, Xu, Xu
Xu, Xu, Xu, Xu, Xu, Xu, Xu, Xu, Xu, Xu, Xu, Xu, Xu, Xu, Xu, Xu, Xu, Xu, Xu, Xu, Xu, Xu, Xu, Xu, Xu, Xu, Xu, Xu, Xu, Xu, Xu, Xu, Xu, Xos, Xos, Xos, Uu^Tf, Uh, Uu^Ii, Uu^Tf, Tb^Tf, Uh, Xu, Xuc, Xuc, Xu, Xu, Xu, Xu, Xu, Xu, Xu, Xu, Xu, Xu, Xu, Xu, Xu, Xu, Xu, Xu, Xu, Xu, Xu, Xu, Xu, Xu, Xu
Xu, Xu, Xu, Xu, Xu, Xu, Xu, Xu, Xu, Xu, Xu, Xu, Xu, Xu, Xu, Xu, Xu, Xu, Xu, Xu, Xu, Xu, Xu, Xu, Xu, Xu, Xu, Xu, Xu, Xu, Xu, Xu, Xos, Xos, Xos, Cud, Yhr^Emf, Uu^Tf, Yhr, Yhr^Xp, Uu^Tf, Uh, Ss, Uh, Uh, Xu, Xu, Xu, Xu, Xu, Xu, Xu, Xu, Xu, Xu, Xu, Xu, Xu, Xu, Xu, Xu, Xu, Xu, Xu, Xu, Xu, Xu, Xu
Xu, Xu, Xu, Xu, Xu, Xu, Xu, Xu, Xu, Xu, Xu, Xu, Xu, Xu, Xu, Xu, Xu, Xu, Xu, Xu, Xu, Xu, Xu, Xu, Xu, Xu, Xu, Xu, Xu, Xu, Xu, Xos, Xot, Xos^Xzm/, Yhr^Xp, Yhr^Xp, Yhr, Yhr^Em, Cud, Yhr^Xp, Xu, Ss, Ss, Ss, Uh, Xuc, Xu, Xu, Xu, Xu, Xu, Xu, Xu, Xu, Xu, Xu, Xu, Xu, Xu, Xu, Xu, Xu, Xu, Xu, Xu, Xu, Xu, Xu
Xu, Xu, Xu, Xu, Xu, Xu, Xu, Xu, Xu, Xu, Xu, Xu, Xu, Xu, Xu, Xu, Xu, Xu, Xu, Xu, Xu, Xu, Xu, Xu, Xu, Xu, Xu, Xu, Xu, Xu, Xu, Xos, Xos, Yhr^Xp, Yhr, Yhr, Xos, Xos, Xos, Xu, Xu, Ss, Uh, Uu, Xu, Xu, Xu, Xu, Xu, Xu, Xu, Xu, Xu, Xu, Xu, Xu, Xu, Xu, Xu, Xu, Xu, Xu, Xu, Xu, Xu, Xu, Xu, Xu
Xu, Xu, Xu, Xu, Xu, Xu, Xu, Xu, Xu, Xu, Xu, Xu, Xu, Xu, Xu, Xu, Xu, Xu, Xu, Xu, Xu, Xu, Xu, Xu, Xu, Xu, Xu, Xu, Xu, Xu, Xuc, Xu, Xu, Yhr, Yhr, Xos, Xu, Xos, Xos, Xu, Xu, Xu, Xu, Xu, Xu, Xu, Xu, Xu, Xu, Xu, Xu, Xu, Xu, Xu, Xu, Xu, Xu, Xu, Xu, Xu, Xu, Xu, Xu, Xu, Xu, Xu, Xu, Xu
Xu, Xu, Xu, Xu, Xu, Xu, Xu, Xu, Xu, Xu, Xu, Xu, Xu, Xu, Xu, Xu, Xu, Xu, Xu, Xu, Xu, Xu, Xu, Xu, Xu, Xu, Xu, Xu, Xu, Xuc, Uh, Uh, Yhr, Yhr, Yhr, Xu, Xuc, Xu, Xu, Xu, Xu, Xu, Xu, Xu, Xos, Xos, Xos, Xu, Xu, Xu, Xu, Xu, Xu, Xu, Xu, Xu, Xu, Xu, Xu, Xu, Xu, Xu, Xu, Xu, Xu, Xu, Xu, Xu
Xu, Xu, Xu, Xu, Xu, Xu, Xu, Xu, Xu, Xu, Xu, Xu, Xu, Xu, Xu, Xu, Xu, Xu, Xu, Xu, Xu, Xu, Xu, Xu, Xu, Xu, Xu, Xu, Xu, Xu, Yhr, Yhr^Xp, Yhr, Yhr, Yhr, Uh, Yhr, Xu, Xos, Xos, Xos, Xu, Xu, Xos, Xos, Xos, Xos, Xos, Xos, Xu, Xu, Xu, Xu, Xu, Xu, Xu, Xu, Xu, Xu, Xu, Xu, Xu, Xu, Xu, Xu, Xu, Xu, Xu
Xu, Xu, Xu, Xu, Xu, Xu, Xu, Xu, Xu, Xu, Xu, Xu, Xu, Xu, Xu, Xu, Xu, Xu, Xu, Xu, Xu, Xu, Xu, Xu, Xu, Xu, Xu, Xu, Xu, Xu, Xos, Uh, Yhr^Xp, Yhr, Yhr, Yhr, Yhr, Yhr, Cud, Xos, Xos, Xu, Xu, Xos, Xos, Xos, Xos, Xos, Xos, Xos, Xos, Xu, Xu, Xu, Xu, Xu, Xu, Xu, Xu, Xu, Xu, Xu, Xu, Xu, Xu, Xu, Xu, Xu
Xu, Xu, Xu, Xu, Xu, Xu, Xu, Xu, Xu, Xu, Xu, Xu, Xu, Xu, Xu, Xu, Xu, Xu, Xu, Xu, Xu, Xu, Xu, Xu, Xu, Xu, Xu, Xu, Xu, Xu, Xu, Xos, Cud, Yhr, Yhr, Yhr, Cud, Cud, Yhl, Yhl, Yhl, Xu, Xu, Xu, Xos, Xos, Xos, Wwb, Wwb, Xos, Xos, Xos, Xos, Xu, Xu, Xu, Xu, Xu, Xu, Xu, Xu, Xu, Xu, Xu, Xu, Xu, Xu, Xu
Xu, Xu, Xu, Xu, Xu, Xu, Xu, Xu, Xu, Xu, Xu, Xu, Xu, Xu, Xu, Xu, Xu, Xu, Xu, Xu, Xu, Xu, Xu, Xu, Xu, Xu, Xu, Xu, Qlf, Xu, Xu, Xos, Yhl, Cud, Cud, Xos, Xos, Yhl, Yhl, Yhl, Yhl, Uh, Xu, Xu, Xu, Xos, Xos, Xos, Xos, Wwb^Pr/, Wwb, Xos, Xos, Xos, Xos, Xu, Xu, Xu, Xu, Xu, Xu, Xu, Xu, Xu, Xu, Xu, Xu, Xu
Xu, Xu, Xu, Xu, Xu, Xu, Xu, Xu, Xu, Xu, Xu, Xu, Xu, Xu, Xu, Xu, Xu, Xu, Xu, Xu, Xu, Xu, Xu, Xu, Xu, Xu, Qlf, Xu, Xu, Cud, Yhl^Xp, Yhl, Yhl, Yhl, Yhl, Xos, Xos, Xos, Xos, Yhl, Yhl, Uu^Vyv, Xu, Xu, Xu, Xos, Xos, Xos, Xos, Xos, Yhl, Wwb, Wwb, Xos, Xos, Xos, Xos, Xu, Xu, Xu, Xu, Xu, Xu, Xu, Xu, Xu, Xu, Xu
Xu, Xu, Xu, Xu, Xu, Xu, Xu, Xu, Xu, Xu, Xu, Xu, Xu, Xu, Xu, Xu, Xu, Xu, Xu, Xu, Xu, Xu, Xu, Xu, Qlf, Xu, Xu, Cud, Yhl^Xp, Yhl^Xp, Yhl, Yhl, Yhl, Yhl, Yhl, Xos, Xos, Xos, Xos, Yhl, Yhl, Uh, Uu^Vu, Xu, Xu, Xu, Uh, Uh, Uh, Tb^Tf, Uu^Tf, Yhl, Xos, Wwb^Pr/, Wwb, Xos, Xos, Xos, Xos, Xu, Xu, Xu, Xu, Xu, Xu, Xu, Xu, Xu
Xu, Xu, Xu, Xu, Xu, Xu, Xu, Xu, Xu, Xu, Xu, Xu, Xu, Xu, Xu, Xu, Xos, Xos, Xos, Xu, Xu, Xu, Qlf, Xu, Xu, Cud, Yhl^Xp, Yhl^Xp, Yhl, Yhl, Yhl, Yhl, Xu, Xu, Xu, Xos, Xu, Xu, Xu, Yhl, Yhl, Yhl, Yhl, Uh, Yhl^Xp, Yhl^Xp, Uue^Tf, Tb^Tf, Tb^Tf, Tb^Tf, Uh, Xos, Xos, Xos, Xos, Wwb, Xos, Xos, Xos, Xos, Xu, Xu, Xu, Xu, Xu, Xu, Xu, Xu
Xu, Xu, Xu, Xu, Xu, Xu, Xu, Xu, Xu, Xu, Xu, Xu, Xu, Xu, Xos, Xos, Xos, Xos, Xos, Xos, Xos, Xos, Xos, Cud, Yhl^Xp, Yhl^Xp, Yhl, Yhl, Yhl, Yhl, Xos, Xos, Xos, Xu, Xu, Xu, Xu, Xu, Xu, Uh, Uue^Tf, Uue, Uue, Yhl, Yhl, Yhl, Yhl, Uue^Emf, Uue, Uh, Xos, Xos, Xu, Xos, Xos, Xos, Xos, Xos, Xu, Xu, Xu, Xu, Xu, Xu, Xu, Xu, Xu, Xu
Xu, Xu, Xu, Xu, Xu, Xu, Xu, Xu, Xu, Xu, Xu, Xu, Xos, Xos, Xos, Xos, Ur^Br\, Uu, Uu, Xos, Xos, Xos, Xos^Xzm/, Xos, Yhl, Yhl, Yhl, Yhl, Xos, Yhl^Pr/, Yhl, Xos, Xos, Xos, Xos, Xos, Xos, Xu, Uu^Vu, Uh, Tb^Tf, Uue^Em, Uue^Tf, Yhl, Yhl, Yhl, Yhl, Yhl^Em, Uu, Yhl^Xp, Xos, Xu, Xu, Xu, Xu, Xos, Xu, Xu, Xu, Xu, Xu, Xu, Xu, Xu, Xu, Xu, Xu, Xu
Xu, Xu, Xu, Xu, Xu, Xu, Xu, Xu, Xu, Xu, Xu, Xu, Xu, Xos, Xos, Uu, Uu, Ur^Br\, Ur^Pr/, Uu^Pr/, Uu^Emf, Xot^Xzm/, Yhr, Yhl, Yhl, Yhl, Xos, Xos, Xos, Yhl, Yhl, Yhl, Xos, Xos, Xos, Xos, Xos, Xos, Xos, Tb^Tf, Uh, Uh, Xu, Yhl, 1 Yhl, Yhl, Yhl, Uh, Uh, Yhl, Qxu, Qxu, Qxu, Xu, Xu, Xu, Xu, Xu, Xu, Xu, Xu, Xu, Xu, Xu, Xu, Xu, Xu, Xu
Xu, Xu, Xu, Xu, Xu, Xu, Xu, Xu, Xu, Xu, Xu, Xu, Xu, Xu, Xu, Xos, Xos, Uu^Pr/, Uu, Ur^Br\, Ur^Br\, Yhr, Yhr, Yhl, Xos, Yhl^Pr/, Yhl, Yhl, Yhl, Xos, Xos, Xos, Xos, Xos, Xos, Xos, Xos, Xos, Xos, Xos, Xos, Xu, Xu, Xu, Yhl, Yhl, Yhl^Emf, Uu^Tf, Uh, Yhl, Yhl, Qxu, Qxu, Xos, Xos, Xu, Xu, Xu, Xu, Xu, Xu, Xu, Xu, Xu, Xu, Xu, Xu, Xu
Xu, Xu, Xu, Xu, Xu, Xu, Xu, Xu, Xu, Xu, Xu, Xu, Xu, Xu, Xu, Xu, Xu, Xos, Uu^Tf, Yhr^Xp, Yhr^Xp, Ur^Br\, Yhr, Xos, Xos, Xos, Xos, Yhl, Xos, Xos, Xos, Xos, Xos, Xos, Xos, Xos, Uu, Uu, Uu, Xos, Xos, Xos, Xos, Xos, Yhl, Xos, Xos, Tb^Tf, Tb^Tf, Yhl, Yhl, Yhl, Yhl, Xos, Xom, Xos, Xos, Xu, Xu, Xu, Xu, Xu, Xu, Xu, Xu, Xu, Xu, Xu
Xu, Xu, Xu, Xu, Xu, Xu, Xu, Xu, Xu, Xu, Xu, Xu, Xu, Xu, Ss, Ss, Ss, Uh, Uh, Tb^Tf, Yhr^Xp, Ur^Br|, Uu, Xos, Xos, Xos, Xos, Xos, Xos, Xos, Uu, Xos, Xos, Xos, Xos, Xu, Uu, Urb^Ii, Uu, Xu, Xu, Xos, Xos, Xos, Yhl, Xos, Xos, Xos, Xos, Yhl, Yhl, Yhl, Cud, Cud, Yhl, Xom, Xos, Xos, Xos, Xuc, Xu, Xu, Xu, Xu, Xu, Xu, Xu, Xu
Xu, Xu, Xu, Xu, Xu, Xu, Xu, Xu, Xu, Xu, Xu, Xu, Xu, Xu, Ss, Ss, Xu, Ss, Xu, Uu^Tf, Uu, Ur^Br|, Uu, Xos, Xos^Xzm\, Xos, Xos, Xos, Uu, Ur^Br\, Ur^Br\, Uu, Uu^Pr/, Xos, Xos^Xzm\, Xu, Xu, Uu, Uu, Xu, Xu, Xos, Xos, Xos^Zok, Yhl^Zok, Xos^Zok, Xos, Xos, Xos, Xos, Xos, Cud, Yhl, Yhl, Yhl^Xp, Yhl, Xom, Xot, Yhl^Xp, Uh, Xu, Xu, Xu, Xu, Xu, Xu, Xu, Xu
Xu, Xu, Xu, Xu, Xu, Xu, Xu, Xu, Xu, Xu, Xu, Xu, Xu, Xu, Xu, Ss, Xu, Xu, Xos, Xos, Uh, Ur^Br\, Ur^Br\, Uu^Tf, Uh, Xom, Xom, Xos, Xos, Uu, Uu^Pr/, Ur^Pr/, Ur^Br\, Uu, Uu, Xu, Xu, Qlf, Xu, Xu, Xu, Xos, Xos, Xos^Zok, Yhl^Zok, Xos^Zok, Xos, Xos, Xos, Xos, Xos, Xos, Xos, Yhl, Yhl^Xp, Yhl, Yhl, Yhl, Yhl^Xp, Uh, Xu, Xu, Xu, Xu, Xu, Xu, Xu, Xu
Xu, Xu, Xu, Xu, Xu, Xu, Xu, Xu, Xu, Xu, Xu, Xu, Xu, Xu, Xu, Xu, Xos, Xos, Uu^Pr\, Uu, Ur^Br/, Ur^Br/, Uu^Emf, Ur^Br\, Ur^Br\, Uh, Uu^Zz/, Xom, Xos, Xos, Xos, Uu^Emf, Uu^Em, Ur^Br\, Ur^Br\, Uu, Xu, Qlf^Xo, Xu, Xu, Xu, Xos, Xos, Xos^Zok, Xos^Zok, Xos^Zok, Xos, Xos, Xos, Xos, Xos, Xot, Uh, Yhl, Yhl, Yhl, Yhl, Yhl, Xos, Xu, Xu, Xu, Xu, Xu, Xu, Xu, Xu, Xu
Xu, Xu, Xu, Xu, Xu, Xu, Xu, Xu, Xu, Xu, Xu, Xu, Xu, Xu, Xos, Xos, Uu, Uu, Ur^Br/, Ur^Pr\, Uu^Pr\, Uu^Tf, Xos, Uu, Uu^Zz/, Ur^Zz/, Ur^Br\, Uu^Em, Xos, Xos, Ur, Uu^Em, Xos, Uu, Uu, Uu^Br\, Uu^Br\, Uu, Uh, Xuc, Xuc, Xu, Xu, Xos, Xos, Xos, Xos, Xos, Xos, Xos, Xos, Xos, Uu^Ii, Yhl, Yhr, Yhr, Uu^Ii, Uu^Vyv, Xom, Xos, Xos, Xu, Xu, Xu, Xu, Xu, Xu, Xu
Xu, Xu, Xu, Xu, Xu, Xu, Xu, Xu, Xu, Xu, Xu, Xu, Xu, Xos, Xos, Xos, Xos, Ur^Br/, Uu, Uu, Xos, Xos, Xos, Xos, Xos, Uu, Ur^Br|, Uu, Ur, Uu, Xos, Xos, Xos, Xos, Xu, Uu, Uu, Qxu, Qxu, Ur, Ur, Xu, Xu, Xu, Xu, Xos, Xos, Xos, Xos, Xos, Xos, Uh, Uu, Yhl, Urb, Yhr, Uu^Vud, Uh, Uh, Xom, Xos, Xos, Xos, Xu, Xu, Xu, Xu, Xu
Xu, Xu, Xu, Xu, Xu, Xu, Xu, Xu, Xu, Xu, Xu, Xu, Xu, Xu, Xu, Xos, Xos, Xos, Xos, Xos, Xos, Xos, Xos, Xos, Xos, Uh, Ur^Br|, Ur^Br\, Ur^Br\, Xos, Xos^Xzm\, Xos, Xos, Xu, Xu, Qlf, Qxu, Qxu, Qxu, Uh, Wwf, Wwf, Wwrg, Xu, Xu, Xu, Xu, Xos, Xos, Xos, Xos, Xos, Xom, Uu^Ii, Urb, Uu^Ii, Uh, Uh, Uu, Uu, Qlf^Xo, Xos, Xos, Xos, Xos, Xu, Xu, Xu
Xu, Xu, Xu, Xu, Xu, Xu, Xu, Xu, Xu, Xu, Xu, Xu, Xu, Xu, Xu, Xu, Xu, Xos, Xos, Xos, Xos, Xos, Xos, Xos, Uu^Pr\, Uh, Ur^Br/, Ur^Br\, Ur^Br\, Ur^Br\, Ur^Pr/, Xos, Xos, Xu, Xu, Qlf, Qlf, Qxu, Xu, Wwf, Wwg, Uu^Tf, Wwf, Xu, Xu, Xu, Xu, Xu, Xos, Xos, Xos, Xom, Urb, Urb, Urb, Uu^Vud, Xos, Uu, Qlf^Xo, Qlf^Xo, Uu, Uu, Uu, Xos, Xos, Xos, Xos, Xu
Xu, Xu, Xu, Xu, Xu, Xu, Xu, Xu, Xu, Xu, Xu, Xu, Xu, Xu, Xu, Xu, Xu, Xu, Xu, Xos, Xos, Xos, Uu, Uu, Ur^Br/, Ur^Pr\, Uu^Pr\, Uu, Xos, Ur^Pr/, Ur^Br\, Ur^Br\, Ur^Br\, Xu, Xu, Xu, Qlf^Xo, Xu, Xuc, Uu^Tf, Uu^Tf, Ur^Em, Uh, Wwf, Xos, Xos, Xos, Xos, Xom, Xom, Urb, Urb^Zz\, Urb^Zz\, Urb, Urb, Uh, Xos, Xos, Xos, Uu, Uu, Urb^Ii, Uu, Uu, Xos, Xos, Xos, Xos
Xu, Xu, Xu, Xu, Xu, Xu, Xu, Xu, Xu, Xu, Xu, Xu, Xu, Xu, Xu, Xu, Xu, Xu, Xu, Xu, Xos, Xos, Xos, Ur^Br/, Uu, Uu, Xos, Xos, Xos, Xos, Xu, Ur^Br\, Xu, Xu, Xu, Xu, Qlf, Xu, Xuc, Tb^Tf, Uh, Ur, Uu, Uh, Xos, Xos, Xos, Xos, Rb, Urb, Urb, Rb, Rb, Urb^Zz\, Xos, Xos, Xos, Xos, Xos, Xos, Xos, Uu, Xos, Xos, Xos, Xos, Xu, Xu
Xu, Xu, Xu, Xu, Xu, Xu, Xu, Xu, Xu, Xu, Xu, Xu, Xu, Xu, Xu, Xu, Xu, Xu, Xu, Xu, Xu, Xos, Xos, Xos, Xos, Xos, Xos, Xos, Xu, Xu, Xu, Xu, Xu, Xu, Qlf, Qlf, Xu, Xu, Xu, Xuc, Xu, Uh, Xos, Xos, Xos, Xos, Urb, Wwrg, Wwf, Rb^Em, Urb, Urb, Rb, Xos, Xos, Xos, Xos, Xos, Xos, Xos, Xos, Xos, Xos, Xos, Xu, Xu, Xu, Xu
Xu, Xu, Xu, Xu, Xu, Xu, Xu, Xu, Xu, Xu, Xu, Xu, Xu, Xu, Xu, Xu, Xu, Xu, Xu, Xu, Xu, Xu, Xu, Xos, Xos, Xos, Xu, Xu, Xu, Xu, Uu, Uu, Uu, Qlf, Xu, Xu, Xu, Xu, Xu, Xu, Xu, Xos, Xos, Xos, Urb, Urb, Xuc, Wwg, Rb, Rb, Wwf, Xuc, Xuc, Wwf, Uh, Xos, Xos, Xos, Xu, Xu, Xu, Xos, Xu, Xu, Xu, Xu, Xu, Xu
Xu, Xu, Xu, Xu, Xu, Xu, Xu, Xu, Xu, Xu, Xu, Xu, Xu, Xu, Xu, Xu, Xu, Xu, Xu, Xu, Xu, Xu, Xu, Xu, Xu, Xu, Xu, Xu, Xu, Xu, Uu, Urb^Ii, Uu, Uu, Xu, Xu, Xu, Xu, Xu, Xu, Xu, Xos, Uh, Uh, Urb, Xuc, Urb, Wwf, Rb^Em, Xuc, Xuc, Urb, Urb, Uu^Tf, Xuc, Xu, Xu, Xu, Xu, Xu, Xu, Xu, Xu, Xu, Xu, Xu, Xu, Xu
Xu, Xu, Xu, Xu, Xu, Xu, Xu, Xu, Xu, Xu, Xu, Xu, Xu, Xu, Xu, Xu, Xu, Xu, Xu, Xu, Xu, Xu, Xu, Xu, Xu, Xu, Xu, Xu, Xu, Xu, Xu, Uu, Qlf, Xu, Xu, Xu, Xu, Xu, Xu, Xu, Xu, Xu, Uh, Xu, Wwf, Urb, Urb, Xuc, Xuc, Rb, Rb, Rb, Xu, Uh, Wwrg, Xuc, Xu, Xu, Xu, Xu, Xu, Xu, Xu, Xu, Xu, Xu, Xu, Xu
Xu, Xu, Xu, Xu, Xu, Xu, Xu, Xu, Xu, Xu, Xu, Xu, Xu, Xu, Xu, Xu, Xu, Xu, Xu, Xu, Xu, Xu, Xu, Xu, Xu, Xu, Xu, Xu, Xu, Xu, Xu, Xu, Xu, Qlf, Qlf, Xu, Xu, Xu, Xu, Xu, Xu, Xu, Xu, Xu, Wwg, Xuc, Xuc, Rb^Tf, Rb^Em, Xuc, Xu, Uh, Uu, Xu, Wwg, Xuc, Xu, Xu, 5 Cte^Es, Xu, Xu, Xu, Xu, Xu, Xu, Xu, Xu, Xu
Xu, Xu, Xu, Xu, Xu, Xu, Xu, Xu, Xu, Xu, Xu, Xu, Xu, Xu, Xu, Xu, Xu, Xu, Xu, Xu, Xu, Xu, Xu, Xu, Xu, Xu, Xu, Xu, Xu, Xu, Xu, Xu, Xu, Xu, Xu, Qlf, Qlf, Xu, Xu, Xu, Xu, Xu, Xu, Xu, Xu, Wwrg, Uu, Rb^Em, Xuc, Xu, Xuc, Uu, Xu, Wwf^Es, Uu, Xu, Xu, Cte, Wwrg, Wwrg, Uu^Tf, Xu, Xu, Xu, Xu, Xu, Xu, Xu
Xu, Xu, Xu, Xu, Xu, Xu, Xu, Xu, Xu, Xu, Xu, Xu, Xu, Xu, Xu, Xu, Xu, Xu, Xu, Xu, Xu, Xu, Xu, Xu, Xu, Xu, Xu, Xu, Xu, Xu, Xu, Xu, Xu, Xu, Xu, Xu, Xu, Qlf, Qlf^Xo, Xu, Xu, Xu, Uh, Xu, Xu, Xu, Rb, Uu, Rb, Xu, Wwg, Wwf, Xu, Xu, Uu^Tf, Uu, Uu^Em, Uu^Tf, Tb^Tf, Uh, Uu^Emf, Xu, Xos, Xu, Xu, Xu, Xu, Xu
Xu, Xu, Xu, Xu, Xu, Xu, Xu, Xu, Xu, Xu, Xu, Xu, Xu, Xu, Xu, Xu, Xu, Xu, Xu, Xu, Xu, Xu, Xu, Xu, Xu, Xu, Xu, Xu, Xu, Xu, Xu, Xu, Xu, Xu, Xu, Xu, Xu, Xu, Xu, Qlf^Xo, Qlf^Xo, Uh, Uh, Xu, Xu, Xu, Uu, Uu^Tf, Xu, Uu, Wwrg, Xu, Xu, Xu, Rb, Rb, Uu, Uu^Emf, Uh, Uh, Uh, Uh, Xos, Xos, Xu, Xu, Xu, Xu
Xu, Xu, Xu, Xu, Xu, Xu, Xu, Xu, Xu, Xu, Xu, Xu, Xu, Xu, Xu, Xu, Xu, Xu, Xu, Xu, Xu, Xu, Xu, Xu, Xu, Xu, Xu, Xu, Xu, Xu, Xu, Xu, Xu, Xu, Xu, Xu, Xu, Xu, Xu, Uh, Uh, Qlf^Xo, Qlf^Xo, Xu, Urb, Uu, Uu, Xu, Xu, Xu, Xu, Wwf, Uu, Uu, Xu, Rb^Es, Uu, Uu, Uu, Xu, Uh, Uh, Xos, Xos, Xu, Xu, Xu, Xu
Xu, Xu, Xu, Xu, Xu, Xu, Xu, Xu, Xu, Xu, Xu, Xu, Xu, Xu, Xu, Xu, Xu, Xu, Xu, Xu, Xu, Xu, Xu, Xu, Xu, Xu, Xu, Xu, Xu, Xu, Xu, Xu, Xu, Xu, Uh, Uh, Xu, Xu, Uh, Uh, Uu, Qlf^Xo, Qlf^Xo, Xu, Xu, Rb^Em, Rb, Uu, Rb, Uu^Tf, Xu, Wwf, Xu, Xu, Uu, Xu, Uu, Uu, Uu, Uh, Xu, Xu, Xu, Xu, Xu, Xu, Xu, Xu
Xu, Xu, Xu, Xu, Xu, Xu, Xu, Xu, Xu, Xu, Xu, Xu, Xu, Xu, Xu, Xu, Xu, Xu, Xu, Xu, Xu, Xu, Xu, Xu, Xu, Xu, Xu, Xu, Xu, Xu, Xu, Xu, Xu, Xu, Uh, Uh, Urb, Uh, Urb, Urb, Uh, Qlf^Xo, Qlf^Xo, Xu, Xu, Rb^Emf, Uu, Xu, Xu, Uu^Tf, Wwf, Xu, Xu, Xu, Uu^Ii, Uu, Xu, Xu, Rb^Em, Rb, Cte^Es, Xu, Xu, Xu, Xu, Xu, Xu, Xu
Xu, Xu, Xu, Xu, Xu, Xu, Xu, Xu, Xu, Xu, Xu, Xu, Xu, Xu, Xu, Xu, Xu, Xu, Xu, Xu, Xu, Xu, Xu, Xu, Xu, Xu, Xu, Xu, Xu, Xu, Xu, Xu, Xos, Xu, Urb, Uh, Urb, Urb, Urb, Uh, Xu, Uh, Uh, Qlf^Xo, Qlf^Xo, Xu, Xu, Uu, Xu, Xu, Wwrg, Uu, Xu, Xu, Xu, Uu, Xu, Xu, Xu, Rb, Cte^Es, 6 Cte, Xu, Xu, Xu, Xu, Xu, Xu
Xu, Xu, Xu, Xu, Xu, Xu, Xu, Xu, Xu, Xu, Xu, Xu, Xu, Xu, Xu, Xu, Xu, Xu, Xu, Xu, Xu, Xu, Xu, Xu, Xu, Xu, Xu, Xu, Xuc, Xu, Uh, Xuc, Uh, Xos, Xos, Urb, Urb, Urb, Uh, Uh, Xu, Uh, Xu, Uh, Qlf^Xo, Xu, Xu, Xu, Xu, Wwrg, Uh, Uh, Rb^Es, Xu, Xu, Xu, Uu^Tf, Tb^Tf, Uu, Uu, Xu, Xu, Xu, Xu, Xu, Xu, Xu, Xu
Xu, Xu, Xu, Xu, Xu, Xu, Xu, Xu, Xu, Xu, Xu, Xu, Xu, Xu, Xu^Zok, Xu, Xu, Xu, Xu, Xu, Xu, Xu, Xos, Xos, Xos, Xu, Xu, Xuc, Qxu, Qxu, Uu, Ur^Es, Cte, Uh, Urb, Xos, Xos, Xu, Xu, Uh, Xu, Xu, Xu, Xu, Qlf^Xo, Xu, Xu, Xu, Xu, Xu, Uu^Emf, Uu^Em, Uu, Rb, Uu, Uu, Rb, Uu^Tf, Uu, Uh, Xos, Xu, Xu, Xu, Xu, Xu, Xu, Xu
Xu, Xu, Xu, Xu, Xu, Xu, Xu, Xu, Xu, Xu, Xu, Xu, Xu^Zok, Xu^Zok, Urb^Zok, Xos^Zok, Xos^Zok, Xu, Xu, Xu, Xos, Xos, Xos, Xos, Xos, Xos, Qxu, Cte, Uu, Qxu, Urb, Ur^Es, Urb, Urb, Urb, Uu, Uh, Xos, Xom, Xu, Xu, Xu, Xu, Xu, Xu, Qlf, Qlf, Xu, Xu, Uu^Tf, Uu^Emf, Uu^Em, Cte^Es, Wwf, Wwf, Uu, Xu, Uu, Xos, Xos, Xos, Xos, Xu, Xu, Xu, Xu, Xu, Xu
Xu, Xu, Xu, Xu, Xu, Xu, Xu, Xu, Xu, Xu, Xu, Xu, Xu, Xos^Zok, Xos^Zok, Urb^Zok, Urb, Xos, Xos^Xzm\, Xos, Xom^Xzm/, Xos, Uh, Xos, Xos, Xos, Urb^Es, Urb^Es, Uu^Es, Cud, Urb, Urb^Eb, Urb, Urb, Urb, Urb, Uh, Uh, Uh, Xom, Xos, Xu, Xu, Xu, Xu, Xu, Qlf, Xu, Xu, Xu, Xuc, Cte^Es, 4 Cte^Es, Cte, Xuc, Xu, Xu, Xos, Xos, Xos, Xu, Xu, Xu, Xu, Xu, Xu, Xu, Xu
Xu, Xu, Xu, Xu, Xu, Xu, Xu, Xu, Xu, Xu, Xu, Xu, Xu, Xu, Xu, Xos, Xos, Urb^Xo, Urb^Pw/o, Xom^Xzm\, Urb, Urb, Uu^Emf, Uu, Xos, Urb, Urb, Urb^Es, Qxu, Cud, Cud, Urb, Urb, Urb, Urb, Urb, Urb, Cte, Ur, Xos, Xos, Xu, Xu, Xu, Xu, Xu, Uu, Xu, Xu, Xu, Xu, Xuc, Xu, Xuc, Xu, Xu, Xu, Xu, Xu, Xu, Xu, Xu, Xu, Xu, Xu, Xu, Xu, Xu
Xu, Xu, Xu, Xu, Xu, Xu, Xu, Xu, Xu, Xu, Xu, Xu, Xu, Xu, Xu, Xu, Xu, Xos, Xos, Urb, Urb, Cud, Uu^Tf, Ur^Es, Xos, Urb, Cud, Urb, Qxu, Tb^Tf, Ur^Em, Urb, Urb, Urb, Urb, Urb^Eb, Uh, Uu, Uu, Xos, Xos, Xu, Xu, Xu, Xu, Uu, Urb^Ii, Uu, Xu, Xu, Xu, Xuc, Xu, Xuc, Xu, Xu, Xu, Xu, Xu, Xu, Xu, Xu, Xu, Xu, Xu, Xu, Xu, Xu
Xu, Xu, Xu, Xu, Xu, Xu, Xu, Xu, Xu, Xu, Xu, Xu, Xu, Xu, Xu, Xu, Xu, Xos, Xos, Cud, Ur^Es, Uu^Em, 3 Ur^Em, Ur^Em, Xos, Urb, Urb, Qxu, Urb, Uu^Tf, Uu, Urb, Urb, Urb, Urb, Urb, Uu^Tf, Uh, Uh, Xos, Xu, Xu, Xu, Xu, Xu, Uu, Uu, Uu, Xu, Xu, Xu, Xuc, Xu, Xuc, Xu, Xu, Xu, Xu, Xu, Xu, Xu, Xu, Xu, Xu, Xu, Xu, Xu, Xu
Xu, Xu, Xu, Xu, Xu, Xu, Xu, Xu, Xu, Xu, Xu, Xu, Xu, Xu, Xu, Xu, Xu, Xos^Xzm/, Urb, Urb^Em, Uh, Uu, Ur, Uu, Xos, Urb, Urb, Urb, Urb, Urb^Es, Urb, Urb, Urb, Urb, Cud, Urb^Em, Tb^Tf, Tb^Tf, Qxu, Xuc, Xu, Xu, Xu, Xu, Xu, Xu, Xu, Xu, Xu, Xu, Xu, Xuc, Xu, Xuc, Xu, Xu, Xu, Xu, Xu, Xu, Xu, Xu, Xu, Xu, Xu, Xu, Xu, Xu
Xu, Xu, Xu, Xu, Xu, Xu, Xu, Xu, Xu, Xu, Xu, Xu, Xu, Xu, Xu, Xu, Xu, Urb, Urb, Urb, Cud, Uu, Cud, Ur^Es, Xos, Urb, Urb, Urb^Es, Urb, Urb, Urb, Urb, Urb, Urb, Cud, Urb^Emf, Uh, Uh, Qxu, Xuc, Xu, Xu, Xu, Xu, Xu, Xu, Xu, Xu, Xu, Xu, Xu, Xuc, Xu, Xuc, Xu, Xu, Xu, Xu, Xu, Xu, Xu, Xu, Xu, Xu, Xu, Xu, Xu, Xu
Xu, Xu, Xu, Xu, Xu, Xu, Xu, Xu, Xu, Xu, Xu, Xu, Xu, Xu, Xos, Xos, Urb^Em, Urb^Pw\o, Xos, Xos, Xos, Uu, Uu, Ur, Xos, Urb, Urb, Urb, Urb^Es, Cte, Uu^Tf, Urb, Urb^Eb, Uh, Uh, Cud, Urb, Qxu, Qxu, Qxu, Xuc, Xu, Xu, Xu, Xu, Xu, Xu, Xu, Xu, Xu, Xu, Xuc, Xu, Xuc, Xu, Xu, Xu, Xu, Xu, Xu, Xu, Xu, Xu, Xu, Xu, Xu, Xu, Xu
Xu, Xu, Xu, Xu, Xu, Xu, Xu, Xu, Xu, Xu, Xu, Xu, Xu, Xos, Uh, Uh^Xo, Urb^Xo, Urb, Xu, Xos, Xos, Xu, Xu, Urb, Xos, Urb, Urb^Eb, Urb, Uh, Uh, Ur, Uh, Urb, Qxu, Uh, Urb, Xuc, Xuc, Xu, Qxu, Qxu, Xu, Xu, Xu, Xu, Xu, Xu, Xu, Xu, Xu, Xu, Xuc, Xu, Xuc, Xu, Xu, Xu, Xu, Xu, Xu, Xu, Xu, Xu, Xu, Xu, Xu, Xu, Xu
Xu, Xu, Xu, Xu, Xu, Xu, Xu, Xu, Xu, Xu, Xu, Xu, Xu, Xu, Xu, Uu^Tf, Urb^Es, Urb^Xo, Uh^Xo, Xos, Xu, Xu, Xu, Xu, Xu, Qxu, Qxu, Urb, Uu^Es, Uh, Uh, Uu, Urb, Qxu, Qxu, Xos, Xos, Xu, Xu, Qxu, Qxu, Qxu, Xu, Xu, Xu, Xu, Xu, Xu, Xu, Xu, Xu, Xuc, Xu, Xuc, Xu, Xu, Xu, Xu, Xu, Xu, Xu, Xu, Xu, Xu, Xu, Xu, Xu, Xu
Xu, Xu, Xu, Xu, Xu, Xu, Xu, Xu, Xu, Xu, Xu, Xu, Xu, Xu, Xu^Zok, Xos, Urb, Urb, Uh, Xos, Xu, Xu, Xu, Xu, Xu, Qxu, Xu, Xu, Xu, Uu, Qxu, Qxu, Qxu, Qxu, Qxu, Xos, Xos, Xu, Xu, Xu, Qxu^Xo, Qxu^Xo, Xu, Xu, Xu, Xu, Xu, Xu, Xu, Xu, Xu, Xuc, Xu, Xuc, Xu, Xu, Xu, Xu, Xu, Xu, Xu, Xu, Xu, Xu, Xu, Xu, Xu, Xu
Xu, Xu, Xu, Xu, Xu, Xu, Xu, Xu, Xu, Xu, Xu, Xu, Xu^Zok, Xu^Zok, Xos^Zok, Xos^Zok, Urb^Zok, Urb, Xu, Xos, Xu, Xu, Xu, Xu, Xu, Qxu^Xo, Xu, Xu, Xu, Xu, Xu, Qxu, Qxu, Qxu, Qxu, Xos, Xu, Xu, Xu, Xu, Xu, Qxu, Qxu, Xu, Xu, Xu, Xu, Xu, Xu, Xu, Xu, Xuc, Xu, Xuc, Xu, Xu, Xu, Xu, Xu, Xu, Xu, Xu, Xu, Xu, Xu, Xu, Xu, Xu
Xu, Xu, Xu, Xu, Xu, Xu, Xu, Xu, Xu, Xu, Xu, Xu^Zok, Xos^Zok, Xos^Zok, Urb^Zok, Urb^Zok, Xos^Zok, Urb^Zok, Xos^Zok, Xu, Xu, Xu, Xu, Xu, Xu, Qxu, Xu, Xu, Xu, Xu, Xu, Qxu, Qxu, Qxu, Xu, Xu, Xu, Xu, Xu, Xu, Xu, Xu, Xu, Xu, Xu, Xu, Xu, Xu, Xu, Xu, Xu, Xuc, Xu, Xuc, Xu, Xu, Xu, Xu, Xu, Xu, Xu, Xu, Xu, Xu, Xu, Xu, Xu, Xu
Xu, Xu, Xu, Xu, Xu, Xu, Xu, Xu, Xu, Xu, Xu, Xu, Xu, Urb^Zok, Xos^Zok, Xos^Zok, Xos^Zok, Xos^Zok, Xu^Zok, Xu^Zok, Xu, Xu, Xu, Xu, Xu, Xu, Xu, Xu, Xu, Xu, Xu, Xu, Qxu^Xo, Qxu^Xo, Xu, Xu, Xu, Xu, Xu, Xu, Xu, Xu, Xu, Xu, Xu, Xu, Xu, Xu, Xu, Xu, Xu, Xuc, Xu, Xuc, Xu, Xu, Xu, Xu, Xu, Xu, Xu, Xu, Xu, Xu, Xu, Xu, Xu, Xu
Xu, Xu, Xu, Xu, Xu, Xu, Xu, Xu, Xu, Xu, Xu, Xu, Xu, Xu, Xu, Xu^Zok, Xu^Zok, Xu^Zok, Xu, Xu, Xu, Xu, Xu, Xu, Xu, Xu, Xu, Xu, Xu, Xu, Xu, Xu, Qxu, Qxu, Xu, Xu, Xu, Xu, Xu, Xu, Xu, Xu, Xu, Xu, Xu, Xu, Xu, Xu, Xu, Xu, Xu, Xuc, Xu, Xuc, Xu, Xu, Xu, Xu, Xu, Xu, Xu, Xu, Xu, Xu, Xu, Xu, Xu, Xu
Xu, Xu, Xu, Xu, Xu, Xu, Xu, Xu, Xu, Xu, Xu, Xu, Xu, Xu, Xu, Xu, Xu, Xu, Xu, Xu, Xu, Xu, Xu, Xu, Xu, Xu, Xu, Xu, Xu, Xu, Xu, Xu, Xu, Xu, Xu, Xu, Xu, Xu, Xu, Xu, Xu, Xu, Xu, Xu, Xu, Xu, Xu, Xu, Xu, Xu, Xu, Xuc, Xu, Xuc, Xu, Xu, Xu, Xu, Xu, Xu, Xu, Xu, Xu, Xu, Xu, Xu, Xu, Xu
Xu, Xu, Xu, Xu, Xu, Xu, Xu, Xu, Xu, Xu, Xu, Xu, Xu, Xu, Xu, Xu, Xu, Xu, Xu, Xu, Xu, Xu, Xu, Xu, Xu, Xu, Xu, Xu, Xu, Xu, Xu, Xu, Xu, Xu, Xu, Xu, Xu, Xu, Xu, Xu, Xu, Xu, Xu, Xu, Xu, Xu, Xu, Xu, Xu, Xu, Xu, Xuc, Xu, Xuc, Xu, Xu, Xu, Xu, Xu, Xu, Xu, Xu, Xu, Xu, Xu, Xu, Xu, Xu
Xu, Xu, Xu, Xu, Xu, Xu, Xu, Xu, Xu, Xu, Xu, Xu, Xu, Xu, Xu, Xu, Xu, Xu, Xu, Xu, Xu, Xu, Xu, Xu, Xu, Xu, Xu, Xu, Xu, Xu, Xu, Xu, Xu, Xu, Xu, Xu, Xu, Xu, Xu, Xu, Xu, Xu, Xu, Xu, Xu, Xu, Xu, Xu, Xu, Xu, Xu, Xuc, Xu, Xuc, Xu, Xu, Xu, Xu, Xu, Xu, Xu, Xu, Xu, Xu, Xu, Xu, Xu, Xu
Xu, Xu, Xu, Xu, Xu, Xu, Xu, Xu, Xu, Xu, Xu, Xu, Xu, Xu, Xu, Xu, Xu, Xu, Xu, Xu, Xu, Xu, Xu, Xu, Xu, Xu, Xu, Xu, Xu, Xu, Xu, Xu, Xu, Xu, Xu, Xu, Xu, Xu, Xu, Xu, Xu, Xu, Xu, Xu, Xu, Xu, Xu, Xu, Xu, Xu, Xu, Xuc, Xu, Xuc, Xu, Xu, Xu, Xu, Xu, Xu, Xu, Xu, Xu, Xu, Xu, Xu, Xu, Xu
