Wwb, Wwb, Wwb, Wwb, Wwb, Wwb, Wwb, Wwb, Wwb, Wwb, Wwb, Wwb, Wwb, Wwb, Wwb, Wwb, Wwb, Wwb, Wwb, Wwb, Wwb, Wwb, Wwb, Xoa, Wwb, Wwb, Aa, Wwb, Aa, Aa, Aa, Wwb, Wwb, Xoa, Wwb, Wwb, Wwb, Wwb, Wwb, Wwb, Wwb, Wwb, Wwb, Wwb, Wwb, Wwb, Wwb, Wwb, Wwb, Wwb, Wwb, Wwb, Wwb, Wwb, Wwb, Wwb
Wwb, Wwb, Wwb, Wwb, Wwb, Wwb, Wwb, Wwb, Wwb, Wwb, Wwb, Wwb, Wwb, Wwb, Wwb, Wwb, Wwb, Wwb, Wwb, Wwb, Xoa, Wwb, Wwb, Wwb, Aa, Aa, Aa, Aa, Xoa, Aa, Aa, Aa, Ai, Wwb, Wwb, Wwb, Xoa, Wwb, Wwb, Wwb, Wwb, Wwb, Wwb, Wwb, Wwb, Wwb, Wwb, Wwb, Wwb, Wwb, Wwb, Wwb, Wwb, Wwb, Wwb, Wwb
Wwb, Wwb, Wwb, Wwb, Wwb, Wwb, Wwb, Wwb, Wwb, Wwb, Wwb, Wwb, Wwb, Wwb, Wwb, Wwb, Wwb, Wwb, Wwb, Wwb, Wwb, Wwb, Wwb, Aa, Aa, Aa, Xoa, Xoa, Xoa, Xoa, Xoa, Aa, Aa, Wwb, Wwb, Wwb, Wwb, Wwb, Wwb, Wwb, Wwb, Wwb, Wwb, Wwb, Wwb, Wwb, Wwb, Wwb, Wwb, Wwb, Wwb, Wwb, Wwb, Wwb, Wwb, Wwb
Wwb, Wwb, Wwb, Wwb, Wwb, Wwb, Wwb, Wwb, Wwb, Wwb, Wwb, Wwb, Wwb, Wwb, Wwb, Wwb, Wwb, Wwb, Wwb, Wwb, Wwb, Wwb, Ai, Ai, Aa, Xoa, Xoa, Xoa, Xoa, Xoa, Xoa, Xoa, Aa, Aa, Wwb, Wwb, Wwb, Wwb, Wwb, Wwb, Wwb, Wwb, Wwb, Wwb, Wwb, Wwb, Wwb, Wwb, Wwb, Wwb, Wwb, Wwb, Wwb, Wwb, Wwb, Wwb
Wwb, Wwb, Wwb, Wwb, Wwb, Wwb, Wwb, Wwb, Wwb, Wwb, Wwb, Wwb, Wwb, Wwb, Wwb, Wwb, Wwb, Wwb, Wwb, Xoa, Wwb, Wwb, Ai, Aa, Aa, Xoa, Xoa, Xoa, Xoa, Xoa, Xoa, Xoa, Aa, Aa, Ai, Wwb, Wwb, Xoa, Wwb, Wwb, Wwb, Wwb, Wwb, Wwb, Wwb, Wwb, Wwb, Wwb, Wwb, Wwb, Wwb, Wwb, Wwb, Wwb, Wwb, Wwb
Wwb, Wwb, Wwb, Wwb, Wwb, Wwb, Wwb, Wwb, Wwb, Wwb, Wwb, Wwb, Wwb, Wwb, Wwb, Wwb, Wwb, Wwb, Wwb, Wwb, Wwb, Wwb, Aa, Aa, Aa, Xoa, Xoa, Xoa, Xoa, Xoa, Xoa, Xoa, Aa, Ai, Wwb, Wwb, Wwb, Wwb, Wwb, Wwb, Wwb, Wwb, Wwb, Wwb, Wwb, Wwb, Wwb, Wwb, Wwb, Wwb, Wwb, Wwb, Wwb, Wwb, Wwb, Wwb
Wwb, Wwb, Wwb, Wwb, Wwb, Wwb, Wwb, Wwb, Wwb, Wwb, Wwb, Wwb, Wwb, Wwb, Wwb, Wwb, Wwb, Wwb, Wwb, Wwb, Wwb, Wwb, Wwb, Ai, Aa, Xoa, Xoa, Xoa, Xoa, Xoa, Xoa, Xoa, Aa, Ai, Wwb, Wwb, Wwb, Wwb, Wwb, Wwb, Wwb, Wwb, Wwb, Wwb, Wwb, Wwb, Wwb, Wwb, Wwb, Wwb, Wwb, Wwb, Wwb, Wwb, Wwb, Wwb
Wwb, Wwb, Wwb, Wwb, Wwb, Wwb, Wwb, Wwb, Wwb, Wwb, Wwb, Wwb, Wwb, Wwb, Wwb, Wwb, Wwb, Wwb, Wwb, Wwb, Xoa, Wwb, Wwb, Ai, Aa, Aa, Aa, Xoa, Xoa, Xoa, Aa, Aa, Ai, Wwb, Wwb, Wwb, Xoa, Wwb, Wwb, Wwb, Wwb, Wwb, Wwb, Wwb, Wwb, Wwb, Wwb, Wwb, Wwb, Wwb, Wwb, Wwb, Wwb, Wwb, Wwb, Wwb
Wwb, Wwb, Wwb, Wwb, Wwb, Wwb, Wwb, Wwb, Wwb, Wwb, Wwb, Wwb, Wwb, Wwb, Wwb, Wwb, Wwb, Wwb, Wwb, Wwb, Wwb, Wwb, Wwb, Wwb, Wwb, Ai, Ai, Aa, Ai, Aa, Ai, Aa, Wwb, Wwb, Wwb, Wwb, Wwb, Wwb, Wwb, Wwb, Wwb, Wwb, Wwb, Wwb, Wwb, Wwb, Wwb, Wwb, Wwb, Wwb, Wwb, Wwb, Wwb, Wwb, Wwb, Wwb
Wwb, Wwb, Wwb, Wwb, Wwb, Wwb, Wwb, Wwb, Wwb, Wwb, Wwb, Wwb, Wwb, Wwb, Wwb, Wwb, Wwb, Wwb, Wwb, Wwb, Wwb, Wwb, Wwb, Wwb, Xoa, Wwb, Wwb, Wwb, Wwb, Ai, Wwb, Wwb, Xoa, Wwb, Wwb, Wwb, Wwb, Wwb, Wwb, Wwb, Wwb, Wwb, Wwb, Wwb, Wwb, Wwb, Wwb, Wwb, Wwb, Wwb, Wwb, Wwb, Wwb, Wwb, Wwb, Wwb
Wwb, Wwb, Wwb, Wwb, Wwb, Wwb, Wwb, Wwb, Wwb, Wwb, Wwb, Wwb, Wwb, Wwb, Wwb, Wwb, Wwb, Wwb, Wwb, Wwb, Wwb, Wwb, Wwb, Wwb, Wwb, Wwb, Wwb, Wwb, Xoa, Wwb, Wwb, Wwb, Wwb, Wwb, Wwb, Wwb, Wwb, Wwb, Wwb, Wwb, Wwb, Wwb, Wwb, Wwb, Wwb, Wwb, Wwb, Wwb, Wwb, Wwb, Wwb, Wwb, Wwb, Wwb, Wwb, Wwb
Wwb, Wwb, Wwb, Wwb, Wwb, Wwb, Wwb, Wwb, Wwb, Wwb, Wwb, Wwb, Wwb, Wwb, Wwb, Wwb, Wwb, Wwb, Wwb, Wwb, Wwb^Xo, Wwb^Xo, Wwb^Xo, Wwb, Wwb, Wwb, Wwb, Wwb, Wwb, Wwb, Wwb, Wwb, Wwb, Wwb, Wwb, Wwb, Wwb, Wwb, Wwb, Wwb, Wwb, Wwb, Wwb, Wwb, Wwb, Wwb, Wwb, Wwb, Wwb, Wwb, Wwb, Wwb, Wwb, Wwb, Wwb, Wwb
Wwb, Wwb, Wwb, Wwb, Wwb, Wwb, Wwb, Wwb, Wwb, Wwb, Wwb, Wwb, Wwb, Wwb, Wwb, Wwb, Wwb^Xo, Wwb^Xo, Wwb^Xo, Wwb^Xo, Wwb^Xo, Rb, Rb, Wwb^Xo, Wwb^Xo, Wwb, Wwb, Wwb, Wwb, Wwb, Wwb, Wwb, Wwb^Xo, Wwb^Xo, Wwb^Xo, Wwb, Wwb, Wwb, Wwb, Wwb, Wwb, Wwb, Wwb, Wwb, Wwb, Wwb, Wwb, Wwb, Wwb, Wwb, Wwb, Wwb, Wwb, Wwb, Wwb, Wwb
Wwb, Wwb, Wwb, Wwb, Wwb, Wwb, Wwb, Wwb, Wwb, Wwb, Wwb, Wwb, Wwb, Wwb, Wwb^Xo, Wwb^Xo, Rb, Rb, Rb, Rb, Rb, Rb, Uue, Rb, Wwb^Xo, Wwb, Wwb^Xo, Wwb, Wwb^Xo, Wwb^Xo, Wwb^Xo, Wwb, Wwb^Xo, Rb, Rb, Wwb^Xo, Wwb^Xo, Wwb, Wwb, Wwb, Wwb, Wwb, Wwb, Wwb, Wwb, Wwb, Wwb, Wwb, Wwb, Wwb, Wwb, Wwb, Wwb, Wwb, Wwb, Wwb
Wwb, Wwb, Wwb, Wwb, Wwb, Wwb, Wwb, Wwb, Wwb, Wwb, Wwb, Wwb, Wwb^Xo, Wwb^Xo, Rb, Rb, Re, Rb, Re, Rb, Uue, Uue, Uhe, Rb, Rb, Wwb^Xo, Rb, Wwb^Xo, Rb, Rb, Re, Wwb^Xo, Rb, Rb, Uue, Rb, Wwb^Xo, Wwb, Wwb, Wwb, Wwb, Wwb, Wwb, Wwb, Wwb, Wwb, Wwb, Wwb, Wwb, Wwb, Wwb, Wwb, Wwb, Wwb, Wwb, Wwb
Wwb, Wwb, Wwb, Wwb, Wwb, Wwb, Wwb, Wwb, Wwb, Wwb, Wwb^Xo, Wwb^Xo, Xue, Rb, Rb, Re, Re, Re, Re, Re, Re, Uhe, Uue, Rb, Uhe, Rb, Uhe, Rb, Xoa, Rb^Dr, Rb, Re, Uue, Uue^Ii, Uhe, Rb, Rb, Wwb^Xo, Wwb^Xo, Wwb, Wwb, Wwb, Wwb, Wwb, Wwb, Wwb, Wwb, Wwb, Wwb, Wwb, Wwb, Wwb, Wwb, Wwb, Xue, Xue
Wwb, Wwb, Wwb, Wwb, Wwb, Wwb, Wwb, Wwb, Wwb, Wwb^Xo, Xue, Xue, Rb, Re, Uue, Re, Re, Uue, Uue, Re, Uue^Ii, Re, Uue, Uue, Re, Re^Fetd, Re^Fdw, Uhe, Re, Rb, Re^Fdw, Re^Fetd, Re^Fdw, Uhe, Yhs^Xp, Uhe, Uue, Rb, Rb, Wwb^Xo, Wwb, Wwb, Wwb, Wwb, Wwb, Wwb, Wwb, Wwb, Wwb, Wwb, Wwb, Wwb, Wwb, Xue, Xue, Xue
Wwb, Wwb, Wwb, Wwb, Wwb, Wwb, Wwb, Wwb, Wwb, Wwb^Xo, Xue, Xue, Re, Re, Uue, Uue, Xue, Uue, Uue, Re, Uue, Uue, Uue, Uue, Uue, Re, Re, Re, Re, Re, Re, Re^Fdw, Re, Re, Yhs, Yhs^Xp, Uue, Rb, Rb, Wwb^Xo, Wwb^Xo, Wwb, Wwb, Wwb, Wwb, Wwb, Wwb, Wwb, Wwb, Wwb, Wwb, Wwb, Wwb, Wwb, Xue, Xue
Wwb, Wwb, Wwb, Wwb, Wwb, Wwb, Wwb, Wwb, Wwb^Xo, Wwb^Xo, Rb, Re, Re, Uue, Uue, Xue, Xue, Xue, Xue, Uue, Yhs, Yhs, Uue, Xoa, Uue, Re, Rp, Re^Gvs, Rp^Cov, Re, Rp, Re, Re, Xoa, Re, Yhs, Uue, Uhe, Rb, Rb, Rb, Wwb^Xo, Wwb^Xo, Wwb, Wwb, Wwb, Wwb, Xue, Wwb^Xo, Wwb, Wwb^Xo, Wwb, Wwb, Wwb, Xue, Xue
Wwb, Wwb, Wwb, Wwb, Wwb, Wwb, Wwb^Xo, Wwb^Xo, Rb, Rb, Re, Re, Re, Re, Xue, Xue, Xue, Xue, Uhe, Uhe, Yhs^Xp, Yhs^Xp, Re^Fdw, Re, Re, Re, Rp^Cov, Rp^Cov, Cud^Xo, Rp^Cov, Rp^Cov, Re, Re, Re^Dr, Re^Fdw, Re, Xue, Uue, Uhe, Rb, Rb, Rb, Wwb^Xo, Wwb, Wwb, Wwb, Xue, Xue, Rb, Wwb^Xo, Rb, Wwb^Xo, Xue, Xue, Xue, Xue
Wwb, Wwb, Wwb, Wwb, Wwb, Wwb^Xo, Xue, Xue, Rb, Re, Uue, Re, Uue, Re, Xue, Xue, Uhe, Uhe, Tb^Tf, Uue^Tf, Uue, Re, Re^Fetd, Re^Fdw, Re, Re, Rp^Cov, Cud^Xo, 2 Cud, Cud^Xo, Rp^Cov, Re^Gvs, Re, Re, Re^Fetd, Re^Fdw, Xue, Xue, Uhe, Uhe, Uhe, Rb, Rb, Wwb^Xo, Xue, Xue, Xue, Xue, Uue, Rb, Rb, Rb, Xue, Xue, Uhe, Xue
Wwb^Xo, Wwb, Wwb, Wwb, Wwb^Xo, Wwb^Xo, Xue, Rb, Re, Re, Uue, Uhe, Uue, Uue, Uue, Xue, Uhe, Uhe, Uue, Uue^Ii, Uue, Uue, Re^Dr, Re, Rp, Rp, Rp^Cov, Cud^Xo, Cud^Xo, Cud^Xo, Rp^Cov, Rp, Re, Re, Re^Fdw, Re^Fdw, Xue, Xue, Uhe, Uue, Uue, Rb, Rb, Xue, Xue, Xue, Uue, Uue, Re, Re, Re, Re, Uue, Uue, Uhe, Uue
Xue, Wwb^Xo, Wwb^Xo, Wwb^Xo, Xue, Xue, Xue, Rb, Uue, Uue, Yhs, Uhe, Uue, Uue, Uhe, Uhe, Uue^Tf, Tb^Tf, Uhe, Uhe, Uue, Re, Re, Re, Re, Re^Gvs, Rp, Rp^Cov, Rp^Cov, Rp^Cov, Re, Re, Re, Re, Re, Re, Uue, Xue, Uhe, Uue^Tf, Uue, Re, Re, Rb, Rb, Uue, Uue, Uhe, Uue, Re, Re, Uue, Uue, Uhe, Uue, Uue
Rb, Rb, Rb, Xue, Uue, Rb, Re, Uue, Yhs^Xp, Yhs, Uue, Re, Re, Re^Tf, Uue, Uue, Uue, Uue, Uhe, Tb^Tf, Tb^Tf, Re, Yhs, Xoa, Re^Fdw, Re, Re, Re^Gvs, Rp, Re^Gvs, Re, Re, Re, Xoa, Yhs, Yhs^Xp, Uue^Ii, Uhe, Uue^Tf, Uue, Uhe, Uue, Uue, Uue, Uue, Uue, Uue, Uue, Uue, Wwb, Wwb, Re, Re, Re, Uue, Uhe
Uue, Rb, Re, Uue, Uue, Re, Yhs, Yhs, Uue, Uue, Re, Re, Re, Tb^Tf, Tb^Tf, Uue, Uue, Uhe, Yhs, Tb^Tf, Yhs, Yhs, Re, Re, Re^Fdw, Re^Fetd, Re, Rp, Xoa, Re, Re, Re^Fetd, Re, Re, Yhs, Yhs^Xp, Uhe, Uhe, Uue, Uue, Uhe, Uue, Wwb, Uue, Wwb, Uue, Uue, Uue, Wwb, Wwb, Uue, Re, Re, Re, Re, Uhe
Re, Re, Re, Re, Re, Yhs, Uhe, Uue, Re, Re, Re^Tf, Re, Re, Uue^Tf, Uue, Uue, Uue, Yhs, Yhs^Xp, Yhs^Xp, Re, Uhe, Uhe, Uue, Uue^Fdw, Re^Fdw, Re, Re, Re, Re^Dr, Uue^Fdw, Uue^Fdw, Uue, Uue, Uue^Tf, Uue, Xue, Tb^Tf, Uue, Uue, Uhe, Uue, Wwb, Wwb, Wwb, Uue, Uue, Re, Uhe, Uue, Uue, Uhe, Uhe, Uue, Uhe, Uue
Uue, Re, Uue, Re, Re, Yhs, Uue, Uue, Re, Re, Re, Re, Re, Uue, Sm, Uue, Uue, Yhs, Re, Re, Re, Tb^Tf, Uhe, Re, Uue, Re^Fdw, Uue, Re, Re, Re^Fdw, Uue^Fdw, Uue, Uhe, Uhe, Re^Tf, Xue, Xue, Re^Tf, Uue, Uhe, Uue, Wwb, Wwb, Wwb, Wwb, Wwb, Uue, Re, Uue, Uue, Uue, Uue, Uue, Uue, Uue, Uue
Uue, Uhe, Uue, Uue, Yhs, Yhs^Xp, Re, Re, Re, Uue, Uue^Tf, Uhe, Uue, Uue, Sm, Sm, Uue^Tf, Uue, Uue, Uue, Xue, Uue, Tb^Tf, Uhe, Uue, Uue^Ii, Uue, Rp, Re, Uue, Uue, Uue, Tb^Tf, Re^Emf, Xue, Xue, Uue, Uhe, Uue, Uue, Wwb, Wwb, Uue, Wwb, Wwb, Wwb, Uue, Re, Re, Re, Uue, Wwb, Wwb, Wwb, Wwb, Wwb
Uue, Uue, Uue^Tf, Re, Yhs, Wwb, Wwb, Re, Re, Uue, Uue^Tf, Uue, Uue, Sm, Uue, Uue, Tb^Tf, Uue, Wwb, Uue, Wwb, Xue, Xue, Uhe, Re^Fdw, Uue, Rp, Rp, Re^Fdw, Uue^Fdw, Uue, Uue^Tf, Uue, Re^Tf, Re, Uue, Uue, Uhe, Uue, Uue, Uue, Uue, Sm, Uue, Uue, Wwb, Tb^Tf, Re^Tf, Re, Sm, Sm, Wwb, Wwb, Wwb, Wwb, Wwb
Sm, Sm, Tb^Tf, Uue, Yhs, Wwb, Wwb, Re, Re, Uue^Tf, Uhe, Uue, Sm, Sm, Uue, Uue^Tf, Uue, Re, Wwb, Wwb, Wwb, Xue, Xue, Xue, Re, Rp, Uue, Re, Re^Fdw, Re^Fdw, Uue, Uue, Re, Re, Wwb, Re, Re, Uue, Re, Uue, Re, Uue, Sm, Sm, Uue, Uue, Tb^Tf, Re^Tf, Uue, Sm, Sm, Wwb, Wwb, Wwb, Wwb, Wwb
Sm, Sm, Yhs^Xp, Yhs, Wwb, Wwb, Wwb, Re, Uue, Uue, Uhe, Uue, Re, Re, Uue, Uue, Sm, Uue, Uue, Wwb, Wwb, Uue, Uue, Uue, Rp, Uue, Uue, Re, Re, Re^Fdw, Re^Fdw, Re, Re, Re, Wwb, Wwb, Re, Uue, Re, Re, Re, Re, Uue, Sm, Sm, Uue^Tf, Re^Tf, Yhs, Yhs, Sm, Sm, Wwb, Wwb, Wwb, Wwb, Wwb
Yhs, Yhs^Xp, Uue, Wwb, Wwb, Wwb, Uue, Uue, Uue, Uue, Re, Re, Uue, Re, Re, Uue, Sm, Uue, Uue^Tf, Wwb, Wwb, Uue, Sm, Rp, Rp, Uue, Re, Re, Re, Re^Fdw, Uue, Uue^Fdw, Uue, Re, Re, Wwb, Re, Re, Uue, Re, Re, Uue, Sm, Sm, Sm, Uue, Yhs, Yhs^Tf, Yhs, Sm, Sm, Sm, Uue, Uue, Uue, Uue
Re, Uue, Uue, Wwb, Uue, Uue, Sm, Uue, Uue, Re, Re, Re, Uue, Uue, Re, Re, Uue^Tf, Sm, Uue^Tf, Uue, Uue, Uue, Sm, Uue^Fdw, Re^Fdw, Re, Re, Wwb, Wwb, Re^Fdw, Re, Uue^Fdw, Uue, Re, Re, Re, Re, Uue, Uue, Sm, Sm, Sm, Uue, Sm, Wwb, Yhs^Xp, Yhs^Xp, Yhs^Tf, Yhs^Tf, Yhs, Re, Uue, Uue, Uue, Uue^Tf, Tb^Tf
Re, Re, Uue, Wwb, Uue, Sm, Sm, Uue, Wwb, Uue, Re, Uue, Sm, Uue, Uue, Uue^Tf, Uue^Tf, Tb^Tf, Sm, Sm, Sm, Sm, Sm, Uue^Fdw, Uue^Fdw, Rp, Rp, Wwb, Wwb, Re, Re, Re, Uue, Uue, Re, Re^Fdw, Uue, Uue, Sm, Uue, Sm, Uue, Sm, Wwb, Wwb, Wwb, Wwb, Wwb, Yhs, Yhs, Re, Re, Re, Re, Re, Re
Uue, Uue, Uue, Wwb, Wwb, Uue, Uue, Uue, Wwb, Wwb, Wwb, Uue, Sm, Uue, Sm, Wwb, Wwb, Uue^Tf, Uue, Sm, Uue, Sm, Sm, Uue, Yhs, Re, Rp, Re, Re, Re, Re^Fdw, Re, Uue, Uue, Yhs, Yhs, Sm, Sm, Sm, Uue, Uue, Sm, Wwb, Wwb, Wwb, Wwb, Wwb, Wwb, Yhs, Yhs, Re, Re, Re^Tf, Re, Yhs^Xp, Yhs
Uue, Uue^Tf, Uue^Tf, Uue, Wwb, Wwb, Re, Re, Re, Wwb, Wwb, Re, Uue, Sm, Sm, Wwb, Uue, Uue^Tf, Uue, Uue, Sm, Sm, Sm, Sm, Yhs, Re, Re, Uue, Uue, Re, Yhs, Re, Uue, Uue, Yhs^Xp, Yhs, Sm, Wwb, Wwb, Uue, Uue, Sm, Wwb, Wwb, Wwb, Wwb, Yhs^Xp, Yhs, Uue, Yhs^Xp, Yhs, Re, Tb^Tf, Yhs, Re, Re
Yhs, Tb^Tf, Yhs^Xp, Yhs, Yhs, Wwb, Wwb, Re, Yhs, Uue, Uue, Re, Re, Wwb, Sm, Sm, Sm, Sm, Uue, Uue, Sm, Wwb, Wwb, Sm, Yhs, Yhs^Xp, Re, Rp, Rp, Uue, Yhs, Yhs, Yhs, Yhs^Xp, Yhs, Sm, Wwb, Wwb, Wwb, Wwb, Uue, Uhe, Uue, Wwb, Yhs, Yhs^Xp, Uue, Uue, Uue, Uue, Uue, Yhs, Tb^Tf, Re^Tf, Re^Tf, Re
Uue, Yhs, Uue, Re, Wwb, Yhs, Wwb, Yhs, Re^Tf, Yhs, Yhs, Re, Wwb, Wwb, Wwb, Sm, Uue, Sm, Uue, Sm, Sm, Wwb, Wwb, Wwb, Yhs, Yhs, Yhs, Uue, Re, Re, Uue^Dr, Yhs, Yhs^Xp, Yhs, Yhs, Wwb, Wwb, Wwb, Wwb, Wwb, Wwb, Uhe, Yhs, Yhs, Uhe, Uue, Re, Uue^Tf, Uue, Wwb, Wwb, Uue, Uue, Yhs, Yhs, Uue
Wwb, Uue, Uue, Uue, Wwb, Wwb, Uue, Uue, Tb^Tf, Uue, Yhs^Xp, Wwb, Wwb, Wwb, Wwb, Wwb, Uue^Tf, Uue, Uue, Sm, Uue, Wwb, Wwb, Wwb, Wwb, Yhs^Xp, Yhs^Xp, Uue, Uue, Re, Re, Uue, Yhs, Yhs, Wwb, Wwb, Uue, Re, Re, Wwb, Wwb, Wwb, Yhs^Xp, Uhe, Uue, Uhe, Tb^Tf, Tb^Tf, Wwb, Uue, Wwb, Wwb, Wwb, Wwb, Wwb, Wwb
Wwb, Wwb, Wwb, Wwb, Uue, Uue, Uue, Uue^Tf, Re^Tf, Uue, Uue, Yhs^Xp, Wwb, Wwb, Re, Uue, Tb^Tf, Uue^Tf, Uue, Uue, Uue^Dr, Uue, Wwb, Wwb, Wwb, Yhs, Yhs, Yhs, Uue, Rp, Rp, Re, Uue, Yhs, Uue, Uue, Tb^Tf, Uue, Re, Re, Re, Yhs, Yhs, Uhe, Re, Re, Re^Tf, Uue, Uue, Wwb, Wwb, Wwb, Wwb, Wwb, Wwb, Wwb
Uue, Wwb, Wwb, Wwb, Wwb, Uue, Re, Re^Tf, Re, Uue, Uue, Yhs^Xp, Re, Re, Re^Tf, Tb^Tf, Uue^Tf, Uue, Uue, Uue, Uue, Uue, Uue, Wwb, Wwb, Wwb, Wwb, Yhs^Edt, Re^Edt, Re, Re, Rp, Tb^Tf, Uue, Uue, Uue^Tf, Uue, Uue, Re, Re, Yhs, Yhs, Xue, Uue, Xue, Re, Re, Uue, Xue, Uue, Re, Wwb, Wwb, Wwb, Wwb, Wwb
Uue, Uue, Uue, Wwb, Re, Re, Re, Re, Re, Wwb, Wwb, Yhs, Re, Re, Uue, Uue, Re, Re, Uue, Xue, Xue, Uhe, Uue, Uue, Uue, Uue, Re, Re^Edt, Re, Uue, Uue^Em, Rp^Edt, Uue^Edt, Xue, Xue, Uue, Xue, Xue, Xue, Xue, Xue, Xue, Xue, Xue, Xue, Xue, Xue, Xue, Xue, Xue, Xue, Re, Re, Re, Re, Re
Wwb, Uue, Uue, Wwb, Wwb, Re^Tf, Uue, Re, Wwb, Wwb, Wwb, Yhs, Yhs, Re, Re, Re, Wwb, Uue, Uhe, Xue, Xue, Uue, Uue, Uhe, Uhe, Xue, Xue, Uhe, Uhe, Tb^Tf, Re^Emf, Rp^Ezx, Uue^Emf, Xue, Xue, Xue, Xos, Xue, Xue, Xue, Xue, Xue, Xue, Xue, Xue, Xue, Xue, Xue, Xue, Xue, Xue, Xue, Xue, Xue, Xue, Xue
Wwb, Uue, Uhe, Uue, Uue, Re, Uue, Uue, Uue, Uue, Uue, Wwb, Uue, Yhs, Yhs^Xp, Wwb, Uue, Uhe, Xue, Xue, Xue, Xue, Xue, Uhe, Xue, Xue, Xue, Xoa, Xoa, Uue^Tf, Re, Rp^Em, Rp, Uhe, Xoa, Xos, Xue, Xue, Xue, Xue, Xue, Xue, Xue, Xue, Xue, Xue, Xue, Xue, Xue, Xue, Xue, Xue, Xue, Xue, Xue, Xue
Uue, Uue, Uhe, Uhe, Xue, Xue, Xue, Uhe, Xue, Xue, Xue, Uhe, Uue, Yhs, Yhs, Uue, Xue, Xue, Xue, Xue, Xue, Xue, Xue, Xue, Xue, Xue, Xue, Xue, Xue, Uue, Rp^Edt, Uue, Rp^Edt, Uue, Uhe, Xue, Xue, Xue, Xue, Xue, Xue, Xue, Xue, Xue, Xue, Xue, Xue, Xue, Xue, Xue, Xue, Xue, Xue, Xue, Xue, Xue
Uue, Uhe, Uhe, Xue, Xue, Xue, Xue, Xue, Xue, Xue, Xue, Xue, Xue, Xue, Xue, Xue, Xue, Xue, Xue, Xue, Xue, Xue, Xue, Xue, Uue, Xue, Xue, Xue, Uue, Uhe, Wwb, Uue, Uue^Edt, Uue^Edt, Uue, Uhe, Xue, Xue, Xue, Xue, Xue, Xue, Xue, Xue, Xue, Xue, Uhe, Xue, Xue, Xue, Xue, Xue, Xue, Xue, Xue, Xue
Uhe, Uhe, Xue, Xue, Xue, Xue, Xue, Xue, Xue, Xue, Xue, Xue, Xue, Xue, Xue, Xue, Xue, Xue, Xue, Xue, Xue, Xue, Uue, Uhe, Tb^Tf, Uue, Sm, Uue, Cud, Wwb, Wwb, Uue, Uue, Uue^Edt, Uue, Wwb, Uhe, Xue, Uhe, Uhe, Uhe, Uhe, Xue, Xue, Uhe, Uhe, Uue, Uhe, Uhe, Xue, Xue, Xue, Xue, Xue, Xue, Xue
Xue, Xue, Xue, Xue, Xue, Xue, Xue, Xue, Xue, Xue, Xue, Xue, Xue, Xue, Xue, Xue, Uue, Xue, Uue, Uhe, Uhe, Uhe, Uue, Uue, Uue, Uue, Wwb, Sm, Sm, Wwb, Wwb, Uue, Uue, Uue^Vu, Wwb, Wwb, Uhe, Uhe, Uue, Uue, Re, Uhe, Uhe, Uue, Uhe, Uue, Uue, Uue, Uhe, Xue, Xue, Xue, Xue, Xue, Xue, Xue
Xue, Xue, Xue, Xue, Xue, Xue, Xue, Xue, Xue, Xue, Xue, Xue, Xue, Uhe, Uhe, Uhe, Uue, Uue, Uhe, Uue, Uue, Uue, Uue, Uhe, Uhe, Uue, Uue, Wwb, Sm, Sm, Uue, Uue, Uue, Wwb, Wwb, Uue, Re, Uue, Re, Re, Uue, Uhe, Uue, Uhe, Uue^Emf, Uue, Re, Uue, Uue, Uhe, Uhe, Xue, Xue, Xue, Xue, Xue
Xue, Xue, Xue, Xue, Xue, Xue, Xue, Xue, Xue, Xue, Xue, Xue, Uhe, Uhe, Uue, Uue, Uhe, Uue, Wwb, Uue^Vu, Uue, Uhe, Uue, Uue^Tf, Uue, Uue, Uue, Sm, Sm, Sm, Uue, Uue, Uue^Tf, Uue^Emf, Uue, Re, Re, Re, Uue, Uue, Uhe, Uue, Uue, Uue^Tf, Uue, Uue, Re, Re, Uue, Uue, Uhe, Xue, Xue, Xue, Xue, Xue
Xue, Xue, Xue, Xue, Xue, Xue, Xue, Xue, Xue, Xue, Xue, Xue, Uue, Uhe, Uue, Uue, Uue, Wwb, Wwb, Wwb, Sm, Uue, Uue, Uue, Sm, Uue, Uhe, Uue, Sm, Sm, Uue, Uue, Re, Tb^Tf, Uue, Cud, Uue^Dr, Re, Re, Re, Re, Uue, Uue, Uue, Uue, Re, Uue, Re, Re, Uue, Uhe, Xue, Xue, Xue, Xue, Xue
Xue, Xue, Xue, Xue, Xue, Xue, Xue, Xue, Xue, Xue, Uhe, Uue, Uue, Re, Uue, Tb^Tf, Uue, Wwb, Wwb, Wwb, Sm, Sm, Sm, Sm, Uue, Uhe, Re, Uue, Uue, Uue, Re, Re, Re, Uue^Tf, Uue, Uue, Uue^Tf, Re, Re^Tf, Re^Tf, Re, Re, Uue, Sm, Sm, Uue, Uue, Uhe, Uue, Uhe, Uhe, Xue, Xue, Xue, Xue, Xue
Xue, Xue, Xue, Xue, Xue, Xue, Xue, Xue, Xue, Uhe, Uue, Uue, Re, Uue, Uue, Uhe, Uue, Sm, Sm, Wwb, Sm, Sm, Uue, Uue, Uhe, Uhe, Re, Cud, Uue, Uue, Re, Re, Re, Re, Re^Emf, Uue^Tf, Uue^Emf, Uue^Emf, Uue, Re, Wwb, Uue, Sm, Sm, Wwb, Sm, Uue, Uhe, Uhe, Uue, Xue, Xue, Xue, Xue, Xue, Xue
Xue, Xue, Xue, Xue, Xue, Xue, Xue, Xue, Uhe, Uhe, Uue, Re, Re, Re, Uue, Uhe, Uhe, Uue, Sm, Wwb, Sm, Uue, Uue, Uue, Uue, Uue, Re, Re, Uue^Dr, Re, Uue, Uue, Re, Re, Re, Re, Uue, Uue^Tf, Wwb, Wwb, Wwb, Wwb, Wwb, Sm, Wwb, Sm, Uue, Uhe, Uue, Xue, Xue, Xue, Xue, Xue, Xue, Xue
Xue, Xue, Xue, Xue, Xue, Xue, Xue, Xue, Xue, Xue, Uue, Tb^Tf, Re, Re, Uue^Tf, Uue, Uue, Uue, Uue, Sm, Uue, Uue, Re, Re, Re, Re, Re, Re, Uue, Re, Uue, Re, Re, Re, Re, Re, Wwb, Wwb, Re, Uue, Sm, Wwb, Wwb, Wwb, Wwb, Wwb, Uue, Uhe, Uue, Xue, Xue, Xue, Xue, Xue, Xue, Xue
Xue, Xue, Xue, Xue, Xue, Xue, Xue, Xue, Xue, Xue, Uhe, Tb^Tf, Re, Re, Tb^Tf, Tb^Tf, Uue, Xue, Xue, Uue, Uue, Re, Wwb, Re, Re, Re, Re, Re, Uue, Uue, Uue, Re, Uue^Tf, Uue, Re, Re, Wwb, Wwb, Uue, Uue^Vu, Sm, Wwb, Sm, Sm, Wwb, Wwb, Wwb, Uue, Xue, Xue, Xue, Xue, Xue, Xue, Xue, Xue
Xue, Xue, Xue, Xue, Xue, Xue, Xue, Xue, Xue, Xue, Uhe, Re, Uue, Re^Tf, Uue^Tf, Tb^Tf, Tb^Tf, Xue, Xue, Uue, Uhe, Uue, Uue, Wwb, Re, Uue^Vu, Uue, Uue^Emf, Uue, Re, Uue, Uue, Uue, Uue, Uue, Re^Tf, Wwb, Wwb, Uue, Uue, Uue, Uhe, Uhe, Sm, Sm, Wwb, Xue, Xue, Xue, Xue, Xue, Xue, Xue, Xue, Xue, Xue
Xue, Xue, Xue, Xue, Xue, Xue, Xue, Xue, Xue, Xue, Uhe, Uue, Uue, Re, Re^Emf, Tb^Tf, Uue, Uue^Emf, Xue, Xue, Uhe, Uhe, Uue, Wwb, Wwb, Uue, Uue, Uue^Emf, Re, Re, Re, Uue, Uue, Uue, Uue, Uue, Uue, Wwb, Tb^Tf, Uue^Dr, Xue, Uhe, Uhe, Uue, Xue, Xue, Xue, Xue, Xue, Xue, Xue, Xue, Xue, Xue, Xue, Xue
Xue, Xue, Xue, Xue, Xue, Xue, Xue, Xue, Xue, Xue, Xue, Xue, Uue, Uue, Uue, Re^Tf, Uhe, Uue^Tf, Xue, Xue, Re, Uhe, Uue, Uue^Tf, Uue, Uue, Uue, Re, Re, Re, Uue, Uue^Tf, Wwb, Sm, Wwb, Re, Re, Re^Emf, Tb^Tf, Uhe, Uhe, Xue, Xue, Xue, Xue, Xue, Xue, Xue, Xue, Xue, Xue, Xue, Xue, Xue, Xue, Xue
Xue, Xue, Xue, Xue, Xue, Xue, Xue, Xue, Xue, Xue, Xue, Xue, Xue, Xue, Xue, Re, Uhe, Uue, Uue, Uue^Emf, Re, Re, Wwb, Uue^Tf, Uue^Dr, Uue, Uhe, Uue, Re, Re, Uue, Uue, Wwb, Wwb, Wwb, Uue, Re, Re^Tf, Re^Tf, Uue, Uhe, Xue, Xue, Xue, Xue, Xue, Xue, Xue, Xue, Xue, Xue, Xue, Xue, Xue, Xue, Xue
Xue, Xue, Xue, Xue, Xue, Xue, Xue, Xue, Xue, Xue, Xue, Xue, Xue, Xue, Uhe, Uhe, Re, Uue^Vu, Re, Uue, Wwb, Wwb, Uue, Uue, Uue, Uhe, Uue, Re, Uue, Re, Re, Uue, Sm, Wwb, Wwb, Uue, Uue, Re, Re^Emf, Uue, Uue, Uhe, Xue, Xue, Xue, Xue, Xue, Xue, Xue, Xue, Xue, Xue, Xue, Xue, Xue, Xue
Xue, Xue, Xue, Xue, Xue, Xue, Xue, Xue, Xue, Xue, Xue, Xue, Xue, Xue, Uhe, Uhe, Uhe, Re, Re, Re, Wwb, Wwb, Uue, Uhe, Uhe, Wwb, Wwb, Uue^Vu, Uue, Re, Re, Uue, Sm, Wwb, Wwb, Wwb, Uue, Uue, Tb^Tf, Re, Re, Uue, Uue, Xue, Xue, Xue, Xue, Xue, Xue, Xue, Xue, Xue, Xue, Xue, Xue, Xue
Xue, Xue, Xue, Xue, Xue, Xue, Xue, Xue, Xue, Xue, Xue, Xue, Xue, Xue, Xue, Uhe, Xue, Uue, Uue, Uue, Wwb, Uhe, Uue, Uue, Uue, Wwb, Wwb, Uue, Re, Re, Re, Uue, Uue, Uue, Uue, Uue, Xue, Uue^Tf, Uue, Uue, Uhe, Uhe, Xue, Xue, Xue, Xue, Xue, Xue, Xue, Xue, Xue, Xue, Xue, Xue, Xue, Xue
Xue, Xue, Xue, Xue, Xue, Xue, Xue, Xue, Xue, Xue, Xue, Xue, Xue, Xue, Xue, Xue, Xue, Uhe, Uhe, Uue, Uhe, Uhe, Uue, Xue, Uue, Uhe, Uue, Re, Re, Re, Re, Uue^Tf, Uhe, Uue, Uue, Xue, Xue, Uhe, Uhe, Uue, Xue, Xue, Xue, Xue, Xue, Xue, Xue, Xue, Xue, Xue, Xue, Xue, Xue, Xue, Xue, Xue
Xue, Xue, Xue, Xue, Xue, Xue, Xue, Xue, Xue, Xue, Xue, Xue, Xue, Xue, Xue, Xue, Xue, Xue, Uhe, Uue^Tf, Uue^Tf, Uue, Xue, Xue, Xue, Uue, Tb^Tf, Re, Re, Re, Uue, Uue, Uhe, Uue, Xue, Xue, Xue, Xue, Xue, Xue, Xue, Xue, Xue, Xue, Xue, Xue, Xue, Xue, Xue, Xue, Xue, Xue, Xue, Xue, Xue, Xue
Xue, Xue, Xue, Xue, Xue, Xue, Xue, Xue, Xue, Xue, Xue, Xue, Xue, Xue, Xue, Xue, Xue, Xue, Uhe, Uhe, Uue, Uue, Uue, Xue, Xue, Xue, Uhe, Uue, Re, Re, 1 Re, Uue, Uue, Uhe, Xue, Xue, Xue, Xue, Xue, Xue, Xue, Xue, Xue, Xue, Xue, Xue, Xue, Xue, Xue, Xue, Xue, Xue, Xue, Xue, Xue, Xue
Xue, Xue, Xue, Xue, Xue, Xue, Xue, Xue, Xue, Xue, Xue, Xue, Xue, Xue, Xue, Xue, Xue, Xue, Xue, Xue, Xue, Uue, Xue, Xue, Xue, Xue, Uhe, Uue, Uhe, Re, Re, Re, Uue, Uhe, Uhe, Xue, Xue^Zok, Xue, Xue, Xue, Xue, Xue, Xue, Xue, Xue, Xue, Xue, Xue, Xue, Xue, Xue, Xue, Xue, Xue, Xue, Xue
Xue, Xue, Xue, Xue, Xue, Xue, Xue, Xue, Xue, Xue, Xue, Xue, Xue, Xue, Xue, Xue, Xue, Xue, Xue, Xue, Xue, Xue, Xue, Xue, Xue^Zok, Xue^Zok, Uhe^Zok, Uhe, Uue, Re, Re, Uue, Re, Uhe, Uhe^Zok, Uhe^Zok, Xue^Zok, Xue, Xue, Xue, Xue, Xue, Xue, Xue, Xue, Xue, Xue, Xue, Xue, Xue, Xue, Xue, Xue, Xue, Xue, Xue
Xue, Xue, Xue, Xue, Xue, Xue, Xue, Xue, Xue, Xue, Xue, Xue, Xue, Xue, Xue, Xue, Xue, Xue, Xue, Xue, Xue, Xue, Xue^Zok, Xue^Zok, Xue^Zok, Uhe^Zok, Uhe^Zok, Uue^Zok, Uue^Zok, Re, Uue, Re, Uue^Zok, Uue^Zok, Uhe^Zok, Uhe^Zok, Xue^Zok, Xue, Xue, Xue, Xue, Xue, Xue, Xue, Xue, Xue, Xue, Xue, Xue, Xue, Xue, Xue, Xue, Xue, Xue, Xue
Xue, Xue, Xue, Xue, Xue, Xue, Xue, Xue, Xue, Xue, Xue, Xue, Xue, Xue, Xue, Xue, Xue, Xue, Xue, Xue, Xue, Xue, Xue, Xue^Zok, Xue^Zok, Uue^Zok, Uhe^Zok, Uhe^Zok, Uue^Zok, Re^Zok, Uue^Zok, Uue^Zok, Uhe^Zok, Uhe^Zok, Xue^Zok, Xue^Zok, Xue, Xue, Xue, Xue, Xue, Xue, Xue, Xue, Xue, Xue, Xue, Xue, Xue, Xue, Xue, Xue, Xue, Xue, Xue, Xue
