Ds^Es, Ds, Ds, Gs, Gs, Ds, Gs, Ds, Ds, Qxe, Ds^Esd, Ds, Ds, Ds, Hhd, Hhd, Gs, Gd, Gs, Qxe, Qxe, Ds, Gs, Gd, Gs, Ds, Ds, Gg, Gd, Hhd, Hhd, Hhd, Hhd, Hhd, Mm, Mm, Mm, Mm, Mm^Xm, Mm^Xm, Mm, Mm, Mm, Mm, Mm, Mm, Mm^Xm, Mm^Xm, Mm^Xm, Mm, Mm, Mm^Xm, Mm^Xm, Mm^Xm, Mm^Xm
Ds^Esd, Gs^Esd, Gd, Gs, Hhd, Hhd, Ds, Ds^Es, Qxe, Gd^Esd, Gd^Edb, Gs, Gd, Gd^Esd, Gd^Es, Gd, Gd, Gd, Gd, Ds, Qxe, Gd, Ds^Es, Gd, Gd, Ds^Esd, Gs, Gd, Gg, Hhd, Hhd, Hhd, Hhd, Hhd, Mm, Mm, Hh, Mm^Xm, Mm^Xm, Mm^Xm, Hh, Hh, Hh, Hh, Mm, Mm^Xm, Mm^Xm, Mm^Xm, Mm, Mm, Hh, Mm, Mm^Xm, Mm^Xm, Mm
Ds, Gd, Qxe, Qxe, Ds^Esd, Hhd, Ds^Es, Ds, Qxe, Qxe, Ds^Edb, Gd^Edb, Ds^Esd, Gd, Gs, Gd, Qxe, Qxe, Gd, Gs, Gs, Gd, Gs, Gs^Edb, Gd^Edb, Gs^Esd, Gs, Gs, Hhd, Hhd, Hhd, Hhd, Mm, Mm, Hh, Hh, Hh, Mm, Mm, Mm, Hh, Hh^Fp, Hh^Fp, Hh, Mm, Mm, Mm^Xm, Mm, Hh, Hh, Hh, Mm, Mm^Xm, Mm^Xm, Mm
Gs, Qxe, Qxe, Qxe, Ds^Edb, Gs, Ds, Ds, Qxe, Qxe, Ds, Ds^Es, Ds, Ds^Esd, Ds, Qxe, Qxe, Qxe, Gs, Gd, Hhd, Ds^Es, Gd, Gd^Edb, Gd^Edb, Gs^Fdw, Gs, Gs, Hhd, Hhd, Mm, Mm, Hh, Hh, Hh, Hh^Fp, Hh, Hh, Mm, Hh, Hh^Fp, Hh, Hh, Hh, Mm, Mm, Hh, Hh, Hh, Hh, Hh, Mm, Mm, Mm, Hh
Gd, Qxe, Qxe, Qxe, Gd^Edb, Gd^Edb, Ds^Esd, Gs, Gd, Qxe, Ds, Ds^Esd, Ds, Ds^Es, Qxe, Qxe, Qxe, Ds^Esd, Gs, Hhd, Ds, Ds, Qxe, Qxe, Gd^Edb, Gd, Gg, Gs, Hh, Mm, Hh, Hh, Hh, Hh^Fp, Hh^Fmw, Hh, Mm, Mm, Hh, Hh, Hh^Fmw, Hh^Fmw, Mm, Mm, Hh, Hh^Fp, Hh, Hh, Gg, Hh, Hh, Hh, Mm, Mm, Hh
Gd, Qxe, Gs^Es, Gd^Edb, Gd^Edb, Ds, Ds^Es, Gs^Esd, Gd, Ds, Gs, Qxe, Qxe, Ds, Qxe, Qxe, Gs, Ds^Es, Gd, Gs, Gs, Ds^Es, Qxe, Qxe, Gd, Gd^Fdw, Gg, Gs, Hh, Hh, Gs, Gs, Hh, Gll^Fmw, Gll^Fp, Gll^Fp, Hh, Hh, Gll^Fmw, Gll^Fmw, Hh^Fp, Mm, Hh, Hh, Gll^Fp, Hh^Fp, Hh, Gg, Gs, Gg, Hh, Hh, Mm, Hh, Hh
Ds^Esd, Gd, Gs^Es, Gd, Gd, Ds^Es, Ds, Hhd, Hhd, Gd, Qxe, Qxe, Qxe, Gd, Gd, Gd, Gd, Gd, Qxe, Gd, Ds^Es, Gs, Gd^Edb, Gd^Edb, Gd^Fdw, Gd, Gs, Hh, Gg, Gs, Gs, Gs, Gs, Gll^Fp, Gs, Gll^Fp, Gs, Gll^Fp, Gg, Gll^Fmw, Hh^Fp, Gg, Gg, Gg, Gs, Gll^Fp, Gs, Gg, Gs, Gs, Gg, Hh, Hh, Hh, Gll^Fp
Gg, Gs, Ds^Esd, Gd, Qxe, Qxe, Ds^Es, Hhd, Gs, Ds, Qxe, Qxe, Ds, Gd, Gd, Gd^Edb, Gd^Edb, Qxe, Ds^Esd, Ds^Esd, Gs, Gs^Esd, Gs, Gd^Edb, Gs, Gd^Fdw, Re, Gg, Gd, Gd, Gd^Fmw, Gd^Fdw, Gd^Fdw, Gd, Gs, Gg, Gs, Gg, Gll^Fp, Gll^Fp, Gs, Gs, Gs, Gs, Gs, Gll, Gll^Fmw, Gll^Fp, Gg, Gs, Gg, Hh, Hh, Hh^Fp, Gll^Fp
Gs, Gd, Gd, Gd, Qxe, Qxe, Ds, Gs, Gs^Esd, Ds^Esd, Qxe, Qxe, Ds^Es, Gs, Gd^Esd, Gd^Edb, Qxe, Qxe, Ds^Es, Gs, Gs, Gd, Gs^Fdw, Gs, Gd^Edt, Gd, Re, Qxe, Qxe, Gll^Fdw, Gd^Fmw, Gd^Fdw, Gd^Fdw, Gd, Gs, Gll^Fdw, Gd^Fdw, Gs, Gd, Gs, Qxe, Gll^Fp, Gs, Gll^Fp, Gd, Gll, Gll^Fp, Gg, Gs, Gg^Efm, Gg^Efm, Gg, Gg, Gll^Fp, Gd^Fmw
Gs, Gd^Fdw, Gd^Fdw, Ds^Esd, Gd^Esd, Ds^Es, Ds^Es, Ds^Esd, Qxe, Ds, Ds^Es, Ds, Gs, Gs, Ds, Qxe, Gs, Ds, Gd, Gd^Esd, Gd^Fdw, Gd, Gs^Fdw, Gs^Edt, Gd^Edt, Gg, Chr^Edt, Re, Qxe, Gd^Fdw, Gll^Fp, Gd, Gd^Fdw, Gll^Fdw, Gd, Gs, Gd^Fdw, Gs, Gd^Fmw, Gd^Fdw, Qxe, Gd, Gd, Gs, Gd, Gll, Gd, Gll^Fmw, Gs, Gs, Gg, Gll^Fp, Gll^Fp, Gd^Fmw, Gll^Fmw
Gs, Gs^Fdw, Gd^Fdw, Gs, Gs, Gd, Qxe, Ds, Qxe, Qxe, Ds, Ds^Esd, Gs, Ds^Esd, Gd, Gd, Gd, Gd, Gd^Fdw, Gd, Gs, Gd^Edb, Gd^Edb, Gs, Ch, Chr^Edt, Gd^Edt, Ch, Qxe, Qxe, Chr, Chr, Chr^Edt, Gd^Fdw, Ch, Gd, Gll^Fp, Gll^Fdw, Qxe, Qxe, Chr, Chr, Chr, Gd, Qxe, Gd, Gd, Gg, Ch, Gg, Gs, Gs, Gll^Fmw, Gll^Fp, Gll^Fmw
Gg, Gs, Gs, Gs, Gs, Gd, Gd, Ds, Qxe, Qxe, Gd^Edb, Qxe, Qxe, Ds^Esd, Gd, Qxe, Gd^Es, Gs^Fdw, Gd^Fdw, Gs, Gs, Gd^Edb, Re, Chr, Gd^Fdw, Gd^Fdw, Gs, Gs, Rr, Qxe, Qxe, Khr, Ch^Edt, Chr, Gd^Fdw, Chr, Chr, Qxe, Qxe, Chr, Yhs, Yhs, Gd^Fdw, Chr, Qxe, Qxe, Chr, Ch, Gs, Chr, Chr, Gll^Fp, Gs, Gd^Fmw, Gll^Fp
Gs, Gg, Ds^Esd, Gs, Gs, Gd^Fdw, Gd^Edb, Gd^Edb, Gd, Gs, Gs^Edb, Gd^Edb, Qxe, Qxe, Qxe, Qxe, Gd^Edb, Gd^Edb, Gs^Fdw, Gd^Fdw, Re, Gd^Edt, Re, Chr, Gd^Fdw, Qxe, Qxe, Re, Re, Gd, Gd, Ch, Rr^Edt, Rp^Edt, Gd^Fdw, Gd^Fdw, Qxe, Qxe, Chr, Yhs, Yhs, Gll^Fdw, Gd^Fdw, Chr, Qxe, Qxe, Qxe, Gd, Gd, Gs, Gs, Ch, Gs, Gd^Fmw, Gg
Ds, Gs, Ds, Gg, Gs, Gd, Gs^Edb, Gs^Edb, Gd^Fdw, Gd, Gd^Fdw, Gd, Gd, Gd, Gd, Qxe, Qxe, Gd^Edb, Gd^Edb, Gd^Edb, Re, Re, Qxe, Qxe, Gd, Gs, Qxe, Re^Dr, Re^Edt, Gd, Wwg, Wwg, Rp, Rr^Edt, Rr, Rr, Ch, Chr, Re^Fdw, Yhs, Re, Re^Fdw, Gd^Fetd, Chr, Qxe, Qxe, Qxe, Qxe, Gd, Gs, Gs, Ch, Gg, Gll^Fp, Gg
Ds^Es, Ds^Esd, Ds, Gs^Esd, Gs, Gs, Ds^Edb, Gs^Edb, Gs, Gs, Gs, Gd, Gs^Es, Gs^Es, Gd^Es, Qxe, Qxe, Qxe, Qxe, Gd, Chr, Qxe, Gd, Gd^Edt, Re^Edt, Re, Qxe, Re^Edt, Gd^Edt, Wwg^Ewl, Wwg, Gs, Rp^Edb, Rr^Edb, Rr^Edb, Chr, Re^Fdw, Re, Re^Fdw, Gd^Fdw, Re, Re^Fdw, Re^Fdw, Re, Qxe, Qxe, Gd^Edt, Qxe, Qxe, Gd, Gs, Chr, Chr, Gs, Gs
Wwg, Ds, Ds, Ds^Esd, Ds^Es, Ds^Edb, Ds^Esd, Gs, Gs, Gg, Gs^Edb, Gd^Edb, Gs, Gd, Gd, Gd, Re, Re, Chr, Qxe, Re, Re, Wwf^Es, Rr^Edt, Re^Edt, Re^Dr, Gd, Gd^Edt, Wwg, Wwg, Gd, Gd, Qxe, Rr^Edb, Rr^Edb, Gll^Fdw, Gd^Fetd, Re, Re, Re, Re, Re, Re^Edt, Re, Chr, Rr^Edt, Rr^Vhcr, Gd^Edt, Gd, Gd, Gs, Gd, Gs, Ch, Chr
Wog, Wwg, Wwg, Ds, Ds, Ds, Ds, Ds^Es, Ds^Esd, Gs, Gg, Gs^Edb, Gd^Es, Re^Dr, Re, Ch, Chr, Qxe, Rp, Re^Edt, Re^Edt, Wwf, Wwf, Rr, Wwg, Wwf^Es, Wwg, Wwg, Chr, Gs, Gd, Qxe, Qxe, Rr^Edb, Chr, Re^Edb, Re^Edt, Re, Ch, Chr, Chr^Edt, Re, Rr^Edt, Rp, Rr, Rr^Edt, Rr^Edt, Rp^Edt, Chr, Gs, Gll^Fmw, Gd, Gs, Gll^Fdw, Gll^Fp
Wog, Wog, Wog, Wwg, Wwg, Wwrg, Wwrg, Ds, Ds, Gs, Gg, Gs, Re^Edt, Re, Chr, Khr, Chr, Re, Re^Edb, Re^Edt, Re^Edt, Re^Es, Wwf^Es, Wwrg, Wwg, Wwg, Rr^Edb, Gs^Edb, Gs^Edb, Gs^Edt, Rr^Edt, Qxe, Rr, Rr, Rr, Re^Edt, Ch^Edt, Ch, Khr^Egk, Ch^Edt, Ch^Edt, Chr^Edt, Rr, Rr^Edt, Gd^Fdw, Gd^Fdw, Gd^Fdw, Rr, Rr^Edb, Rp^Edb, Rr, Qxe, Gd, Gll^Fdw, Gll^Fdw
Wwg, Wog, Wwg, Wog, Wog, Wog, Wwrg, Wwg, Wwg^Ewl, Ds^Esd, Gs, Gd^Edt, Gs^Edt, Gd, Gd^Dr, Re, Chr, Rr, Re^Edb, Re^Dr, Re, Wwf^Es, Wwg, Wwg, Chw, Wwf, Gs^Edb, Rr^Edb, Rr, Rr^Edt, Gs, Qxe, Rp, Rr^Edt, Rr^Edt, Chr^Edt, Rr, Khr, 1 Khr, Khr^Egk, Rr, Rr, Rr^Edt, Rr, Wwf, Gd^Fdw, Chr, Yhs, Qxe, Rr^Edb, Qxe, Qxe, Rr^Edb, Gd, Gs
Wwg, Wog, Wwg, Wwg, Wwg, Wwg, Wwg, Wwg, Wwg, Wwrg, Wwg^Ewl, Gs^Edt, Gs^Edb, Gs^Edt, Re^Edt, Re, Gd, Chr, Ch^Edb, Re^Edb, Ds, Ds, Wwg, Wwg, Ds, Wwf, Wwf^Es, Wwf, Wwf, Wwf^Es, Rr, Gd, Gs, Chr^Edt, Ch^Edt, Rr, Rr, Khr^Egk, Khr, Khr, Ch, Chr, Rp^Edt, Rr^Edt, Rp, Wwf^Ewl, Wwf^Edb, Yhs^Edb, Yhs^Edb, Qxe, Qxe, Rp^Edb, Gd^Vhr, Rr^Edb, Rr
Wwg, Wog, Wwg, Ds^Es, Ds, Gs, Gll, Wwrg, Wwg, Ds, Wwg^Ewl, Ds, Ds^Esd, Gs^Edt, Gs^Edt, Gd^Es, Gd^Edb, Gs^Edb, Ds, Chw^Edb, Chw, Wwrg, Wwg, Wwg, Wwg, Ds, Wwg, Wwrg, Wwg, Wwf^Es, Ww^Dr, Rr^Vhcr, Wwrg, Gll^Fp, Wwf, Chw, Wwf, Rr, Chw, Chw, Gd^Fmw, Gd, Rp, Rr^Edt, Rp^Edt, Gd^Fetd, Wwf, Wwg, Chw, Yhs, Qxe, Gd^Fetd, Gll^Fdw, Gll^Fdw, Re
Gs^Fmw, Wwg, Wwg, Wwg, Wwg, Gll^Fp, Gll^Fp, Gll, Gs, Wwg, Wwg, Wwg, Wwg, Gs, Gs, Gd, Gd, Ds^Edb, Ds, Ds, Wwrg, Wwrg, Wog, Wog, Wog, Wwg, Wog, Wog, Wog, Wwg, Wog, Wwg, Wwg, Wwg, Wwrg, Wwf, Wwf, Rb, Wwg, Wwf, Wwf, Gd, Chw, Rr^Edt, Rp^Edt, Wwf, Wwg, Wwg^Ewl, Wwg, Yhs^Xp, Yhs^Edt, Qxe, Gll^Fdw, Wwf, Wwf
Gs^Fdw, Wwrg, Wwg, Wog, Wwg, Ds, Ds, Gll^Fp, Gs^Es, Ds, Wwg, Wog, Wog, Wwg, Wwg, Ds^Esd, Ds, Ds^Esd, Wwg, Wwg, Wog, Wog, Wwg, Wog, Wwg, Wog, Wwg, Wog, Wwg, Wog, Wwg, Wog, Wog, Wwg, Wwg, Wwf, Wwf, Wwf, Wwg, Wwg, Wwg, Wwg, Wwf, Rr^Edt, Chw, Gd^Fetd, Wwg, Wwg, Wwf^Ewl, Yhs^Edt, Yhs^Edt, Gd^Fetd, Wwf, Wwf, Gd^Fmw
Re^Dr, Gs, Wwg^Ewl, Wog, Wog, Wwg, Wwrg, Gll^Fp, Ds^Esd, Gs^Esd, Wwg, Wog, Wog, Wog, Wog, Wwg, Wwg, Wwg, Wwg, Wog, Wog, Wog, Wwrg, Wwrg, Wwg, Wwg, Wwf^Es, Wwg, Ww^Dr, Wwg, Wwrg, Wwg, Wog, Wwg, Wwg, Wwrg, Wwf, Wwg, Wwrg, Wwg, Wwg, Wwf, Wwg, Wwrg, Wwrg, Wwrg, Wwg, Wwf^Edb, Yhs^Edb, Yhs^Edt, Yhs^Xp, Gll^Fdw, Wwf, Gd^Vhr, Gll^Fp
Re, Gs, Gg, Wwg, Wwg, Wog, Wwg, Wwg, Wwg, Ds, Wwg, Wwg, Wwg, Wog, Wog, Wog, Wog, Wog, Wog, Wog, Wwg, Wwg, Wwg, Wwg, Wwf, Wwf^Es, Wwf^Edb, Wwf^Es, Wwf^Edb, Ds^Edb, Ds^Edb, Wwrg, Wog, Wog, Wwg, Wwg, Chr, Chr, Chr, Wwf, Wwg, Wwg, Wog, Wwg, Wwg, Wwg, Wwg, Wwrg^Edb, Yhs^Edb, Yhs^Xp, Wwf, Wwf, Wwf, Gs, Gll^Fp
Re, Re^Es, Wwg, Wwrg, Wwf^Ewl, Wwg, Wwrg, Wog, Wwg, Wwrg, Wwrg, Wwg, Wwg, Wwg, Wwg, Wog, Wwg, Wwg, Wwg, Wwg, Ds, Ch, Wwrg, Wwg, Wwrg, Wwf^Edb, Ds^Edb, Wwf^Es, Ds, Ds^Edb, Wwf^Edb, Wwrg, Wog, Wog, Wwg, Chw, Chw, Khr, Ch, Wwrg, Wwrg, Wwg, Wog, Wog, Wog, Wwg, Wwg, Wwrg, Wwf, Wwrg, Wwg, Wwf, Wwrg, Chw, Gll^Fp
Wwrg, Wwg^Bw\, Re, Re^Dr, Gs, Gs, Gs, Wwg^Ewl, Ds^Esd, Ds, Ds, Ds^Esd, Gg, Wwg^Ewl, Gg, Wwg, Chw, Wwrg, Gg, Ds^Esd, Gll^Fp, Chr, Ch, Wwg, Rr^Vd, Wwf^Es, Ds, Ds^Esd, Gg, Ds^Dr, Wwf, Wwg, Wwg, Wog, Wog, Wwg, Wwrg, Ch, Khr, Chr, Chw, Wwg, Wwg, Wog, Wog, Wwg, Wwg, Wwg, Wwg^Es, Wwg, Wwg, Wwg, Wwg, Wwg, Wwg
Re^Edb, Re^Edb, Re^Edt, Re, Re^Edt, Re, Re, Gs, Gs, Ds^Es, Gs, Gs, Gs, Gg, Gg, Gs, Gg, Rp, Rp, Gg, Gll^Fp, Gll^Fp, Chr, Gs^Fms, Gs^Fms, Ds^Edb, Rp, Rr, Rr^Edb, Gs^Fds, Gs^Fms, Wwf^Edb, Wwrg, Wwg, Wwg, Wwg, Wwg, Ch, Chr, Chr, Wwrg, Chw, Wwg, Wog, Wog, Wog, Wwg, Wwg, Rp^Edt, Wwg, Gs^Edt, Wwf^Edt, Wwg, Wwg, Wwg
Re, Re, Re^Edt, Re^Edt, Gs^Edt, Re, Gg, Re, Re, Gg, Gs, Re, Re, Re, Qxe, Gs, Gs, Rp, Rp, Gll^Fp, Gll^Fp, Gll^Fp, Chr, Gll^Fp, Gll^Fp, Gd^Vhr, Gs^Fms, Rr^Edb, Rr^Edb, Rr^Edb, Rr, Gs^Fmw, Wwf, Wwg, Chw, Wwg, Wwg, Wwf, Wwg, Wwrg, Wwg, Wwrg, Wwg, Wwg, Wog, Wwg, Wwg, Wwf^Edt, Rp^Edt, Gd^Vhr, Gd^Fmw, Wwf^Edt, Wwf^Ewl, Wwrg, Wwf^Edt
Gg, Re, Gg, Gs^Edt, Gg, Gs, Qxe, Gg, Gs, Re, Re, Re, Re^Edt, Re^Edt, Qxe, Qxe, Re^Dr, Gs, Gs, Rp, Gll^Fp, Gll^Fp, Qxe, Qxe, Gll^Fp, Gll^Fp, Gs^Fms, Gs^Fds, Gs^Fds, Rr, Rr^Edt, Rr, Wwf, Rp, Rr, Wwg, Wwf, Wwg, Wwg, Wwg, Wog, Wwg, Wog, Wwg, Wwg, Wwg, Wwg, Wwrg, Chw, Gd^Fmw, Gd^Fmw, Gs^Edt, Gd^Vhr, Gd^Edt, Gd^Edt
Gs, Gg, Gd, Gs, Gll^Fp, Qxe, Gd^Fmw, Qxe, Qxe, Gs, Gs, Re, Re^Edb, Re^Edt, Re^Dr, Re^Edt, Re^Edt, Re^Edt, Re, Rp, Re, Gll^Fp, Qxe, Qxe, Qxe, Ch, Chr, Gs^Fms, Rr^Vhcr, Gs^Fds, Rp, Wwf, Rr^Edb, Rr, Rr, Wwf, Wwg, Wwg, Wwrg, Wwg, Wwg, Wog, Wwg, Wwg, Chw, Wwg, Wwg, Wwg^Es, Wwrg, Chw, Khw, Gd^Fmw, Gd^Fetd, Gs^Edt, Gd^Fmw
Gg, Gs, Gd, Gg, Gg, Gll^Fp, Gd^Fmw, Gll^Fp, Gg, Gd, Gs, Re, Gs^Edb, Re^Edb, Gd, Qxe, Gd, Gs^Edt, Gd, Re, Gd, Rp, Qxe, Qxe, Chr, Khr, Chr, Gs^Edb, Rp^Edb, Rr^Edb, Rr, Rr^Edb, Rr^Edb, Rr^Edb, Rr, Wwrg, Wwrg, Gg, Gs^Fds, Gs^Fds, Wwg, Wwg, Wwg, Chw, Wwf, Khw, Chw, Wwg, Wwrg, Wog, Chw, Gd^Fmw, Gs^Fdw, Gd^Fmw, Gd^Fmw
Chr, Gs, Gs, Gs, Gd^Vhr, Gll^Fp, Gll^Fp, Gs, Gs, Gs^Es, Re, Re, Gg, Gs^Es, Qxe, Qxe, Gd^Fmw, Gd^Fdw, Chr, Rp, Gs^Fdw, Gd, Rp, Gd, Gs, Chr, Gd, Ch, Re^Edt, Re, Rp^Edt, Rr^Edb, Rr^Vhcr, Gs^Fds, Gs^Fds, Rr, Rp, Gg, Gs^Fms, Gll^Fp, Gg, Wwrg, Wwg, Wwg, Wwrg, Chw, Wwrg, Wwg, Wwg, Wwrg, Wog, Khw, Chw, Gs, Gs
Gs, Rp, Rp, Gg, Gs, Gll^Fp, Gg, Gs, Gs^Edb, Gs^Es, Gd, Gs, Rp, Gs, Rp, Rp, Rp, Rp, Gll^Fdw, Gd^Fmw, Gd^Fdw, Gs, Gd, Rp, Rp, Gs, Rp, Re^Edt, Re^Edt, Rp, Gd, Gd^Edt, Gs, Gs^Fms, Gs^Edb, Rr^Edb, Rr, Gs^Fms, Gll^Fp, Gll^Fp, Gs^Edt, Wwrg, Wwg, Wwg, Wwg, Wwrg, Wwg, Wwg, Wwg, Wog, Wog, Wog, Wog, Wwrg, Wwg
Gd^Vhr, Gs, Rp^Edb, Gs, Gg, Gg, Gd, Gg, Rp^Edb, Rp^Edb, Rp, Rp, Gg, Rp, Gs^Dr, Rp, Gs, Rp, Gd, Gd^Fdw, Gd, Gs, Gs, Gs, Gd^Fetd, Rp^Edt, Re^Edt, Re^Edt, Rp, Chr, Chr, Chr, Chr, Gs, Gd^Edb, Rr^Edb, Rr, Gs, Gs, Gs^Edt, Gg^Edt, Wwf, Ss, Ss, Ss, Wwg, Wwg^Ewl, Wwg, Wwg, Wwg, Wwg, Wwg, Wwg, Wog, Wog
Gs, Gs^Edb, Gs^Edb, Rp, Gs, Gs, Rp, Rp, Gs, Rp, Gg, Gg, Qxe, Gs, Gs, Gg, Gg, Re, Gg^Edt, Rp, Re^Edt, Gd^Dr, Re^Edt, Gs, Rp, Rr^Edt, Re, Rr, Gd, Gll^Fdw, Qxe, Khr, Qxe, Gs, Gd^Vhr, Rp, Rr^Edt, Rp, Gs, Gs^Edt, Ss, Gg, Ss, Ss, Ss, Wwf, Wwf, Wwf^Ewl, Gs, Gll^Fp, Gll^Fp, Wwrg, Gd^Fmw, Wwg, Wwg
Gs, Gs, Gg, Rp, Rp, Rp, Gd, Gs, Gg^Edb, Gg, Gg, Gd, Qxe, Gs, Gg, Gs, Re, Gd^Edt, Gd^Edt, Gd, Gll^Fp, Rp^Edt, Gs, Re, Rp, Rp, Gs, Gd, Gd^Fdw, Qxe, Qxe, Qxe, Gll^Fp, Gll^Fp, Gs, Gs, Rp^Edt, Rr^Edt, Gs^Edt, Gg, Chs, Ss, Ss, Ss, Ss, Chr, Chr, Gs^Edt, Gd^Edt, Gll^Fp, Gll^Fp, Gd^Fmw, Gs^Fdw, Gd^Fmw, Gll^Fp
Re, Gg, Rr^Vd, Rp^Edt, Gs, Rp, Rp, Gs, Gs^Edb, Gs^Edb, Gg, Qxe, Gd, Gg, Gg, Gd, Gd, Gg, Qxe, Gg, Qxe, Gll^Fdw, Gd, Gs, Re^Edt, Rp^Edt, Gg, Gd^Fdw, Gd, Qxe, Qxe, Qxe, Gll^Fp, Gll^Fdw, Gll^Fp, Gg, Rp^Edb, Rr^Edt, Rr^Edb, Chr, Ss, Ss, Ss, Ss, Ss, Ss, Chs, Gs^Edt, Gs^Edt, Gs, Gll^Fp, Gd^Fmw, Gs^Fdw, Gd^Fmw, Gll^Fp
Gs, Gs, Rr, Rp, Gg, Gs, Gs, Chr, Gd^Fmw, Gd^Vhr, Gg, Qxe, Gg, Gll^Fp, Gll^Fp, Gll^Fdw, Gll^Fdw, Gll^Fp, Gg, Qxe, Qxe, Gs, Gd^Dr, Gg, Re, Gs^Dr, Qxe, Gs, Gg, Gll^Fdw, Qxe, Chr, Chr, Gd^Fmw, Gll^Fp, Gs, Rr^Vd, Rp^Edb, Rr^Edb, Khr, Rp, Ss, Chs, Khs, Ss, Ss, Ss, Gg, Ss, Gg, Gg, Gd^Fmw, Gll^Fp, Gll^Fp, Gg
Gg^Fet, Ce, Ce, Gg, Gg, Gd, Gg, Gg, Gll^Fp, Gll^Fp, Gd^Fmw, Qxe, Gg, Gll^Fp, Gll^Fdw, Gll^Fp, Gll^Fp, Gll^Fp, Gs, Qxe, Qxe, Qxe, Gs, Re, Rp, Gs, Qxe, Qxe, Gll^Fdw, Gd^Fmw, Gll^Fp, Gll^Fp, Qxe, Chr, Chr, Gs, Gs, Gs, Gg, Chr, Rp, Rp, Rr, Chs, Ss, Ss, Ss, Ss, Ss, Ss, Gs, Gll^Fp, Gs, Gs, Gg
