Ds^Es, Ds, Ds, Gs, Gs, Ds, Gs, Ds, Ds, Qxe, Ds^Esd, Ds, Ds, Ds, Hhd, Hhd, Gs, Gd, Gs, Qxe, Qxe, Ds, Gs, Gd, Gs, Ds, Ds, Gg, Gd, Hhd, Hhd, Hhd, Hhd, Hhd, Mm, Mm, Mm, Mm, Mm^Xm, Mm^Xm, Mm, Mm, Mm, Mm, Mm, Mm, Mm^Xm, Mm^Xm, Mm^Xm, Mm, Mm, Mm^Xm, Mm^Xm, Mm^Xm, Mm^Xm
Ds^Esd, Gs^Esd, Gd, Gs, Hhd, Hhd, Ds, Ds^Es, Qxe, Gd^Esd, Gd, Gs, Gd, Gd^Esd, Gd^Es, Gd, Gd, Gd, Gd, Ds, Qxe, Gd, Ds^Es, Gd, Gd, Ds^Esd, Gs, Gd, Gg, Hhd, Hhd, Hhd, Hhd, Hhd, Mm, Mm, Hh, Mm^Xm, Mm^Xm, Mm^Xm, Hh, Hh, Hh, Hh, Mm, Mm^Xm, Mm^Xm, Mm^Xm, Mm, Mm, Hh, Mm, Mm^Xm, Mm^Xm, Mm
Ds, Gd, Qxe, Qxe, Ds^Esd, Hhd, Ds^Es, Ds, Qxe, Qxe, Ds, Gd, Ds^Esd, Gd, Gs, Gd, Qxe, Qxe, Gd, Gs, Gs, Gd, Gs, Gs, Gd, Gs^Esd, Gs, Gs, Hhd, Hhd, Hhd, Hhd, Mm, Mm, Hh, Hh, Hh, Mm, Mm, Mm, Hh, Hh^Fp, Hh^Fp, Hh, Mm, Mm, Mm^Xm, Mm, Hh, Hh, Hh, Mm, Mm^Xm, Mm^Xm, Mm
Gs, Qxe, Qxe, Qxe, Ds^Esd, Gs, Ds, Ds, Qxe, Qxe, Ds, Ds^Es, Ds, Ds^Esd, Ds, Qxe, Qxe, Qxe, Gs, Gd, Hhd, Ds^Es, Gd, Gd, Gd, Gs^Fdw, Gs, Gs, Hhd, Hhd, Mm, Mm, Hh, Hh, Hh, Hh^Fp, Hh, Hh, Mm, Hh, Hh^Fp, Hh, Hh, Hh, Mm, Mm, Hh, Hh, Hh, Hh, Hh, Mm, Mm, Mm, Hh
Gd, Qxe, Qxe, Qxe, Gd, Gd, Ds^Esd, Gs, Gd, Qxe, Ds, Ds^Esd, Ds, Ds^Es, Qxe, Qxe, Qxe, Ds^Esd, Gs, Hhd, Ds, Ds, Qxe, Qxe, Gd, Gd, Gg, Gs, Hh, Mm, Hh, Hh, Hh, Hh^Fp, Hh^Fmw, Hh, Mm, Mm, Hh, Hh, Hh^Fmw, Hh^Fmw, Mm, Mm, Hh, Hh^Fp, Hh, Hh, Gg, Hh, Hh, Hh, Mm, Mm, Hh
Gd, Qxe, Gs^Es, Gd, Gd, Ds, Ds^Es, Gs^Esd, Gd, Ds, Gs, Qxe, Qxe, Ds, Qxe, Qxe, Gs, Ds^Es, Gd, Gs, Gs, Ds^Es, Qxe, Qxe, Gd, Gd^Fdw, Gg, Gs, Hh, Hh, Gs, Gs, Hh, Gll^Fmw, Gll^Fp, Gll^Fp, Hh, Hh, Gll^Fmw, Gll^Fmw, Hh^Fp, Mm, Hh, Hh, Gll^Fp, Hh^Fp, Hh, Gg, Gs, Gg, Hh, Hh, Mm, Hh, Hh
Ds^Esd, Gd, Gs^Es, Gd, Gd, Ds^Es, Ds, Hhd, Hhd, Gd, Qxe, Qxe, Qxe, Gd, Gd, Gd, Gd, Gd, Qxe, Gd, Ds^Es, Gs, Gd, Gd, Gd^Fdw, Gd, Gs, Hh, Gg, Gs, Gs, Gs, Gs, Gll^Fp, Gs, Gll^Fp, Gs, Gll^Fp, Gg, Gll^Fmw, Hh^Fp, Gg, Gg, Gg, Gs, Gll^Fp, Gs, Gg, Gs, Gs, Gg, Hh, Hh, Hh, Gll^Fp
Gg, Gs, Ds^Esd, Gd, Qxe, Qxe, Ds^Es, Hhd, Gs, Ds, Qxe, Qxe, Ds, Gd, Gd, Gd, Gd, Qxe, Ds^Esd, Ds^Esd, Gs, Gs^Esd, Gs, Gd, Gs, Gd^Fdw, Re, Gg, Gd, Gd, Gd^Fmw, Gd^Fdw, Gd^Fdw, Gd, Gs, Gg, Gs, Gg, Gll^Fp, Gll^Fp, Gs, Gs, Gs, Gs, Gs, Gll, Gll^Fmw, Gll^Fp, Gg, Gs, Gg, Hh, Hh, Hh^Fp, Gll^Fp
Gs, Gd, Gd, Gd, Qxe, Qxe, Ds, Gs, Gs^Esd, Ds^Esd, Qxe, Qxe, Ds^Es, Gs, Gd^Esd, Gd, Qxe, Qxe, Ds^Es, Gs, Gs, Gd, Gs^Fdw, Gs, Gd, Gd, Re, Qxe, Qxe, Gll^Fdw, Gd^Fmw, Gd^Fdw, Gd^Fdw, Gd, Gs, Gll^Fdw, Gd^Fdw, Gs, Gd, Gs, Qxe, Gll^Fp, Gs, Gll^Fp, Gd, Gll, Gll^Fp, Gg, Gs, Gg^Efm, Gg^Efm, Gg, Gg, Gll^Fp, Gd^Fmw
Gs, Gd^Fdw, Gd^Fdw, Ds^Esd, Gd^Esd, Ds^Es, Ds^Es, Ds^Esd, Qxe, Ds, Ds^Es, Ds, Gs, Gs, Ds, Qxe, Gs, Ds, Gd, Gd^Esd, Gd^Fdw, Gd, Gs^Fdw, Gs, Gd, Gg, Chr, Re, Qxe, Gd^Fdw, Gll^Fp, Gd, Gd^Fdw, Gll^Fdw, Gd, Gs, Gd^Fdw, Gs, Gd^Fmw, Gd^Fdw, Qxe, Gd, Gd, Gs, Gd, Gll, Gd, Gll^Fmw, Gs, Gs, Gg, Gll^Fp, Gll^Fp, Gd^Fmw, Gll^Fmw
Gs, Gs^Fdw, Gd^Fdw, Gs, Gs, Gd, Qxe, Ds, Qxe, Qxe, Ds, Ds^Esd, Gs, Ds^Esd, Gd, Gd, Gd, Gd, Gd^Fdw, Gd, Gs, Gd, Gd, Gs, Ch, Chr, Gd, Ch, Qxe, Qxe, Chr, Chr, Chr, Gd^Fdw, Ch, Gd, Gll^Fp, Gll^Fdw, Qxe, Qxe, Chr, Chr, Chr, Gd, Qxe, Gd, Gd, Gg, Ch, Gg, Gs, Gs, Gll^Fmw, Gll^Fp, Gll^Fmw
Gg, Gs, Gs, Gs, Gs, Gd, Gd, Ds, Qxe, Qxe, Gd, Qxe, Qxe, Ds^Esd, Gd, Qxe, Gd^Es, Gs^Fdw, Gd^Fdw, Gs, Gs, Gd, Re, Chr, Gd^Fdw, Gd^Fdw, Gs, Gs, Rr, Qxe, Qxe, Khr, Ch, Chr, Gd^Fdw, Chr, Chr, Qxe, Qxe, Chr, Yhs, Yhs, Gd^Fdw, Chr, Qxe, Qxe, Chr, Ch, Gs, Chr, Chr, Gll^Fp, Gs, Gd^Fmw, Gll^Fp
Gs, Gg, Ds^Esd, Gs, Gs, Gd^Fdw, Gd, Gd, Gd, Gs, Gs, Gd, Qxe, Qxe, Qxe, Qxe, Gd, Gd, Gs^Fdw, Gd^Fdw, Re, Gd, Re, Chr, Gd^Fdw, Qxe, Qxe, Re, Re, Gd, Gd, Ch, Rr, Rp, Gd^Fdw, Gd^Fdw, Qxe, Qxe, Chr, Yhs, Yhs, Gll^Fdw, Gd^Fdw, Chr, Qxe, Qxe, Qxe, Gd, Gd, Gs, Gs, Ch, Gs, Gd^Fmw, Gg
Ds, Gg, Ds, Gg, Gs, Gd, Gs, Gs, Gd^Fdw, Gd, Gd^Fdw, Gd, Gd, Gd, Gd, Qxe, Qxe, Gd, Gd, Gd, Re, Re, Qxe, Qxe, Gd, Gs, Qxe, Re^Dr, Re, Gd, Wwg, Wwg, Rp, Rr, Rr, Rr, Ch, Chr, Re^Fdw, Yhs, Re, Re^Fdw, Gd^Fetd, Chr, Qxe, Qxe, Qxe, Qxe, Gd, Gs, Gs, Ch, Gg, Gll^Fp, Gg
Ds^Es, Ds^Esd, Ds, Gg^Esd, Gg, Gs, Ds, Gs, Gs, Gs, Gs, Gd, Gs^Es, Gs^Es, Gd^Es, Qxe, Qxe, Qxe, Qxe, Gd, Chr, Qxe, Gd, Gd, Re, Re, Qxe, Re, Gd, Wwg^Ewl, Wwg, Gs, Rp, Rr, Rr, Chr, Re^Fdw, Re, Re^Fdw, Gd^Fdw, Re, Re^Fdw, Re^Fdw, Re, Qxe, Qxe, Gd, Qxe, Qxe, Gd, Gs, Chr, Chr, Gs, Gs
Wwg, Ds, Ds, Ds^Esd, Ds^Es, Ds, Ds^Esd, Gg, Gg, Gg, Gs, Gd, Gs, Gs, Gd, Gd, Re, Re, Chr, Qxe, Re, Re, Wwf^Es, Rr, Re, Re^Dr, Gd, Gd, Wwg, Wwg, Gs, Gs, Qxe, Rr, Rr, Gll^Fdw, Gd^Fetd, Re, Re, Re, Re, Re, Re, Re, Chr, Rr, Rr^Vhc, Gd, Gd, Gs, Gs, Gd, Gs, Ch, Chr
Wog, Wwg, Wwg, Ds, Ds, Ds, Ds, Ds^Es, Ds^Esd, Gs, Gg, Gs, Gs^Es, Re^Dr, Re, Ch, Chr, Qxe, Rp, Re, Re, Wwf, Wwf, Rr, Wwg, Wwf^Es, Wwg, Wwg, Chr, Gs, Gg, Qxe, Qxe, Rr, Chr, Re, Re, Re, Ch, Chr, Chr, Re, Rr, Rp, Rr, Rr, Rr, Rp, Chr, Gs, Gll^Fmw, Gs, Gs, Gll^Fp, Gll^Fp
Wog, Wog, Wog, Wwg, Wwg, Wwrg, Wwrg, Ds, Ds, Gg, Gg, Gs, Re, Re, Chr, Khr, Chr, Re, Re, Re, Re, Re^Es, Wwf^Es, Wwrg, Wwg, Wwg, Rr, Gs, Gs, Gs, Rr, Qxe, Rr, Rr, Rr, Re, Ch, Ch, Khr^Egk, Ch, Ch, Chr, Rr, Rr, Gd^Fdw, Gd^Fdw, Gd^Fdw, Rr, Rr, Rp, Rr, Qxe, Gg, Gll^Fp, Gll^Fp
Wwg, Wog, Wwg, Wog, Wog, Wog, Wwrg, Wwg, Wwg^Ewl, Ds^Esd, Gg, Gs, Gs, Gs, Gd^Dr, Re, Chr, Rr, Re, Re^Dr, Re, Wwf^Es, Wwg, Wwg, Chw, Wwf, Gs, Rr, Rr, Rr, Gs, Qxe, Rp, Rr, Rr, Chr, Rr, Khr, 1 Khr, Khr^Egk, Rr, Rr, Rr, Rr, Wwf, Gd^Fdw, Chr, Yhs, Qxe, Rr, Qxe, Qxe, Rr, Gg^Efm, Gg
Wwg, Wog, Wwg, Wwg, Wwg, Wwg, Wwg, Wwg, Wwg, Wwrg, Wwg^Ewl, Gs, Gg, Gs, Re, Re, Gd, Chr, Ch, Re, Ds, Ds, Wwg, Wwg, Ds, Wwf, Wwf^Es, Wwf, Wwf, Wwf^Es, Rr, Gs, Gs, Chr, Ch, Rr, Rr, Khr^Egk, Khr, Khr, Ch, Chr, Rp, Rr, Rp, Wwf^Ewl, Wwf, Yhs, Yhs, Qxe, Qxe, Rp, Gs^Vh, Rr, Rr
Wwg, Wog, Wwg, Ds^Es, Ds, Gs, Gll, Wwrg, Wwg, Ds, Wwg^Ewl, Ds, Ds^Esd, Gg, Gs, Gd^Es, Gd, Gs, Ds, Chw, Chw, Wwrg, Wwg, Wwg, Wwg, Ds, Wwg, Wwrg, Wwg, Wwf^Es, Ww^Dr, Rr^Vhc, Wwrg, Gll^Fp, Wwf, Chw, Wwf, Rr, Chw, Chw, Gd^Fmw, Gd, Rp, Rr, Rp, Gd^Fetd, Wwf, Wwg, Chw, Yhs, Qxe, Gd^Fetd, Gll^Fmw, Gll^Fp, Re
Gs^Fmw, Wwg, Wwg, Wwg, Wwg, Gll^Fp, Gll^Fp, Gll, Gs, Wwg, Wwg, Wwg, Wwg, Gg, Gg, Gd, Gd, Ds, Ds, Ds, Wwrg, Wwrg, Wog, Wog, Wog, Wwg, Wog, Wog, Wog, Wwg, Wog, Wwg, Wwg, Wwg, Wwrg, Wwf, Wwf, Rb, Wwg, Wwf, Wwf, Gd, Chw, Rr, Rp, Wwf, Wwg, Wwg^Ewl, Wwg, Yhs^Xp, Yhs, Qxe, Gll^Fp, Wwf, Wwf
Gs^Fdw, Wwrg, Wwg, Wog, Wwg, Ds, Ds, Gll^Fp, Gs^Es, Ds, Wwg, Wog, Wog, Wwg, Wwg, Ds^Esd, Ds, Ds^Esd, Wwg, Wwg, Wog, Wog, Wwg, Wog, Wwg, Wog, Wwg, Wog, Wwg, Wog, Wwg, Wog, Wog, Wwg, Wwg, Wwf, Wwf, Wwf, Wwg, Wwg, Wwg, Wwg, Wwf, Rr, Chw, Gd^Fetd, Wwg, Wwg, Wwf^Ewl, Yhs, Yhs, Gd^Fetd, Wwf, Wwf, Gd^Fmw
Re^Dr, Gg, Wwg^Ewl, Wog, Wog, Wwg, Wwrg, Gll^Fp, Ds^Esd, Gs^Esd, Wwg, Wog, Wog, Wog, Wog, Wwg, Wwg, Wwg, Wwg, Wog, Wog, Wog, Wwrg, Wwrg, Wwg, Wwg, Wwf^Es, Wwg, Ww^Dr, Wwg, Wwrg, Wwg, Wog, Wwg, Wwg, Wwrg, Wwf, Wwg, Wwrg, Wwg, Wwg, Wwf, Wwg, Wwrg, Wwrg, Wwrg, Wwg, Wwf, Yhs, Yhs, Yhs^Xp, Gll^Fp, Wwf, Gs^Vh, Gll^Fp
Re, Gg, Gg, Wwg, Wwg, Wog, Wwg, Wwg, Wwg, Ds, Wwg, Wwg, Wwg, Wog, Wog, Wog, Wog, Wog, Wog, Wog, Wwg, Wwg, Wwg, Wwg, Wwf, Wwf^Es, Wwf, Wwf^Es, Wwf, Ds, Ds, Wwrg, Wog, Wog, Wwg, Wwg, Chr, Chr, Chr, Wwf, Wwg, Wwg, Wog, Wwg, Wwg, Wwg, Wwg, Wwrg, Yhs, Yhs^Xp, Wwf, Wwf, Wwf, Gs, Gll^Fp
Gg, Re, Gg, Gg, Gg, Wwg, Wwrg, Wog, Wwg, Wwrg, Wwrg, Wwg, Wwg, Wwg, Wwg, Wog, Wwg, Wwg, Wwg, Wwg, Ds, Ch, Wwrg, Wwg, Wwrg, Wwf, Ds, Wwf^Es, Ds, Ds^Esd, Wwf, Wwrg, Wog, Wog, Wwg, Chw, Chw, Khr, Ch, Wwrg, Wwrg, Wwg, Wog, Wog, Wog, Wwg, Wwg, Wwrg, Wwf, Wwrg, Wwg, Wwf, Wwrg, Chw, Gll^Fp
Gg, Re, Re, Gg, Gg, Gg, Gg, Wwg^Ewl, Ds^Esd, Ds, Ds, Ds^Esd, Gg, Wwg^Ewl, Gg, Wwg, Chw, Wwrg, Gg, Ds^Esd, Gll^Fp, Chr, Ch, Wwg, Rr^Vd, Wwf^Es, Ds, Ds^Esd, Gg, Ds^Dr, Wwf, Wwg, Wwg, Wog, Wog, Wwg, Wwrg, Ch, Khr, Chr, Chw, Wwg, Wwg, Wog, Wog, Wwg, Wwg, Wwg, Wwg^Es, Wwg, Wwg, Wwg, Wwg, Wwg, Wwg
Re, Re, Re, Re^Dr, Re, Re, Re, Gg, Gg, Ds^Es, Gg, Gg, Gg, Gg, Gg, Gg, Gg, Rp, Rp, Gg, Gll^Fp, Gll^Fp, Chr, Gs^Fms, Gs^Fms, Ds, Rp, Rr, Rr, Gs^Fds, Gs^Fms, Wwf, Wwrg, Wwg, Wwg, Wwg, Wwg, Ch, Chr, Chr, Wwrg, Chw, Wwg, Wog, Wog, Wog, Wwg, Wwg, Rp, Wwg, Gs, Wwf, Wwg, Wwg, Wwg
Re, Re, Re, Re, Gg, Re, Gg, Re, Re, Gg, Gg, Re, Re, Re, Qxe, Gg, Gg, Rp, Rp, Gll^Fp, Gll^Fp, Gll^Fp, Chr, Gll^Fp, Gll^Fp, Gs^Vh, Gs^Fms, Rr, Rr, Rr, Rr, Gs^Fmw, Wwf, Wwg, Chw, Wwg, Wwg, Wwf, Wwg, Wwrg, Wwg, Wwrg, Wwg, Wwg, Wog, Wwg, Wwg, Wwf, Rp, Gd^Vhr, Gd^Fmw, Wwf, Wwf^Ewl, Wwrg, Wwf
Gg, Re, Gg, Gg, Gg, Gs, Qxe, Gg, Gg, Re, Re, Re, Re, Re, Qxe, Qxe, Re^Dr, Gs, Gs, Rp, Gll^Fp, Gll^Fp, Qxe, Qxe, Gll^Fp, Gll^Fp, Gs^Fms, Gs^Fds, Gs^Fds, Rr, Rr, Rr, Wwf, Rp, Rr, Wwg, Wwf, Wwg, Wwg, Wwg, Wog, Wwg, Wog, Wwg, Wwg, Wwg, Wwg, Wwrg, Chw, Gd^Fmw, Gd^Fmw, Gs, Gd^Vhr, Gs, Gg
Gs, Gg, Gg, Gg, Gll^Fp, Qxe, Gd^Fmw, Qxe, Qxe, Gg, Gg, Re, Re, Re, Re^Dr, Re, Re, Re, Re, Rp, Re, Gll^Fp, Qxe, Qxe, Qxe, Ch, Chr, Gs^Fms, Rr^Vhc, Gs^Fds, Rp, Wwf, Rr, Rr, Rr, Wwf, Wwg, Wwg, Wwrg, Wwg, Wwg, Wog, Wwg, Wwg, Chw, Wwg, Wwg, Wwg^Es, Wwrg, Chw, Khw, Gd^Fmw, Gd^Fetd, Gs, Gd^Fmw
Gg, Gs, Gg, Gg, Gg, Gll^Fp, Gd^Fmw, Gll^Fp, Gg, Gg, Gs, Re, Gs, Re, Gd, Qxe, Gd, Gs, Gd, Re, Gg, Rp, Qxe, Qxe, Chr, Khr, Chr, Gg, Rp, Rr, Rr, Rr, Rr, Rr, Rr, Wwrg, Wwrg, Gg, Gs^Fds, Gs^Fds, Wwg, Wwg, Wwg, Chw, Wwf, Khw, Chw, Wwg, Wwrg, Wog, Chw, Gd^Fmw, Gs^Fdw, Gd^Fmw, Gd^Fmw
Chr, Gg, Gg, Gg, Gs^Vh, Gll^Fp, Gll^Fp, Gs, Gs, Gs^Es, Re, Re, Gg, Gs^Es, Qxe, Qxe, Gd^Fmw, Gd^Fdw, Ch, Rp, Gs^Fdw, Gg, Rp, Gg, Gg, Chr, Gg, Ch, Re, Re, Rp, Rr, Rr^Vhc, Gs^Fds, Gs^Fds, Rr, Rp, Gg, Gs^Fms, Gll^Fp, Gg, Wwrg, Wwg, Wwg, Wwrg, Chw, Wwrg, Wwg, Wwg, Wwrg, Wog, Khw, Chw, Gs, Gs
Gs, Rp, Rp, Gg, Gg, Gll^Fp, Gg, Gs, Gs, Gs^Es, Gg, Gg, Rp, Gs, Rp, Rp, Rp, Rp, Gll^Fdw, Gd^Fmw, Gd^Fdw, Gs, Gg, Rp, Rp, Gg, Rp, Re, Re, Rp, Gg, Gg, Gg, Gs^Fms, Gg, Rr, Rr, Gs^Fms, Gll^Fp, Gll^Fp, Gs, Wwrg, Wwg, Wwg, Wwg, Wwrg, Wwg, Wwg, Wwg, Wog, Wog, Wog, Wog, Wwrg, Wwg
Gs^Vh, Gs, Rp, Gg, Gg, Gg, Gg, Gg, Rp, Rp, Rp, Rp, Gg, Rp, Gs^Dr, Rp, Gs, Rp, Gd, Gd^Fdw, Gd, Gs, Gg, Gg, Gg^Fet, Rp, Re, Re, Rp, Chr, Chr, Chr, Chr, Gs, Gs, Rr, Rr, Gg, Gs, Gs, Gg, Wwf, Ss, Ss, Ss, Wwg, Wwg^Ewl, Wwg, Wwg, Wwg, Wwg, Wwg, Wwg, Wog, Wog
Gs, Gs, Gs, Rp, Gs, Gg, Rp, Rp, Gg, Rp, Gg, Gg, Qxe, Gs, Gs, Gg, Gg, Re, Gg, Rp, Re, Gd^Dr, Re, Gg, Rp, Rr, Re, Rr, Gg, Gll^Fdw, Qxe, Khr, Qxe, Gs, Gs^Vh, Rp, Rr, Rp, Gs, Gs, Ss, Gg, Ss, Ss, Ss, Wwf, Wwf, Wwf^Ewl, Gs, Gll^Fp, Gll^Fp, Wwrg, Gd^Fmw, Wwg, Wwg
Gs, Gs, Gg, Rp, Rp, Rp, Gg, Gg, Gg, Gg, Gg, Gg, Qxe, Gs, Gg, Gg, Re, Gd, Gd, Gd, Gll^Fp, Rp, Gg, Re, Rp, Rp, Gg, Gg, Gd^Fdw, Qxe, Qxe, Qxe, Gll^Fp, Gll^Fp, Gs, Gg, Rp, Rr, Gg, Gg, Chs, Ss, Ss, Ss, Ss, Chr, Chr, Gs, Gs, Gll^Fp, Gll^Fp, Gd^Fmw, Gs^Fdw, Gd^Fmw, Gll^Fp
Re, Gg, Rr^Vd, Rp, Gg, Rp, Rp, Gg, Gg, Gg, Gg, Qxe, Gg, Gg, Gg, Gd, Gd, Gg, Qxe, Gg, Qxe, Gll^Fdw, Gd, Gg, Re, Rp, Gg, Gd^Fdw, Gd, Qxe, Qxe, Qxe, Gll^Fp, Gll^Fdw, Gll^Fp, Gg, Rp, Rr, Rr, Chr, Ss, Ss, Ss, Ss, Ss, Ss, Chs, Gg, Gs, Gs, Gll^Fp, Gd^Fmw, Gs^Fdw, Gd^Fmw, Gll^Fp
Gs, Gs, Rr, Rp, Gg, Gg, Gg, Chr, Gd^Fmw, Gs^Vh, Gg, Qxe, Gg, Gll^Fp, Gll^Fp, Gll^Fdw, Gll^Fdw, Gll^Fp, Gg, Qxe, Qxe, Gs, Gd^Dr, Gg, Re, Gs^Dr, Qxe, Gs, Gg, Gll^Fdw, Qxe, Chr, Chr, Gd^Fmw, Gll^Fp, Gg, Rr^Vd, Rp, Rr, Khr, Rp, Ss, Chs, Khs, Ss, Ss, Ss, Gg, Ss, Gg, Gg, Gd^Fmw, Gll^Fp, Gll^Fp, Gg
Gg^Fet, Ce, Ce, Gg, Gg, Gg, Gg, Gg, Gll^Fp, Gll^Fp, Gd^Fmw, Qxe, Gg, Gll^Fp, Gll^Fdw, Gll^Fp, Gll^Fp, Gll^Fp, Gs, Qxe, Qxe, Qxe, Gs, Re, Rp, Gs, Qxe, Qxe, Gll^Fdw, Gd^Fmw, Gll^Fp, Gll^Fp, Qxe, Chr, Chr, Gs, Gs, Gg, Gg, Chr, Rp, Rp, Rr, Chs, Ss, Ss, Ss, Ss, Ss, Ss, Gs, Gll^Fp, Gs, Gs, Gg
