Xos, Xos, Xos, Xos, Xos, Xos, Xos, Xos, Xos, Xos, Xos, Xos, Xos, Xos, Xos, Xos, Xos, Xos, Xos, Xos, Xu, Xu, Xu, Xu, Xu, Xu, Xu, Xos, Xos, Xos, Xos, Xos, Xos, Xos, Yhr, Yhr, Yhr, Xos, Xos, Xos, Xos, Xos, Xos, Xos, Xos, Xos, Xos, Xos, Xos, Xos, Xos, Xos, Xos, Xos, Xos, Xos, Xos, Xos, Xos, Xos, Xos, Xos, Xos, Xos, Xos, Xos, Xos, Xos, Xos, Xos, Xos, Xos, Xos, Xos
Xos, Xos, Xos, Xos, Xos, Xos, Xos, Xos, Xos, Xos, Xos, Xos, Yhr, Xos, Xos, Xos, Yhr, Xos, Xos, Xos, Xu, Xu, Xu, Xu, Xu, Xu, Xu, Xos, Xos, Xos, Xos, Xos, Xos, Xos, Yhr, Yhr, Yhr, Xos, Xos, Xos, Xos, Xos, Xos, Xos, Xos, Xos, Xos, Xos, Xos, Xos, Xos, Xos, Xos, Xos, Xos, Xos, Xos, Xos, Xos, Xos, Xos, Xos, Xos, Xos, Xos, Xos, Xos, Xos, Xos, Xos, Xos, Xos, Xos, Xos
Xos, Xos, Xos, Xos, Xos, Xos, Xos, Xos, Xos, Xos, Xos, Xos, Xos, Yhr, Yhr, Xos, Xos, Yhr^Pr/, Yhr, Xos, Uu^Uf, Xu, Xu, Xu, Xu, Xu, Xu, Xos, Xos, Xos, Xos, Xos, Xos, Xos, Yhr, Yhr, Yhr, Xos, Xos, Xos, Xos, Xos, Xos, Xos, Xos, Xos, Xos, Xos, Xos, Xos, Xos, Xos, Xos, Xos, Xos, Xos, Xos, Xos, Xos, Xos, Xos, Xos, Xos, Xos, Xos, Xos, Xos, Xos, Xos, Xos, Xos, Xos, Xos, Xos
Xos, Xos, Xos, Xos, Xos, Xos, Xos, Xos, Xos, Xos, Xos, Xos, Xos, Xos, Xom, Yhr^Pr/, Yhr, Yhr, Yhr, Yhr, Yhr, Uu^Uf, Xos, Xos, Yhr, Xu, Xos, Xos, Xos, Xos, Xos, Xos, Xos, Xos, Uh, Yhr, Yhr, Xos, Xos, Xos, Xos, Xos, Xos, Xos, Xos, Xos, Xos, Xos, Xos, Xos, Xos, Xos, Xos, Xos, Xos, Xos, Xos, Xos, Xos, Xos, Xos, Xos, Xos, Xos, Xos, Xos, Xos, Xos, Xos, Xos, Xos, Xos, Xos, Xos
Xos, Xos, Xos, Xos, Xos, Xos, Xos, Xos, Xos, Xos, Xos, Xos, Xom, Xos, Uu, Yhr, Yhr, Yhr, Yhr, Yhr, Yhr, Yhr, Yhr, Xom, Yhr^Pr\, Xos, Xos, Xos, Xos, Xos, Xos, Xos, Xos, Xos, Uh, Yhr, Uu^Uf, Xos, Xos, Xos, Xos, Xos, Xos, Xos, Xos, Xos, Xos, Xos, Xos, Xos, Xos, Xos, Xos, Xos, Xos, Xos, Xos, Xos, Xos, Xos, Xos, Xos, Xos, Xos, Xos, Xos, Xos, Xos, Xos, Xos, Xos, Xos, Xos, Xos
Xos, Xos, Xos, Xos, Xos, Xos, Xos, Xos, Xos, Xos, Xom, Xom, Uh, Uu, Ur^Br/, Xu, Yhr, Yhr, Yhr, Yhr, Yhr, Yhr, Yhr, Yhr, Yhr, Xos, Xos, Xos, Xu, Xu, Xu, Xos, Xos, Xos, Uu^Uf, Yhr, Uh, Xos, Xos, Xos, Xos, Xos, Yhr, Xos, Xos, Xos, Xos, Xos, Xos, Xos, Xos, Xos, Xos, Xos, Xos, Xos, Xos, Xos, Xos, Xos, Xos, Xos, Xos, Xos, Xos, Xos, Xos, Xos, Xos, Xos, Xos, Xos, Xos, Xos
Xos, Xos, Xos, Xos, Xos, Xos, Xos, Xos, Xos, Xom, Uh^Pr\, Uh, Ur^Br/, Ur^Br/, Uh, Uu, Xos, Yhr, Yhr, Yhr, Xos, Xos, Yhr^Pr|, Yhr, Yhr, Yhr, Yhr, Xu, Xu, Xu, Xu, Xu, Xuc, Xos, Uu^Uf, Yhr, Yhr, Xos, Xos, Xos, Yhr^Pr\, Yhr, Xos, Xos, Yhr, Xos, Xos, Xos, Xos, Xos, Xos, Xos, Xos, Xos, Xos, Xos, Xos, Xos, Xos, Xos, Xos, Xos, Xos, Xos, Xos, Xos, Xos, Xos, Xos, Xos, Xos, Xos, Xos, Xos
Xos, Xos, Xos, Xos, Xos, Xos, Xos, Xos, Uh, Uh, Ur^Br/, Ur^Pr\, Uh^Pr\, Uh, Xos, Xos, Xos, Yhr, Yhr, Xos, Xos, Xos, Yhr, Xos, Yhr^Pr|, Yhr, Yhr, Yhr, Yhr, Xu, Uh, Xu, Xuc, Uh, Uh, Yhr, Yhr, Yhr, Yhr^Xp, Yhr, Xos, Xos, Yhr^Pr\, Yhr, Xos, Xos, Xos, Xos, Xos, Xos, Xos, Xos, Xos, Xos, Xu, Xu, Xu, Xos, Xos, Xos, Xos, Xos, Xu, Xos, Xos, Xos, Xos, Xos, Xos, Xos, Xos, Xos, Xos, Xos
Xos, Xos, Xos, Xos, Xos, Xos, Xos, Xos, Xos, Ur^Br/, Uh, Uh, Xos, Xos, Xos, Xos, Xos, Yhr, Yhr, Xom, Xos, Xos, Xos, Xos, Yhr, Xos, Xos, Yhr^Xp, Yhr, Yhr, Yhr, Xu, Xu, Uu^Vu, Uu^Ii, Yhr, Yhr, Yhr, Yhr, Yhr, Yhr^Xp, Yhr, Xos, Xos, Xos, Xos, Xos, Xos, Xos, Xos, Xos, Xos, Xos, Xu, Xu, Xu, Xuc, Xuc, Uh, Xos, Xu, Xu, Xu, Xu, Xu, Xos, Xos, Xos, Xos, Xos, Xos, Xos, Xos, Xos
Xos, Xos, Xos, Xos, Xos, Xos, Xos, Xos, Xos, Xos, Xos, Xos, Xos, Xos, Xos, Xos, Yhr, Yhr, Yhr, Yhr, Uu^Uf, Xom, Xom, Xos, Xos, Xos, Xos, Xos, Uh, Yhr^Xp, Yhr, Xuc, Xu, Uu, Uh, Uh, Xos, Uu^Uf, Yhr, Yhr, Yhr, Yhr, Yhr, Xos, Uh, Uh, Uh, Xos, Xos, Xos, Xos, Xos, Xos, Xos, Uh, Xu, Uu, Uh, Uh, Uh, Uh, Xu, Xu, Xu, Xu, Xu, Xu, Xos, Xos, Xos, Xos, Xos, Xos, Xos
Xos, Xos, Xos, Xos, Xos, Xos, Xos, Xos, Xos, Xos, Xos, Xos, Xos, Xos, Yhr, Yhr^Pr\, Xos, Xos, Xos, Yhr, Uu^Uf, Uu^Uf, Xos, Xos, Xos, Xos, Xu, Uu^Uf, Uu^Uf, Uh, Yhr, Xuc, Xuc, Xu, Xos, Xos, Xos, Uh, Uh, Yhr, Uu^Uf, Yhr, Yhr, Yhr, Uh, Uu^Uf, Uu^Uf, Xos, Xos, Xos, Xos, Xos, Xu, Uh, Uh, Uu, Urb, Urb, Urb, Uu, Wwf, Wwf, Xos, Xu, Xu, Xu, Xu, Xos, Xos, Xos, Xos, Xos, Xos, Xos
Xos, Xos, Xos, Xos, Xos, Xos, Xos, Xos, Xos, Xos, Xos, Xos, Yhr, Yhr, Xos, Xos, Xos, Xos, Xom, Yhr, Yhr^Xp, Uh, Xos, Xos, Xos, Xu, Xu, Uh, Uu^Ii, Uu^Uf, Yhr^Xp, Yhr, Yhr, Xos, Xos, Xos, Xos, Xos, Xos, Uh, Xos, Uu^Uf, Yhr, Yhr^Xp, Yhr^Xp, Uu^Uf, Yhr, Xos, Xos, Xos, Xu, Xu, Xuc, Uh, Uu^Uf, Wwf, Urb, Urb^Ii, Urb, Uu^Em, Uu^Uf, Uh, Uh, Xu, Xu, Xu, Xu, Xos, Xos, Xos, Xos, Xos, Xos, Xos
Xos, Xos, Xos, Xos, Xos, Xos, Xos, Xos, Xos, Xos, Xos, Xos, Xos, Xos, Xos, Xos, Xos, Xom, Uh, Yhr, Yhr, Uh, Xos, Xos, Xos, Xu, Xu, Uh, Uu^Vu, Uu, Xos, Yhr, Yhr, Xom, Xom, Xos, Yhr, Xos, Xos, Xos, Xos, Xos, Uu^Uf, Yhr, Yhr, Yhr, Yhr^Pr/, Yhr^Pr/, Yhr, Xos, Xu, Xu, Xu, Uh, Uu^Emf, Uh, Uu, Urb, Urb, Uu, Uu^Uf, Ur, Uh, Xu, Xu, Xu, Xos, Xos, Xos^Efs, Xos, Xos, Xos, Xos^Efs, Xos^Efs
Xos, Xos, Xos, Xos, Xos, Xos, Xos, Xos, Xos, Xos, Xos, Xos, Xos, Xos, Yhl, Xos, Xos, Xos, Uh, Uu^Uf, Yhr, Yhr^Xp, Xos, Xos, Xos, Xu, Xu, Xu, Xu, Xos, Xos, Xos, Xos, Yhr, Yhr, Xos, Xos, Yhr, Yhr^Pr/, Xos, Yhr, Yhr, Yhr, Yhr, Xos, Yhr^Pr/, Yhr, Yhr, Yhr, Yhr, Xu, Xu, Xu, Uh, Uh, Uu^Uf, Ur^Em, Urb, Urb, Urb, Uh, Wwf, Xos^Efs, Xos, Xos, Xos, Xos, Xos^Efs, Wog, Wog, Wog, Xos, Urb, Urb
Xos, Xos, Xos, Xos, Xos, Xos, Xos, Xos, Xos, Xos, Xu, Xu, Xu, Xos, Xos, Yhl, Yhl^Pr/, Xom, Yhr, Yhr, Yhr, Yhr, Yhr, Xos, Xos, Xos, Xos, Xu, Xos, Xos, Xos, Xos, Yhr, Xos, Xos, Yhr, Yhr, Xos, Yhr, Yhr^Xp, Yhr, Yhr, Xos, Yhr^Xp, Xos, Xos, Xos, Yhr, Yhr, Yhr, Xos, Xu, Xu, Xu, Xos, Uh, Uh, Urb, Uh, Urb, Uu^Dr, Wwf, Uu, Xos^Efs, Xos, Xos, Xos, Xos, Xos^Efs, Wog, Urb, Urb, Urb, Urb
Xos, Xos, Xos, Xos, Xos, Xos, Xos, Xos, Xu, Xu, Xuc, Xuc, Xu, Xu, Xu, Xos, Xos, Yhr^Xp, Yhr, Yhr, Yhr, Yhr, Yhr, Xos, Xos, Xos, Xos, Xos, Xos, Xos, Xos, Xos, Xos, Yhr, Yhr^Pr/, Xos, Yhr, Yhr^Xp, Yhr, Yhr, Xos, Yhr^Xp, Xos, Yhr^Pr/, Xos, Xos, Xos, Xos, Xos, Xos, Xos, Xos, Xos, Xos, Xos, Xos, Xos, Xos, Xos^Efs, Uu^Dr, Xu, Uh, Rr, Urb, Urb, Xos, Xos, Xos^Efs, Urb, Urb, Rr, Rr, Urb, Urb
Xos, Xos, Xos, Xos, Xos, Xos, Xu, Xu, Xu, Xu, Uu^Vu, Wwg, Wwf, Xuc, Xu, Xos, Yhr, Yhr, Yhr, Uu^Uf, Uu^Uf, Yhr^Xp, Yhr, Xom, Xom, Xos, Xos, Xos, Xos, Xos, Xos, Xos, Xos, Xos, Yhr, Yhr^Xp, Yhr, Yhr, Xos, Yhr^Xp, Xos, Yhr^Pr/, Xos, Yhr, Xos, Xos, Xos, Xos, Xos, Xos, Xos, Xos, Xos^Efs, Xos^Efs, Wog, Xos, Xos, Xos^Efs, Urb, Urb, Rr, Rr, Urb, Rr, Rr, Urb, Urb, Urb^Pr\, Rr^Pr\, Rr, Urb, Urb, Xos, Xos
Xos, Xos, Xos, Xos, Xos, Xos, Xos, Xu, Xos, Uh, Wog, Wwg, Wwg, Wwg, Yhl, Yhl, Yhl, Yhr, Xos, Uu^Uf, Uu^Uf, Yhr^Xp, Xos, Yhl^Pr/, Yhl, Xom, Xos, Xos, Xos, Xos, Xos, Xos, Yhr, Yhr^Pr\, Yhr^Pr\, Yhr, Xos, Yhr^Xp, Xos, Yhr^Pr/, Xos, Yhr, Xos, Yhr, Xos, Xos, Xos^Zok, Xos^Zok, Xos^Zok, Xos, Xos, Xos, Xos, Wog, Wog, Wog, Urb, Urb, Rr, Rr, Urb, Urb, Xos, Urb, Urb, Rr, Rr, Rr, Urb, Urb^Pr\, Xos, Xos, Xos, Xos
Xos, Xos, Xos, Xos, Xos, Xos, Xos, Xos, Xos, Uh, Wwg, Wwg, Wwg, Yhl^Ii, Yhl, Yhl, Xos, Xos, Xos, Xos, Xos, Xos, Xos, Xos, Xos, Yhl, Yhl, Xos, Xos, Xos, Yhr, Yhr, Yhr, Yhr, Xos, Xos, Xos, Yhr^Pr/, Xos, Yhr, Xos, Yhr, Xos, Xos, Xos^Zok, Xos^Zok, Ur^Zok, Uu^Zok, Uu, Xos, Xos, Xos, Xos, Xos, Urb, Urb, Rr, Rr, Urb, Urb, Xos, Xos, Xos, Xos, Xos, Urb, Urb, Rr, Rr, Urb, Urb^Pr/, Xos^Efs, Xos^Efs, Xos
Xos, Xos, Xos, Xos, Xos, Xos, Xos, Xu, Xu, Wwg, Uh, Wwg, Wwf, Yhl, Yhl, Xos, Xos, Xos, Xu, Xu, Xu, Xos, Xos, Xos, Xos, Xos, Xos, Xos, Xos, Xos, Xos, Yhr, Xos, Xos, Xos, Xos, Xos, Yhr, Xos, Yhr, Xos, Xos, Xos, Xos^Zok, Xos^Zok, Uu^Zok, Uu, Ur^Br\, Ur^Pr/, Uu^Pr/, Uu, Xos^Efs, Urb, Urb, Rr, Rr, Urb, Urb, Wog, Wog, Wog, Xos, Xos, Xos, Xos, Xos, Xos, Urb, Urb^Pr/, Rr^Pr/, Rr, Urb, Urb, Xos
Xos, Xos, Xos, Xos, Xos, Xos, Xos, Xu, Xu, Xu, Xu, Wwf, Xos, Yhl, Yhl, Xos, Xos, Xos, Uh, Xu, Xu, Xu, Xu, Xos, Xos, Xos, Xos, Xos, Xos, Xos, Xos, Xos, Xos, Xos, Xos, Xos, Xos, Yhr, Xos, Xos, Xos, Xos, Xos, Xos, Xos, Xos, Xos, Uu^Pr/, Uu, Ur^Br\, Ur^Br\, Urb, Rr, Rr, Urb, Urb, Xos, Xos, Xos, Wog, Xos, Xos, Xos, Xos, Xos, Xos, Xos, Xos, Xos, Urb, Urb, Rr, Rr, Urb
Xos, Xos, Xos, Xos, Xos, Xos, Xos, Xos, Xos, Xu, Xos, Xos, Xos, Yhl, Yhl, Yhl, Yhl, Uh, Uu^Uf, Yhl, Uh, Xu, Xos, Xos, Xos, Xos, Wog, Xos, Xos, Xos, Xos, Xos, Xos, Xos, Xos, Xos, Xos, Xos, Xos, Xos, Xos, Xos, Xos, Xos, Xos, Xos, Xos, Xos, Urb, Urb, Rr, Ur^Br\, Ur^Br\, Urb, Uu, Xos, Xos, Xos, Xos, Xos, Xos, Xos, Xos, Xos, Xos, Xos, Xos, Xos, Xos, Xos, Xos, Urb, Urb, Rr
Xos, Xos, Xos, Xos, Xos, Xos, Xos, Xos, Xos, Xos, Xos, Xos, Yhl^Pr\, Yhl^Xp, Xos, Yhl, Yhl, Yhl, Yhl, Yhl^Xp, Uu^Uf, Xos, Xos, Xos, Wog, Wog, Wog, Wog, Wog, Xos, Xos, Xos, Xos, Xos, Xos, Xos, Xos, Xos, Xos, Xos, Xos, Xos, Xos, Xos, Xos, Xos, Urb, Urb, Rr, Rr, Urb, Urb, Uu, Ur^Br\, Ur^Pr/, Uu^Pr/, Uu, Xos, Xos^Zok, Xos, Xos, Xos, Xos, Xos, Xos, Xos, Xos, Xos, Xos, Xos, Xos, Xos, Xos, Urb
Xos, Xos, Xos, Xos, Xos, Xos, Xos, Xos, Xos, Xos, Yhl, Yhl, Xos, Xos, Xos, Xos, Yhl^Xp, Yhl, Yhl, Yhl, Yhl, Xos, Wog, Wog^Pr\, Wog^Pr\, Wog, Wog, Wog, Xos, Xos, Xos, Xos, Xos, Xos, Xos, Xos, Xos, Xos, Xu, Xos, Xu, Xu, Xos, Xos, Urb, Urb, Rr, Rr, Urb, Urb, Xos, Xos, Xos, Uu^Pr/, Uu, Ur^Br\, Ur^Zok, Uu^Zok, Uu^Zok, Xos^Zok, Xos, Xos, Xos, Xos, Xos, Xos, Xos, Xos, Xos, Xos, Xos, Xos, Xos, Xos
Xos, Xos, Xos, Xos, Xos, Xos, Xos, Xos, Yhl, Yhl, Xos, Xos, Xos, Xos, Yhl, Yhl^Pr\, Xos, Xos, Xos, Yhl, Yhl, Yhl, Yhl, Wog, Wog, Wog^Pr\, Xos, Xos, Xos, Xos, Xos, Xos, Xos, Xos, Xos, Xos, Xos, Xos, Xu, Xu, Uh, Xu, Xu, Urb, Rr, Rr, Urb, Urb, Xos, Xos, Xos, Xos, Xos, Xos, Xos^Zok, Uu^Zok, Uu^Zok, Ur^Zok, Xos, Xos, Xos, Xos, Xos, Xos, Xos, Xos, Xos, Xos, Xos, Xos, Xos, Xos, Xos, Xos
Xos, Xos, Xos, Xos, Xos, Xos, Xos, Yhl, Xos, Xos, Xos, Xos, Yhl, Yhl, Xos, Xos, Xos, Xos, Xos, Xos, Xos, Yhl, Yhl, Yhl, Yhl, Xos, Xos, Xos, Xos, Xos, Xos, Xos, Xos, Xos, Xos, Xos, Xos, Xos, Xos, Uh, Uh, Uu^Uf, Yhr^Xp, Yhr, Yhr, Urb, Xos, Xos, Xos, Xos, Xos, Xos, Xos, Xos, Xos, Xos^Zok, Xos, Xos, Xos, Xos, Xos, Xos, Xos, Xos, Xos, Xos, Xos, Xos, Xos, Xos, Xos, Xos, Xos, Xos
Xos, Xos, Xos, Xos, Xos, Xos, Xos, Xos, Xos, Xos, Yhl, Yhl, Xos, Xos, Xos, Xos, Xos, Xos, Xos, Xos, Xos, Xos, Xos, Yhl, Yhl, Yhl, Yhl, Xos, Xos, Xu, Xu, Xos, Xos, Xos, Xos, Xos, Xos, Xos, Xos, Xos, Xos, Uu^Uf, Yhr, Yhr, Yhr^Xp, Xu, Xu, Xos, Xos, Xos, Xos, Xos, Xos, Xos, Xos, Xos, Xos, Xos, Xos, Xos, Xos, Xos, Xos, Xos, Xos, Xos, Xos, Xos, Xos, Xos, Xos, Xos, Xos, Xos
Xos, Xos, Xos, Xos, Xos, Xos, Xos, Xos, Xos, Xos, Xos, Xos, Xos, Xos, Xos, Xos, Xos, Xos, Xu, Xu, Xu, Xos, Xos, Xos, Xos, Yhl, Yhl, Uh, Uh, Xu, Xuc, Xu, Xu, Xos, Xos, Xos, Xos, Xos, Xos, Xos, Yhr, Yhr^Xp, Yhr, Yhr, Yhr^Xp, Yhr, Xu, Xu, Xu, Xos, Xos, Xos, Xos, Xos, Xos, Xos, Xos, Xos, Xos, Xos, Xos, Xos, Xos, Xos, Xos, Xos, Xos, Xos, Xos, Xos, Xos, Xos, Xos, Xos
Xos, Xos, Xos, Xos, Xos, Xos, Xos, Xos, Xos, Xos, Xos, Xos, Xos, Xos, Xos, Xos, Xu, Xu, Xu, Xu, Xuc, Xu, Xu, Xos, Xu, Yhl, Yhl, Uu^Vu, Uh, Uu^Uf, Uh, Xu, Xu, Xos, Xos, Xos, Xos, Xos, Yhr, Yhr^Pr\, Xos, Yhr, Yhr^Xp, Yhr, Xos, Xos, Xu, Xu, Xu, Xos, Xos, Xos, Xos, Xos, Xos, Xos, Xos, Xos, Xos, Xos, Xos, Xos, Xos, Xos, Xos, Xos, Xos, Xos, Xos, Xos, Xos, Xos, Xos, Xos
Xos, Xos, Xos, Xos, Xos, Xos, Xos, Xos, Xos, Xos, Xos, Xos, Xos, Xos, Xu, Xu, Xu, Xu, Xuc, Xuc, Uu^Uf, Xuc, Xuc, Xu, Xuc, Yhl, Yhl^Xp, Uh, Uu^Uf, Uu^Uf, Uh, Xuc, Xu, Xos, Xos, Xos, Yhr, Yhr, Xos, Xos, Yhr, Yhr, Yhr, Yhr, Xos, Xos, Xos, Xu, Xu, Xu, Xu, Xos, Xos, Xos, Xos, Xos, Xos, Xos, Xos, Xos, Xos, Xos, Xos, Xos, Xos, Xos, Xos, Xos, Xos, Xos, Xos, Xos, Xos, Xos
Xos, Xos, Xos, Xos, Xos, Xos, Xos, Xos, Xos, Xos, Xos, Xos, Xu, Xu, Xu, Xu, Xuc, Xu, Xuc, Uh, Uu^Uf, Uu^Uf, Xuc, Xu, Yhl^Edb, Yhl, Yhl^Xp, Uh, Uh, Uu^Uf, Xuc, Xuc, Xu, Xos, Xos, Xos, Xos, Xos, Yhr, Yhr^Pr\, Xos, Yhr^Xp, Yhr, Uu^Uf, Uu^Uf, Xos, Xos, Xos, Xos, Xu, Xuc, Xu, Xu, Xos, Xos, Xos, Xos, Xos, Xos, Xos, Xos, Xos, Xos, Xos, Xos, Xos, Xos, Xos, Xos, Xos, Xos, Xos, Xos, Xos
Xos, Xos, Xos, Xos, Xos, Xos, Xos, Xos, Xos, Xos, Xos, Xos, Xu, Xuc, Uh, Uu^Uf, Uh, Xuc, Uh, Uh, Uh, Yhl, Xu, Xu, Yhl^Edb, Yhl^Edb, Xu, Uh, Xu, Xu, Xu, Xu, Xos, Xos, Xos, Xos, Xos, Yhr, Xos, Xos, Xos, Uh, Uh, Uu^Uf, Uh, Yhr, Uh, Xos^Efs, Qxu, Qxu, Qxu, Xuc, Xu, Xu, Xos, Xos, Xos, Xos, Xos, Xos, Xos, Xos, Xos, Xos, Xos, Xos, Xos, Xos, Xos, Xos, Xos, Xos, Xos, Xos
Xos, Xos, Xos, Xos, Xos, Xos, Xos, Xos, Xos, Xos, Xos, Xos, Xu, Xuc, Uh, Uu^Uf, Uh, Xuc, Yhl, Yhl, Yhl, Uu^Vu, Yhl^Edb, Yhl, Yhl^Edb, Yhl^Edb, Xu, Xu, Xu, Xu, Xos, Xos, Xos, Xos, Xos, Xos, Xos, Xos, Xos, Xos, Xos, Xos, Xos, Uu^Uf, Uh, Uh, Yhr, Uh, Cud, Qxu, Qxu, Qxu, Xuc, Xu, Xos, Xos, Xos, Xos, Xos, Xos, Xos, Xos, Xos, Xos, Xos, Xos, Xos, Xos, Xos, Xos, Xos, Xos, Xos, Xos
Xos, Xos, Xos, Xos, Xos, Xos, Xos, Xos, Xos, Xos, Xu, Xu, Xu, Xuc, Uu^Uf, Uu^Uf, Yhl, Yhl, Yhl^Xp, Yhl^Xp, Yhl, Yhl^Edb, Yhl, Yhl^Edb, Xos, Xos, Xos, Xu, Xos, Xos, Xos, Xos, Xos, Xos, Xos, Xos, Xos, Xos, Xos, Xos, Xos, Xos, Xos, Xos, Xos, Uh, Yhr, Cud, Uu^Ii, Cud, Qxu, Qxu, Xu, Xu, Xos, Xos, Xos, Xos, Xos, Xos, Xos, Xos, Xos, Xos, Xos, Xos, Xos, Xos, Xos, Xos, Xos, Xos, Xos, Xos
Xos, Xos, Xos, Xos, Xos, Xos, Xos, Xos, Xu, Xu, Xu, Xu, Xu, Xu, Yhl^Xp, Yhl, Xu, Xu, Xu, Xu, Yhl, Yhl^Edb, Uh, Uh, Xos, Xos, Xos, Xos, Xos, Xos, Xos, Xos, Xos, Xos, Xos, Xos, Xos, Xos, Xos, Xos, Xos, Xos, Xos, Xos, Xos, Xos, Qxu, Cud, Cud, Cud, Qxu, Qxu, Xuc, Xu, Xos, Xos, Xos, Xos, Xos, Xos, Xos, Xos, Xos, Xos, Xos, Xos, Xos, Xos, Xos, Xos, Xos, Xos, Xos, Xos
Xos, Xos, Xos, Xos, Xos, Xos, Xos, Xos, Xu, Xu, Yhr^Xp, Xu, Xu, Uh, Yhl, Xu, Xuc, Xuc, Yhl, Yhl, Yhl, Yhl, Yhl, Uh, Xu, Xos, Xos, Xos, Xos, Xos, Xos, Xos, Xos, Xos, Xos, Xos, Xos, Xos, Xos, Xos, Xos, Xos, Xos, Xos, Xos, Xos, Qxu, Qxu, Qxu, Qxu, Qxu, Qxu, Xuc, Xuc, Xos, Xos, Xos, Xos, Xos, Xos, Xos, Xos, Xos, Xos, Xos, Xos, Xos, Xos, Xos, Xos, Xos, Xos, Xos, Xos
Xos, Xos, Xos, Xos, Xos, Xos, Xos, Xos, Xu, Xuc, Uh, Xu, Xu, Xuc, Yhl, Xu, Yhl, Yhl, Xuc, Xu, Yhl, Yhl, Yhl, Yhl, Cte^Edb, Xu, Xos, Xos, Xos, Xos, Xos, Xos, Xos, Xos, Xos, Xos, Xos, Xos, Yhr^Xp, Yhr, Yhr, Xos, Xos, Xos, Xos, Xu, Xu, Qxu, Qxu, Qxu, Xu, Xu, Xu, Xu, Xos, Xos, Xos, Xos, Xos, Xos, Xos, Xos, Xos, Xos, Xos, Xos, Xos, Xos, Xos, Xos, Xos, Xos, Xos, Xos
Xos, Xos, Xos, Xos, Xos, Xos, Xos, Xos, Xu, Xuc, Uu^Uf, Uh, Xu, Xu, Yhl^Xp, Yhl, Xu, Yhl, Yhl, Xu, Yhl, Yhl, Xos, Cte^Edb, Cte^Edb, Cte^Edt, Xos, Xos, Xos, Xos, Xos, Xos, Cud, Cud, Cud, Xos, Wog, Wog, Wog, Yhr^Xp, Yhr, Yhr, Xos, Xos, Xos, Xu, Xu, Xu, Xu, Xu, Xu, Xu, Xos, Xos, Xos, Xos, Xos, Xos, Xos, Xos, Xos, Xos, Xos, Xos, Xos, Xos, Xos, Xos, Xos, Xos, Xos, Xos, Xos, Xos
Xos, Xos, Xos, Xos, Xos, Xos, Xos, Xos, Xu, Xu, Uu^Uf, Uh, Yhl, Yhl, Xu, Xu, Xu, Xu, Yhl^Xp, Yhl, Xos, Xos, Xos, Xos, Xos, Xos, Xos, Xos, Cud, Xos, Cud^Ebme, Cud, Uu^Ii, Cud, Cud, Cud, Cud, Wog, Wog, Wog, Xos, Xos, Xos, Xos, Xos, Xos, Xos, Xu, Xu, Xu, Xos, Xos, Xos, Xos, Xos, Xos, Xos, Xos, Xos, Xos, Xos, Xos, Xos, Xos, Xos, Xos, Xos, Xos, Xos, Xos, Xos, Xos, Xos, Xos
Xos, Xos, Xos, Xos, Xos, Xos, Xos, Xu, Xu, Xu, Uh, Yhr, Uh, Xuc, Xu, Xu, Xu, Xu, Xu, Xu, Xos, Xos, Xos, Xos, Xos, Xos, Xos, Cud, Cud, Cud, Cud, Cud, Cud, Cud, Uu^Ii, Cud, Cud, Cud, Cud, Xos, Xos, Xos, Xos, Xos, Xos, Xos, Xos, Xos, Xos, Xos, Xos, Xos, Xos, Xos, Xos, Xos, Xos, Xos, Xos, Xos, Xu, Xos, Xos, Xos, Xos, Xos, Xos, Xos, Xos, Xos, Xos, Xos, Xos, Xos
Xos, Xos, Xos, Xos, Xos, Xos, Xos, Xu, Xu, Yhr, Uh, Xu, Xuc, Urb, Urb, Xu, Cud, Xu, Xu, Xu, Xos, Xos, Xos, Xos, Xos, Xos, Cud^Ebme, Cud, Cud, Cud, Cud, Cud, Cud, Cud, Cud, Cud, Uu^Ii, Cud, Cud, Cud, Xos, Xos, Xos, Xos, Xos, Xos, Xos, Xos, Xos, Xos, Xos, Xos, Xos, Xos, Xos, Xos, Xos, Xos, Xu, Xu, Xu, Xu, Xu, Xos, Xos, Xos, Xos, Xos, Xos, Xos, Xos, Xos, Xos, Xos
Xos, Xos, Xos, Xos, Xos, Xos, Xos, Xu, Xu, Uh, Xu, Xu, Xu, Xuc, Xu, Cud, Uu^Ii, Cud, Xu, Xu, Xos, Xos, Xos, Xos, Cud, Cud, Cud, Uu^Ii, Cud, Cud, Cud, Cud, Cud, Cud, Cud, Cud, Cud, Cud, Wog, Xos, Xos, Xos, Xos, Xos, Xos, Xos, Xos, Xos, Xu, Xu, Xu, Xos, Xos, Xos, Xos, Xos, Xos, Xu, Xu, Xu, Xu, Xu, Xu, Xu, Xu, Xos, Xos, Xos, Xos, Xos, Xos, Xos, Xos, Xos
Xos, Xos, Xos, Xos, Xos, Xos, Xos, Xu, Xu, Uh, Xu, Xu, Xu, Xu, Xu, Cud, Cud, Cud, Xu, Xu, Xos, Xos, Xos, Xos, Xos, Cud, Cud, Cud, Cud, Uu^Ii, Cud, Cud, Cud, Cud, Cud, Cud, Wog, Wog, Wog, Wog, Yhr, Xos, Xos, Xos, Xos, Xos, Xu, Xu, Xu, Xu, Xu, Xu, Xu, Xos, Xos, Xos, Xos, Xu, Xu, Xos, Xos, Xu, Xu, Xu, Xu, Xu, Xu, Xos, Xos, Xos, Xos, Xos, Xos, Xos
Xos, Xos, Xos, Xos, Xos, Xos, Xos, Xu, Xu, Xu, Xu, Xu, Xu, Xu, Xu, Qxu, Qxu, Xu, Xu, Xu, Xos, Xos, Xos, Xos, Wog, Wog, Wog, Cud, Cud, Cud, Cud, Uu^Ii, Cud, Cud, Wog, Wog, Wog, Wog, Yhr^Xp, Yhr, Yhr^Xp, Yhr, Xos, Xos, Xu, Xu, Xu, Xu, Qxu, Qxu, Qxu, Xu, Xu, Xu, Xos, Xos, Xos, Xu, Xu, Xos, Wwf, Wwf, Wwf, Xu, Xos, Xu, Xu, Xu, Xu, Xos, Xos, Xos, Xos, Xos
Xos, Xos, Xos, Xos, Xos, Xos, Xos, Xos, Xos, Xu, Xos, Xos, Xu, Xu, Qxu, Qxu, Qxu, Xu, Qxu, Xu, Xos, Xos, Yhr, Yhr, Yhr^Xp, Wog, Wog, Wog, Xos, Cud, Cud, Cud, Xos, Wog, Wog, Wog, Yhr^Xp, Yhr, Yhr, Yhr, Xu, Xos, Xos, Xu, Xuc, Xuc, Xuc, Xuc, Uh, Qxu, Qxu, Qxu, Xu, Xu, Xos, Xos, Xos, Xu, Xuc, Xuc, Wwf, Uh, Uh, Xos, Xos, Xos, Xos, Xu, Xu, Xu, Xu, Xos, Xos, Xos
Xos, Xos, Xos, Xos, Xos, Xos, Xos, Xos, Xos, Xos, Xos, Xos, Xos, Xu, Xu, Qxu, Qxu, Qxu, Xu, Xu, Xu, Xos, Xos, Yhr, Yhr, Yhr, Xos, Xos, Xos, Xos, Xos, Xos, Xos, Xos, Xos, Yhr, Yhr, Yhr, Xu, Xu, Urb, Xos, Xos, Xu, Xuc, Wwf^Es, Rb, Rb^Dr, Uu, Uu, Xu, Xu, Xu, Xu, Xos, Xos, Xos, Xu, Xuc, Uh, Wwf, Uh, Uu^Vu, Urb, Uh, Xos, Wwf, Wwf, Xos, Xu, Xu, Xu, Xos, Xos
Xos, Xos, Xos, Xos, Xos, Xos, Xos, Xos, Xos, Xos, Xos, Xos, Xos, Xu, Xu, Qxu, Xu, Qxu, Xu, Xu, Xos, Xos, Xos, Xos, Xos, Xos, Xos, Xos, Xos, Xos, Xos, Xos, Xos, Xos, Xos, Xos, Xos, Xos, Xos, Xos, Xos, Urb, Urb, Xu, Uu^Vu, Wwf, Wwf, Uh, Xos, Xos, Xu, Xu, Xu, Xu, Xu, Xos, Uh, Xuc, Uu^Uf, Uh, Urb, Urb, Urb, Urb, Uu^Uf, Uh, Wwf, Wwf, Xos, Xos, Xu, Xu, Xos, Xos
Xos, Xos, Xos, Xos, Xos, Xos, Xos, Xos, Xos, Xos, Xos, Xos, Xos, Xos, Xu, Xu, Xu, Xu, Xos, Xos, Xos, Xos, Xos, Xos, Xos, Xos, Xos, Xos, Xos, Xos, Xos, Xos, Xos, Xos, Xos, Xos, Xos, Xos, Xos, Xos, Xu, Xu, Xu, Uu, Uu, Rb, Wwf^Es, Wwf, Xu, Xu, Xu, Xu, Xu, Xu, Xos, Xos, Uh, Uh, Uu^Uf, Urb, Urb^Es, Urb, Urb^Es, Urb, Uu^Uf, Uh, Uu^Uf, Xos, Xos, Xos, Xu, Xu, Xos, Xos
Xos, Xos, Xos, Xos, Xos, Xos, Xos, Xos, Xos, Xos, Xos, Xos, Xos, Xos, Xos, Xu, Xos, Xos, Xos, Xos, Xos, Xos, Xos, Xos, Xos, Xos, Xos, Xos, Xos, Xos, Xos, Xos, Xos, Xos, Xos, Xos, Xos, Xos, Xos, Xu, Xuc, Xuc, Uh, Uu, Uu, Xu, Xu, Xu, Xu, Xu, Xu, Xu, Xu, Xuc, Xuc, Urb, Uh, Uu^Uf, Urb, Urb, Urb, Urb, Urb, Urb, Urb, Uh, Uu^Uf, Wwf, Wwf, Xos, Xu, Xu, Xos, Xos
Xos, Xos, Xos, Xos, Xos, Xos, Xos, Xos, Xos, Xos, Xos, Xos, Xos, Xos, Xos, Xos, Xos, Xos, Xos, Xos, Xos, Xos, Xos, Xos, Xos, Xos, Xos, Xos, Xos, Xos, Xos, Xos, Xos, Xos, Xos, Xos, Xos, Xos, Xos, Xos, Wwf, Wwf, Wwf, Rb, Xos, Xu, Xu, Xu, Xu, Xu, Xos, Xos, Xuc, Xuc, Uh, Urb, Urb, Urb, Urb, Urb, Urb, Urb^Ii, Urb, Urb, Urb, Uu^Uf, Uu^Uf, Wwf, Xos, Wwf, Xu, Xu, Xos, Xos
Xos, Xos, Xos, Xos, Xos, Xos, Xos, Xos, Xos, Xos, Xos, Xos, Xos, Xos, Xos, Xos, Xos, Xos, Xos, Xos, Xos, Xos, Xos, Xos, Xos, Xos, Xos, Xos, Xos, Xos, Xos, Xos, Xos, Xos, Xos, Xos, Xu, Xu, Xu, Xos, Rb, Wwf, Rb^Es, Xos, Xos, Xu, Xu, Xu, Xos, Xos, Xos, Xos, Uh, Urb, Urb, Urb, Urb, Urb, Urb, Urb^Es, Urb, Urb, Urb, Urb, Urb, Urb, Urb, Xos, Xos, Xos, Xu, Xu, Xos, Xos
Xos, Xos, Xos, Xos, Xos, Xos, Xos, Xos, Xos, Xos, Xos, Xos, Xos, Xos, Xos, Xos, Xos, Xos, Xos, Xos, Xos, Xos, Xos, Xos, Xos, Xos, Xos, Xos, Xos, Xos, Xos, Xos, Xos, Xos, Xos, Xos, Xu, Xu, Qxu, Qxu, Uh, Rb^Uf, Uu, Xos, Xos, Qxu, Qxu, Xos, Xos, Xos, Urb, Urb^Ebme, Urb, Urb, Xu, Uh, Uh, Urb, Urb, Urb, Urb, Urb, Urb, Urb^Es, Uu^Uf, Urb, Wwf, Xos, Xos, Xos, Xu, Xu, Xos, Xos
Xos, Xos, Xos, Xos, Xos, Xos, Xos, Xos, Xos, Xos, Xos, Xos, Xos, Xos, Xos, Xos, Xos, Xos, Xos, Xos, Xos, Xos, Xos, Xos, Xos, Xos, Xos, Xos, Xos, Xos, Xos, Xos, Xos, Xos, Xos, Xos, Xu, Xu, Qxu, Qxu, Qxu, Uh, Uu^Es, Urb, Urb, Qxu, Qxu, Xos, Urb, Urb^Ebme, Urb, Urb, Xu, Xu, Xu, Xu, Xos, Uu^Vu, Uu^Uf, Uh, Uu^Uf, Urb, Uu^Vu, Uh, Uu^Uf, Uh, Wwf, Wwf, Wwf, Xos, Xu, Xu, Xos, Xos
Xos, Xos, Xos, Xos, Xos, Xos, Xos, Xos, Xos, Xos, Xos, Xos, Xos, Xos, Xos, Xos, Xos, Xos, Xos, Xos, Xos, Xos, Xos, Xos, Xos, Xos, Xos, Xos, Xos, Xos, Xos, Xos, Xos, Xos, Xos, Xos, Xu, Xu, Xu, Qxu, Qxu, Qxu, Xu, Uu, Urb, Urb, Urb, Urb, Urb, Urb, Qxu, Qxu, Qxu, Xu, Xu, Xu, Xos, Xos, Xos, Uh, Uu^Uf, Urb, Uh, Uu^Uf, Xos, Xos, Xos, Xos, Xu, Xu, Xu, Xu, Xos, Xos
Xos, Xos, Xos, Xos, Xos, Xos, Xos, Xos, Xos, Xos, Xos, Xos, Xos, Xos, Xos, Xos, Xos, Xos, Xos, Xos, Xos, Xos, Xos, Xos, Xos, Xos, Xos, Xos, Xos, Xos, Xos, Xos, Xos, Xos, Xos, Xos, Xos, Xu, Xu, Xu, Xu, Xu, Xu, Xu, Qxu, Uh, Urb, Urb, Xu, Xu, Xu, Qxu, Xu, Xu, Xu, Xu, Xos, Xos, Xos, Xos, Xu, Wwf, Wwf, Xos, Xos, Xos, Xu, Xu, Xu, Xu, Xu, Xu, Xos, Xos
Xos, Xos, Xos, Xos, Xos, Xos, Xos, Xos, Xos, Xos, Xos, Xos, Xos, Xos, Xos, Xos, Xos, Xos, Xos, Xos, Xos, Xos, Xos, Xos, Xos, Xos, Xos, Xos, Xos, Xos, Xos, Xos, Xos, Xos, Xos, Xos, Xos, Xos, Xos, Xu, Xu, Xu, Xu, Xu, Qxu, Qxu, Xu, Xu, Xu, Xu, Xu, Xu, Xu, Xu, Xos, Xos, Xos, Xos, Xos, Xos, Xu, Xu, Wwf, Wwf, Xos, Xos, Xu, Xu, Xu, Xu, Xos, Xos, Xos, Xos
Xos, Xos, Xos, Xos, Xos, Xos, Xos, Xos, Xos, Xos, Xos, Xos, Xos, Xos, Xos, Xos, Xos, Xos, Xos, Xos, Xos, Xos, Xos, Xos, Xos, Xos, Xos, Xos, Xos, Xos, Xos, Xos, Xos, Xos, Xos, Xos, Xos, Xos, Xos, Xos, Xos, Xu, Xu, Xu, Xu, Qxu, Xu, Xu, Xu, Xu, Xu, Xu, Xos, Xos, Xos, Xos, Xos, Xos, Xos, Xos, Xu, Xu, Xos, Wwf, Xu, Xu, Xu, Xu, Xos, Xos, Xos, Xos, Xos, Xos
Xos, Xos, Xos, Xos, Xos, Xos, Xos, Xos, Xos, Xos, Xos, Xos, Xos, Xos, Xos, Xos, Xos, Xos, Xos, Xos, Xos, Xos, Xos, Xos, Xos, Xos, Xos, Xos, Xos, Xos, Xos, Xos, Xos, Xos, Xos, Xos, Xos, Xos, Xos, Xos, Xos, Xos, Xos, Xu, Xu, Xu, Xu, Xu, Xos, Xos, Xos, Xos, Xos, Xos, Xos, Xos, Xos, Xos, Xos, Xos, Xu, Xu, Xu, Xu, Xu, Xu, Xos, Xos, Xos, Xos, Xos, Xos, Xos, Xos
Xos, Xos, Xos, Xos, Xos, Xos, Xos, Xos, Xos, Xos, Xos, Xos, Xos, Xos, Xos, Xos, Xos, Xos, Xos, Xos, Xos, Xos, Xos, Xos, Xos, Xos, Xos, Xos, Xos, Xos, Xos, Xos, Xos, Xos, Xos, Xos, Xos, Xos, Xos, Xos, Xos, Xos, Xos, Xos, Xos, Xu, Xos, Xos, Xos, Xos, Xos, Xos, Xos, Xos, Xos, Xos, Xos, Xos, Xos, Xos, Xu, Xu, Xu, Xu, Xos, Xos, Xos, Xos, Xos, Xos, Xos, Xos, Xos, Xos
Xos, Xos, Xos, Xos, Xos, Xos, Xos, Xos, Xos, Xos, Xos, Xos, Xos, Xos, Xos, Xos, Xos, Xos, Xos, Xos, Xos, Xos, Xos, Xos, Xos, Xos, Xos, Xos, Xos, Xos, Xos, Xos, Xos, Xos, Xos, Xos, Xos, Xos, Xos, Xos, Xos, Xos, Xos, Xos, Xos, Xos, Xos, Xos, Xos, Xos, Xos, Xos, Xos, Xos, Xos, Xos, Xos, Xos, Xos, Xos, Xos, Xos, Xos, Xos, Xos, Xos, Xos, Xos, Xos, Xos, Xos, Xos, Xos, Xos
Xos, Xos, Xos, Xos, Xos, Xos, Xos, Xos, Xos, Xos, Xos, Xos, Xos, Xos, Xos, Xos, Xos, Xos, Xos, Xos, Xos, Xos, Xos, Xos, Xos, Xos, Xos, Xos, Xos, Xos, Xos, Xos, Xos, Xos, Xos, Xos, Xos, Xos, Xos, Xos, Xos, Xos, Xos, Xos, Xos, Xos, Xos, Xos, Xos, Xos, Xos, Xos, Xos, Xos, Xos, Xos, Xos, Xos, Xos, Xos, Xos, Xos, Xos, Xos, Xos, Xos, Xos, Xos, Xos, Xos, Xos, Xos, Xos, Xos
Xos, Xos, Xos, Xos, Xos, Xos, Xos, Xos, Xos, Xos, Xos, Xos, Xos, Xos, Xos, Xos, Xos, Xos, Xos, Xos, Xos, Xos, Xos, Xos, Xos, Xos, Xos, Xos, Xos, Xos, Xos, Xos, Xos, Xos, Xos, Xos, Xos, Xos, Xos, Xos, Xos, Xos, Xos, Xos, Xos, Xos, Xos, Xos, Xos, Xos, Xos, Xos, Xos, Xos, Xos, Xos, Xos, Xos, Xos, Xos, Xos, Xos, Xos, Xos, Xos, Xos, Xos, Xos, Xos, Xos, Xos, Xos, Xos, Xos
