border_size=1
usage=map

Xv, Xv, Xv, Xv, Xv, Xv, Xv, Xv, Xv, Xv, Xv, Xv, Xv, Xv, Xv, Xv, Xv, Xv, Xv, Xv, Xv, Xv, Xv, Xv, Xv, Xv, Xv^Gov, Xv, Xv, Xv, Xv, Xv, Xv, Xv, Xv, Xv, Xv, Xv, Xv, Xv, Xv, Xv, Xv, Xv, Xv, Xv, Xv, Xv, Xv, Xv, Xv, Xv, Xv, Xv
Xv, Xv, Xv, Xv, Xv, Xv, Xv, Xv, Xv, Xv, Xv, Xv, Xv, Xv, Xv, Xv, Xv, Xv, Xv, Xv, Xv, Xv, Xv, Xv, Xv, Xv, Xv^Gov, Xv, Xv, Xv, Xv, Xv, Xv, Xv, Xv, Xv, Xv, Xv, Xv, Xv, Xv, Xv, Xv, Xv, Xv, Xv, Xv, Xv, Xv, Xv, Xv, Xv, Xv, Xv
Xv, Xv, Xv, Xv, Xv, Xv, Xv, Xv, Xv, Xv, Xv, Xv, Xv, Xv, Xv, Xv, Xv, Xv, Xv, Xv, Xv, Xv, Xv, Xv, Xv, Xv, Xv^Gov, Xv, Xv, Xv, Xv, Xv, Xv, Xv, Xv, Xv, Xv, Xv, Xv, Xv, Xv, Xv, Xv, Xv, Xv, Xv, Xv, Xv, Xv, Xv, Xv, Xv, Xv, Xv
Xv, Xv, Xv, Xv, Xv, Xv, Xv, Xv, Xv, Xv, Xv, Xv, Xv, Xv, Xv, Xv, Xv, Xv, Xv, Xv, Xv, Xv, Xv, Xv, Xv, Xv, Xv^Gov, Xv, Xv, Xv, Xv, Xv, Xv, Xv, Xv, Xv, Xv, Xv, Xv, Xv, Xv, Xv, Xv, Xv, Xv, Xv, Xv, Xv, Xv, Xv, Xv, Xv, Xv, Xv
Xv, Xv, Xv, Xv, Xv, Xv, Xv, Xv, Xv, Xv, Xv, Xv, Xv, Xv, Xv, Xv, Xv, Xv, Xv, Xv, Xv, Xv, Xv, Xv, Xv, Xv, Xv^Gov, Xv, Xv, Xv, Xv, Xv, Xv, Xv, Xv, Xv, Xv, Xv, Xv, Xv, Xv, Xv, Xv, Xv, Xv, Xv, Xv, Xv, Xv, Xv, Xv, Xv, Xv, Xv
Xv, Xv, Xv, Xv, Xv, Xv, Xv, Xv, Xv, Xv, Xv, Xv, Xv, Xv, Xv, Xv, Xv, Xv, Xv, Xv, Xv, Xv, Xv, Xv, Xv, Xv, Xv^Gov, Xv, Xv, Xv, Xv, Xv, Xv, Xv, Xv, Xv, Xv, Xv, Xv, Xv, Xv, Xv, Xv, Xv, Xv, Xv, Xv, Xv, Xv, Xv, Xv, Xv, Xv, Xv
Xv, Xv, Xv, Xv, Xv, Xv, Xv, Xv, Xv, Xv, Xv, Xv, Xv, Xv, Xv, Xv, Xv, Xv, Xv, Xv, Xv, Xv, Xv, Xv, Xv, Xv, Xv^Gov, Xv, Xv, Xv, Xv, Xv, Xv, Xv, Xv, Xv, Xv, Xv, Xv, Xv, Xv, Xv, Xv, Xv, Xv, Xv, Xv, Xv, Xv, Xv, Xv, Xv, Xv, Xv
Xv, Xv, Xv, Xv, Xv, Xv, Xv, Xv, Xv, Xv, Xv, Xv, Xv, Xv, Xv, Xv, Xv, Xv, Xv, Xv, Xv, Xv, Xv, Xv, Xv, Xv, Xv^Gov, Xv, Xv, Xv, Xv, Xv, Xv, Xv, Xv, Xv, Xv, Xv, Xv, Xv, Xv, Xv, Xv, Xv, Xv, Xv, Xv, Xv, Xv, Xv, Xv, Xv, Xv, Xv
Xv, Xv, Xv, Xv, Xv, Xv, Xv, Xv, Xv, Xv, Xv, Xv, Xv, Xv, Xv, Xv, Xv, Xv, Xv, Xv, Xv, Xv, Xv, Xv, Xv, Xv, Xv^Gov, Xv, Xv, Xv, Xv, Xv, Xv, Xv, Xv, Xv, Xv, Xv, Xv, Xv, Xv, Xv, Xv, Xv, Xv, Xv, Xv, Xv, Xv, Xv, Xv, Xv, Xv, Xv
Xv, Xv, Xv, Xv, Xv, Xv, Xv, Xv, Xv, Xv, Xv, Xv, Xv, Xv, Xv, Xv, Xv, Xv, Xv, Xv, Xv, Xv, Xv, Xv, Xv, Xv, Xv^Gov, Xv, Xv, Xv, Xv, Xv, Xv, Xv, Xv, Xv, Xv, Xv, Xv, Xv, Xv, Xv, Xv, Xv, Xv, Xv, Xv, Xv, Xv, Xv, Xv, Xv, Xv, Xv
Xv, Xv, Xv, Xv, Xv, Xv, Xv, Xv, Xv, Xv, Xv, Xv, Xv, Xv, Xv, Xv, Xv, Xv, Xv, Xv, Xv, Xv, Xv, Xv, Xv, Xv, Xv^Gov, Xv, Xv, Xv, Xv, Xv, Xv, Xv, Xv, Xv, Xv, Xv, Xv, Xv, Xv, Xv, Xv, Xv, Xv, Xv, Xv, Xv, Xv, Xv, Xv, Xv, Xv, Xv
Xv, Xv, Xv, Xv, Xv, Xv, Xv, Xv, Xv, Xv, Xv, Xv, Xv, Xv, Xv, Xv, Xv, Xv, Xv, Xv, Xv, Xv, Xv, Xv, Xv, Xv, Xv^Gov, Xv, Xv, Xv, Xv, Xv, Xv, Xv, Xv, Xv, Xv, Xv, Xv, Xv, Xv, Xv, Xv, Xv, Xv, Xv, Xv, Xv, Xv, Xv, Xv, Xv, Xv, Xv
Xv^Xo, Xv^Xo, Xv^Xo, Xv^Xo, Xv^Xo, Xv^Xo, Xv^Xo, Xv^Xo, Xv^Xo, Xv^Xo, Xv^Xo, Xv^Xo, Xv^Xo, Xv^Xo, Xv^Xo, Xv^Xo, Xv^Xo, Xv^Xo, Xv^Xo, Xv^Xo, Xv^Xo, Xv^Xo, Xv^Xo, Xv^Xo, Xv^Xo, Xv^Xo, Xv^Xo, Xv^Xo, Xv^Xo, Xv^Xo, Xv^Xo, Xv^Xo, Xv^Xo, Xv^Xo, Xv^Xo, Xv^Xo, Xv^Xo, Xv^Xo, Xv^Xo, Xv^Xo, Xv^Xo, Xv^Xo, Xv^Xo, Xv^Xo, Xv^Xo, Xv^Xo, Xv^Xo, Xv^Xo, Xv^Xo, Xv^Xo, Xv^Xo, Xv^Xo, Xv^Xo, Xv^Xo
Xv, Xv, Xv, Xv, Xv, Xv, Xv, Xv, Xv, Xv, Xv, Xv, Xv, Xv, Xv, Xv, Xv, Xv, Xv, Xv, Xv, Xv, Xv, Xv, Xv, Xv, Xv^Gov, Xv, Xv, Xv, Xv, Xv, Xv, Xv, Xv, Xv, Xv, Xv, Xv, Xv, Xv, Xv, Xv, Xv, Xv, Xv, Xv, Xv, Xv, Xv, Xv, Xv, Xv, Xv
Xv, Xv, Xv, Xv, Xv, Xv, Xv, Xv, Xv, Xv, Xv, Xv, Xv, Xv, Xv, Xv, Xv, Xv, Xv, Xv, Xv, Xv, Xv, Xv, Xv, Xv, Xv^Gov, Xv, Xv, Xv, Xv, Xv, Xv, Xv, Xv, Xv, Xv, Xv, Xv, Xv, Xv, Xv, Xv, Xv, Xv, Xv, Xv, Xv, Xv, Xv, Xv, Xv, Xv, Xv
Xv, Xv, Xv, Xv, Xv, Xv, Xv, Xv, Xv, Xv, Xv, Xv, Xv, Xv, Xv, Xv, Xv, Xv, Xv, Xv, Xv, Xv, Xv, Xv, Xv, Xv, Xv^Gov, Xv, Xv, Xv, Xv, Xv, Xv, Xv, Xv, Xv, Xv, Xv, Xv, Xv, Xv, Xv, Xv, Xv, Xv, Xv, Xv, Xv, Xv, Xv, Xv, Xv, Xv, Xv
Xv, Xv, Xv, Xv, Xv, Xv, Xv, Xv, Xv, Xv, Xv, Xv, Xv, Xv, Xv, Xv, Xv, Xv, Xv, Xv, Xv, Xv, Xv, Xv, Xv, Xv, Xv^Gov, Xv, Xv, Xv, Xv, Xv, Xv, Xv, Xv, Xv, Xv, Xv, Xv, Xv, Xv, Xv, Xv, Xv, Xv, Xv, Xv, Xv, Xv, Xv, Xv, Xv, Xv, Xv
Xv, Xv, Xv, Xv, Xv, Xv, Xv, Xv, Xv, Xv, Xv, Xv, Xv, Xv, Xv, Xv, Xv, Xv, Xv, Xv, Xv, Xv, Xv, Xv, Xv, Xv, Xv^Gov, Xv, Xv, Xv, Xv, Xv, Xv, Xv, Xv, Xv, Xv, Xv, Xv, Xv, Xv, Xv, Xv, Xv, Xv, Xv, Xv, Xv, Xv, Xv, Xv, Xv, Xv, Xv
Xv, Xv, Xv, Xv, Xv, Xv, Xv, Xv, Xv, Xv, Xv, Xv, Xv, Xv, Xv, Xv, Xv, Xv, Xv, Xv, Xv, Xv, Xv, Xv, Xv, Xv, Xv^Gov, Xv, Xv, Xv, Xv, Xv, Xv, Xv, Xv, Xv, Xv, Xv, Xv, Xv, Xv, Xv, Xv, Xv, Xv, Xv, Xv, Xv, Xv, Xv, Xv, Xv, Xv, Xv
Xv, Xv, Xv, Xv, Xv, Xv, Xv, Xv, Xv, Xv, Xv, Xv, Xv, Xv, Xv, Xv, Xv, Xv, Xv, Xv, Xv, Xv, Xv, Xv, Xv, Xv, Xv^Gov, Xv, Xv, Xv, Xv, Xv, Xv, Xv, Xv, Xv, Xv, Xv, Xv, Xv, Xv, Xv, Xv, Xv, Xv, Xv, Xv, Xv, Xv, Xv, Xv, Xv, Xv, Xv
Xv, Xv, Xv, Xv, Xv, Xv, Xv, Xv, Xv, Xv, Xv, Xv, Xv, Xv, Xv, Xv, Xv, Xv, Xv, Xv, Xv, Xv, Xv, Xv, Xv, Xv, Xv^Gov, Xv, Xv, Xv, Xv, Xv, Xv, Xv, Xv, Xv, Xv, Xv, Xv, Xv, Xv, Xv, Xv, Xv, Xv, Xv, Xv, Xv, Xv, Xv, Xv, Xv, Xv, Xv
Xv, Xv, Xv, Xv, Xv, Xv, Xv, Xv, Xv, Xv, Xv, Xv, Xv, Xv, Xv, Xv, Xv, Xv, Xv, Xv, Xv, Xv, Xv, Xv, Xv, Xv, Xv^Gov, Xv, Xv, Xv, Xv, Xv, Xv, Xv, Xv, Xv, Xv, Xv, Xv, Xv, Xv, Xv, Xv, Xv, Xv, Xv, Xv, Xv, Xv, Xv, Xv, Xv, Xv, Xv
Xv, Xv, Xv, Xv, Xv, Xv, Xv, Xv, Xv, Xv, Xv, Xv, Xv, Xv, Xv, Xv, Xv, Xv, Xv, Xv, Xv, Xv, Xv, Xv, Xv, Xv, Xv^Gov, Xv, Xv, Xv, Xv, Xv, Xv, Xv, Xv, Xv, Xv, Xv, Xv, Xv, Xv, Xv, Xv, Xv, Xv, Xv, Xv, Xv, Xv, Xv, Xv, Xv, Xv, Xv
Xv, Xv, Xv, Xv, Xv, Xv, Xv, Xv, Xv, Xv, Xv, Xv, Xv, Xv, Xv, Xv, Xv, Xv, Xv, Xv, Xv, Xv, Xv, Xv, Xv, Xv, Xv^Gov, Xv, Xv, Xv, Xv, Xv, Xv, Xv, Xv, Xv, Xv, Xv, Xv, Xv, Xv, Xv, Xv, Xv, Xv, Xv, Xv, Xv, Xv, Xv, Xv, Xv, Xv, Xv
Xv, Xv, Xv, Xv, Xv, Xv, Xv, Xv, Xv, Xv, Xv, Xv, Xv, Xv, Xv, Xv, Xv, Xv, Xv, Xv, Xv, Xv, Xv, Xv, Xv, Xv, Xv^Gov, Xv, Xv, Xv, Xv, Xv, Xv, Xv, Xv, Xv, Xv, Xv, Xv, Xv, Xv, Xv, Xv, Xv, Xv, Xv, Xv, Xv, Xv, Xv, Xv, Xv, Xv, Xv
Xv, Xv, Xv, Xv, Xv, Xv, Xv, Xv, Xv, Xv, Xv, Xv, Xv, Xv, Xv, Xv, Xv, Xv, Xv, Xv, Xv, Xv, Xv, Xv, Xv, Xv, Xv^Gov, Xv, Xv, Xv, Xv, Xv, Xv, Xv, Xv, Xv, Xv, Xv, Xv, Xv, Xv, Xv, Xv, Xv, Xv, Xv, Xv, Xv, Xv, Xv, Xv, Xv, Xv, Xv
Xv, Xv, Xv, Xv, Xv, Xv, Xv, Xv, Xv, Xv, Xv, Xv, Xv, Xv, Xv, Xv, Xv, Xv, Xv, Xv, Xv, Xv, Xv, Xv, Xv, Xv, Xv^Gov, Xv, Xv, Xv, Xv, Xv, Xv, Xv, Xv, Xv, Xv, Xv, Xv, Xv, Xv, Xv, Xv, Xv, Xv, Xv, Xv, Xv, Xv, Xv, Xv, Xv, Xv, Xv
Xv, Xv, Xv, Xv, Xv, Xv, Xv, Xv, Xv, Xv, Xv, Xv, Xv, Xv, Xv, Xv, Xv, Xv, Xv, Xv, Xv, Xv, Xv, Xv, Xv, Xv, Xv^Gov, Xv, Xv, Xv, Xv, Xv, Xv, Xv, Xv, Xv, Xv, Xv, Xv, Xv, Xv, Xv, Xv, Xv, Xv, Xv, Xv, Xv, Xv, Xv, Xv, Xv, Xv, Xv
Xv, Xv, Xv, Xv, Xv, Xv, Xv, Xv, Xv, Xv, Xv, Xv, Xv, Xv, Xv, Xv, Xv, Xv, Xv, Xv, Xv, Xv, Xv, Xv, Qxua, Xv, Xv^Gov, Xv, Xv, Xv, Xv, Xv, Xv, Xv, Xv, Xv, Xv, Xv, Xv, Xv, Xv, Xv, Xv, Xv, Xv, Xv, Xv, Xv, Xv, Xv, Xv, Xv, Xv, Xv
Xv, Xv, Xv, Xv, Xv, Xv, Xv, Xv, Xv, Xv, Xv, Xv, Xv, Xv, Xv, Xv, Xv, Xv, Xv, Xv, Xv, Xv, Xv, Qxua, Xv, Xv, Xv^Gov, Xv, Xv, Xv, Xv, Xv, Qxua, Xv, Xv, Xv, Xv, Xv, Xv, Xv, Xv, Xv, Xv, Xv, Xv, Xv, Xv, Xv, Xv, Xv, Xv, Xv, Xv, Xv
Xv, Xv, Xv, Xv, Xv, Xv, Xv, Xv, Xv, Xv, Xv, Xv, Xv, Xv, Xv, Xv, Xv, Xv, Xv, Xv, Xv, Xv, Qxua, Qxua, Qxua, Xv, Xv^Gov, Xv, Xv, Xv, Xv, Qxua, Xv, Xv, Xv, Xv, Xv, Xv, Xv, Xv, Xv, Xv, Xv, Xv, Xv, Xv, Xv, Xv, Xv, Xv, Xv, Xv, Xv, Xv
Xv, Xv, Xv, Xv, Xv, Xv, Xv, Xv, Xv, Xv, Xv, Xv, Xv, Xv, Xv, Xv, Xv, Xv, Xv, Xv, Xv, Xv, Xv, Xv, Xv, Xv, Xv^Gov, Xv, Xv, Xv, Xv, Qxua, Qxua, Xv, Xv, Xv, Xv, Xv, Xv, Xv, Xv, Xv, Xv, Xv, Xv, Xv, Xv, Xv, Xv, Xv, Xv, Xv, Xv, Xv
Xv, Xv, Xv, Xv, Xv, Xv, Xv, Xv, Xv, Xv, Xv, Xv, Xv, Xv, Xv, Xv, Xv, Xv, Xv, Xv, Qxua, Qxua, Xv, Xv, Qxua, Xv, Xv^Gov, Xv, Xv, Xv, Xv, Qxua, Qxua, Qxua, Xv, Xv, Xv, Xv, Xv, Xv, Xv, Xv, Xv, Xv, Xv, Xv, Xv, Xv, Xv, Xv, Xv, Xv, Xv, Xv
Xv, Xv, Xv, Xv, Xv, Xv, Xv, Xv, Xv, Xv, Xv, Xv, Xv, Xv, Xv, Xv, Xv, Xv, Qxua, Xv, Qxua, Xv, Xv, Xv, Xv, Qxua, Qxua^Gov, Qxua, Xv, Xv, Qxua, Qxua, Qxua, Xv, Xv, Xv, Xv, Xv, Xv, Xv, Xv, Xv, Xv, Xv, Xv, Xv, Xv, Xv, Xv, Xv, Xv, Xv, Xv, Xv
Xv, Xv, Xv, Xv, Xv, Xv, Xv, Xv, Xv, Xv, Xv, Xv, Xv, Xv, Xv, Xv, Xv, Xv, Xv, Qxua, Xv, Xv, Xv, Xv, Xv, Xv, Qxua^Gov, Qxua, Xv, Xv, Xv, Xv, Xv, Qxua, Xv, Xv, Xv, Xv, Xv, Xv, Xv, Xv, Xv, Xv, Xv, Xv, Xv, Xv, Xv, Xv, Xv, Xv, Xv, Xv
Xv, Xv, Xv, Xv, Xv, Xv, Xv, Xv, Xv, Xv, Xv, Xv, Xv, Xv, Xv, Xv, Xv, Xv, Xv, Xv, Xv, Xv, Qxua, Xv, Xv, Xv, Xv^Gov, Xv, Xv, Qxua, Xv, Qxua, Xv, Xv, Xv, Qxua, Xv, Xv, Xv, Xv, Xv, Xv, Xv, Xv, Xv, Xv, Xv, Xv, Xv, Xv, Xv, Xv, Xv, Xv
Xv, Xv, Xv, Xv, Xv, Xv, Xv, Xv, Xv, Xv, Xv, Xv, Xv, Xv, Xv, Xv, Xv, Xv, Xv, Xv, Xv, Qxua, Qxua, Xv, Xv, Qxua, Qxua^Gov, Xv, Qxua, Qxua, Xv, Qxua, Xv, Xv, Xv, Xv, Xv, Xv, Xv, Xv, Xv, Xv, Xv, Xv, Xv, Xv, Xv, Xv, Xv, Xv, Xv, Xv, Xv, Xv
Xv, Xv, Xv, Xv, Xv, Xv, Xv, Xv, Xv, Xv, Xv, Xv, Xv, Xv, Xv, Qxua, Qxua, Xv, Xv, Xv, Qxua, Xv, Qxua, Qxua, Qxua, Xv, Qxua^Gov, Qxua, Xv, Qxua, Xv, Xv, Xv, Qxua, Xv, Xv, Qxua, Xv, Qxua, Qxua, Xv, Xv, Xv, Xv, Xv, Xv, Xv, Xv, Xv, Xv, Xv, Xv, Xv, Xv
Xv, Xv, Xv, Xv, Xv, Xv, Xv, Xv, Xv, Xv, Xv, Xv, Xv, Xv, Xv, Xv, Xv, Qxua, Xv, Xv, Xv, Qxua, Qxua, Xv, Qxua, Xv, Qxua^Gov, Xv, Qxua, Qxua, Xv, Xv, Xv, Qxua, Xv, Xv, Xv, Qxua, Xv, Xv, Xv, Xv, Xv, Xv, Xv, Xv, Xv, Xv, Xv, Xv, Xv, Xv, Xv, Xv
Xv, Xv, Xv, Xv, Xv, Xv, Xv, Xv, Xv, Xv, Xv, Xv, Xv, Xv, Xv, Xv, Xv, Xv, Xv, Qxua, Xv, Qxua, Qxua, Xv, Xv, Qxua, Qxua^Gov, Qxua, Xv, Xv, Xv, Qxua, Qxua, Xv, Xv, Xv, Xv, Xv, Xv, Xv, Xv, Xv, Xv, Xv, Xv, Xv, Xv, Xv, Mm, Xv, Mm^Xm, Mm, Mm, Xv
Xv, Xv, Xv, Xv, Xv, Xv, Xv, Xv, Xv, Xv, Xv, Xv, Xv, Xv, Xv, Xv, Xv, Xv, Xv, Xv, Xv, Qxua, Qxua, Qxua, Xv, Xv, Xv^Gov, Qxua, Xv, Qxua, Qxua, Qxua, Xv, Xv, Xv, Xv, Xv, Xv, Mm, Mm^Xm, Mm^Xm, Xv, Xv, Xv, Mm^Xm, Xv, Mm, Mm^Xm, Mm, Mm, Mm, Mm, Mm, Mm
Xv, Xv, Xv, Xv, Mm, Xv, Mm, Xv, Xv, Xv, Mm^Xm, Mm, Mm, Mm, Mm^Xm, Mm, Mm, Xv, Mm, Mm, Mm^Xm, Xv, Xv, Qxua, Xv, Xv, Xv^Gov, Xv, Qxua, Qxua, Xv, Xv, Mm^Xm, Xv, Xv, Xv, Mm, Mm^Xm, Mm, Mm, Mm, Mm^Xm, Mm, Mm, Mm, Mm^Xm, Mm, Mm, Mm, Mm, Mm, Mm, Mm^Xm, Mm
Xv, Xv, Mm, Mm, Mm, Mm, Mm, Mm, Mm, Mm, Mm, Mm, Mm, Mm, Mm, Mm, Mm, Mm, Mm, Mm, Mm^Xm, Mm^Xm, Mm, Xv, Qxua, Xv, 1 Xv^Gov, Xv, Qxua, Mm, Mm, Mm, Mm, Mm^Xm, Mm, Mm, Mm, Mm, Mm^Xm, Mm, Mm, Mm, Mm, Mm, Mm, Mm, Mm, Mm, Mm, Mm, Mm, Mm^Xm, Mm, Mm
Mm, Mm, Mm^Xm, Mm, Mm, Mm, Mm^Xm, Mm, Mm, Mm, Mm, Mm, Ql, Mm, Mm, Mm, Mm, Mm, Mm, Mm, Mm, Mm, Mm, Mm, Qxua, Xv, Xv, Xv, Qxua, Mm, Mm, Mm, Mm, Mm, Mm, Mm, Mm, Mm, Mm, Mm, Mm, Mm, Mm, Mm, Mm, Mm, Mm, Mm, Mm, Mm, Mm, Mm, Mm^Xm, Mm
Mm, Mm, Mm, Mm, Mm, Mm, Mm, Mm, Uzw, Mm, Mm, Mm, Ql, Uzw, Ql, Mm, Mm, Uzw, Mm, Mm, Mm, Mm, Ql, Ql, Qxua, Xv, Xv, Qxua, Qxua, Mm, Mm, Mm, Uzw, Mm, Uzw, Mm, Mm, Mm, Mm, Mm, Mm, Mm, Uzw, Uzw, Uzw, Mm, Uzw, Mm, Mm, Mm, Mm, Mm, Mm, Mm
Mm, Mm, Mm, Mm, Mm, Mm, Mm, Mm, Ql, Uzw, Mm, Mm, Ql, Uzw, Ql, Mm, Mm, Uzw, Uzw, Mm, Uzw, Uzw, Ql, Ql, Qxua, Qxua, Xv, Qxua, Qxua, Qxua, Ql, Uzw, Uzw, Uzw, Uzw, Mm, Uzw, Uzw, Uzw, Mm, Uzw, Uzw, Uzw, Uzw, Uzw, Mm, Uzw, Uzw, Uzw, Uzw, Mm, Mm, Mm, Mm
Uzw, Mm, Mm, Uzw, Uzw, Mm, Uzw, Uzw, Ql, Uzw, Uzw, Uzw, Uzw, Ql, Ql, Uzw, Mm, Uzw, Uzw, Uzw, Uzw, Ql, Ql, Qxua, Qxua, Qxua, Xv, Xv, Qxua, Qxua, Ql, Ql, Ql, Ql, Uzw, Uzw, Ql, Ql, Uzw, Uzw, Uzw, Uzw, Uzw, Uzw, Uzw, Uzw, Uzw, Uzw, Uzw, Mm, Uzw, Uzw, Uzw, Mm
Uzw, Uzw, Uzw, Uzw, Ql, Ql, Ql, Uzw, Ql, Ql, Uzw, Uzw, Ql, Ql, Ql, Ql, Ql, Uzw, Ql, Ql, Ql, Ql, Qxua, Qxua, Qxua, Qxua, Xv, Qxua, Qxua, Qxua, Qxua, Ql, Ql, Ql, Uzw, Uzw, Ql, Ql, Ql, Uzw, Uzw, Uzw, Uzw, Uzw, Uzw, Ql, Ql, Uzw, Ql, Uzw, Uzw, Uzw, Uzw, Uzw
Uzw, Uzw, Uzw, Uzw, Ql, Ql, Ql, Uzw, Ql, Ql, Uzw, Ql, Ql, Uzw, Ql, Ql, Ql, Uzw, Ql, Ql, Ql, Qxua, Qxua, Qxua, Qxua, Xv, Xv, Xv, Xv, Qxua, Qxua, Ql, Ql, Ql, Ql, Ql, Uzw, Uzw, Ql, Uzw, Uzw, Uzw, Ql, Uzw, Uzw, Ql, Ql, Uzw, Ql, Ql, Uzw, Uzw, Uzw, Uzw
Uzw, Uzw, Ql, Ql, Ql, Ql, Ql, Ql, Ql, Uzw, Uzw, Ql, Ql, Ql, Ql, Ql, Ql, Ql, Ql, Ql, Ql, Qxua, Qxua, Qxua, Qxua, Qxua, Xv, Qxua, Xv, Qxua, Qxua, Qxua, Ql, Ql, Ql, Ql, Uzw, Uzw, Uzw, Ql, Ql, Uzw, Ql, Uzw, Ql, Ql, Uzw, Uzw, Uzw, Ql, Ql, Uzw, Uzw, Uzw
Uzw, Uzw, Uzw, Ql, Uzw, Uzw, Uzw, Ql, Ql, Ql, Ql, Ql, Ql, Ql, Ql, Ql, Ql, Qxua, Qxua, Qxua, Qxua, Qxua, Qxua, Qxua, Qxua, Xv, Qxua, Qxua, Qxua, Xv, Qxua, Qxua, Ql, Ql, Qxua, Ql, Uzw, Uzw, Uzw, Uzw, Ql, Ql, Ql, Ql, Uzw, Uzw, Uzw, Uzw, Uzw, Uzw, Uzw, Ql, Ql, Uzw
Ql, Uzw, Uzw, Ql, Ql, Ql, Ql, Ql, Ql, Ql, Ql, Ql, Ql, Ql, Ql, Ql, Qxua, Qxua, Qxua, Qxua, Qxua, Qxua, Qxua, Qxua, Xv, Xv, Xv, Qxua, Qxua, Qxua, Qxua, Qxua, Ql, Qxua, Qxua, Qxua, Ql, Uzw, Ql, Uzw, Ql, Ql, Ql, Ql, Ql, Uzw, Uzw, Uzw, Uzw, Ql, Uzw, Ql, Ql, Ql
Ql, Ql, Ql, Uzw, Ql, Ql, Ql, Ql, Ql, Ql, Ql, Ql, Ql, Qxua, Qxua, Ql, Qxua, Ql, Ql, Qxua, Qxua, Qxua, Qxua, Qxua, Qxua, Qxua, Xv, Xv, Xv, Qxua, Qxua, Qxua, Qxua, Qxua, Qxua, Qxua, Ql, Ql, Ql, Ql, Uzw, Uzw, Ql, Ql, Ql, Uzw, Uzw, Ql, Ql, Ql, Ql, Ql, Uzw, Ql
Uzw, Ql, Ql, Ql, Uzw, Ql, Ql, Ql, Ql, Ql, Ql, Ql, Qxua, Ql, Ql, Qxua, Qxua, Qxua, Qxua, Qxua, Qxua, Qxua, Qxua, Xv, Xv, Qxua, Qxua, Qxua, Xv, Qxua, Xv, Qxua, Qxua, Ql, Ql, Qxua, Qxua, Ql, Ql, Ql, Uzw, Ql, Ql, Ql, Ql, Ql, Ql, Ql, Ql, Ql, Uzw, Ql, Uzw, Uzw
Uzw, Uzw, Ql, Uzw, Uzw, Uzw, Ql, Ql, Uzw, Uzw, Ql, Ql, Qxua, Ql, Uzw, Qxua, Qxua, Qxua, Qxua, Qxua, Qxua, Qxua, Xv, Xv, Qxua, Qxua, Qxua, Qxua, Xv, Xv, Qxua, Qxua, Qxua, Qxua, Qxua, Qxua, Qxua, Ql, Ql, Uzw, Uzw, Ql, Ql, Qxua, Uzw, Uzw, Ql, Uzw, Ql, Ql, Ql, Ql, Uzw, Uzw
Ql, Ql, Uzw, Uzw, Uzw, Uzw, Ql, Uzw, Uzw, Uzw, Ql, Ql, Qxua, Qxua, Qxua, Qxua, Qxua, Qxua, Qxua, Qxua, Qxua, Qxua, Xv, Qxua, Xv, Qxua, Xv, Xv, Qxua, Qxua, Qxua, Qxua, Ql, Qxua, Qxua, Ql, Ql, Qxua, Uzw, Ql, Qxua, Ql, Qxua, Qxua, Qxua, Ql, Ql, Ql, Ql, Ql, Ql, Uzw, Ql, Uzw
Ql, Ql, Uzw, Ql, Ql, Ql, Ql, Uzw, Ql, Ql, Ql, Qxua, Qxua, Qxua, Qxua, Qxua, Ql, Ql, Qxua, Qxua, Xv, Xv, Xv, Xv, Xv, Qxua, Xv, Xv, Xv, Qxua, Qxua, Qxua, Qxua, Qxua, Qxua, Qxua, Qxua, Qxua, Qxua, Qxua, Qxua, Qxua, Qxua, Qxua, Ql, Ql, Ql, Uzw, Ql, Ql, Ql, Ql, Ql, Uzw
Uzw, Ql, Ql, Ql, Ql, Ql, Uzw, Ql, Ql, Ql, Ql, Ql, Qxua, Qxua, Ql, Qxua, Qxua, Qxua, Qxua, Qxua, Xv, Qxua, Qxua, Qxua, Xv, Xv, Xv, Xv, Xv, Qxua, Xv, Qxua, Qxua, Qxua, Ql, Qxua, Qxua, Qxua, Qxua, Qxua, Ql, Qxua, Uzw, Uzw, Ql, Ql, Ql, Uzw, Ql, Uzw, Ql, Ql, Ql, Ql
Uzw, Ql, Uzw, Ql, Uzw, Uzw, Ql, Ql, Ql, Ql, Qxua, Qxua, Ql, Qxua, Qxua, Qxua, Qxua, Qxua, Ql, Qxua, Qxua, Qxua, Xv, Qxua, Xv, Xv, 2 Xv, Xv, Xv, Xv, Qxua, Qxua, Qxua, Qxua, Qxua, Qxua, Qxua, Qxua, Qxua, Ql, Qxua, Ql, Ql, Ql, Ql, Uzw, Ql, Ql, Ql, Uzw, Uzw, Ql, Ql, Ql
Ql, Ql, Uzw, Ql, Uzw, Uzw, Ql, Ql, Ql, Ql, Ql, Qxua, Ql, Qxua, Qxua, Ql, Qxua, Qxua, Qxua, Qxua, Qxua, Xv, Qxua, Xv, Xv, Xv, Xv, Xv, Xv, Xv, Xv, Xv, Xv, Qxua, Qxua, Qxua, Qxua, Qxua, Qxua, Qxua, Ql, Qxua, Ql, Ql, Ql, Ql, Ql, Ql, Ql, Ql, Ql, Ql, Ql, Ql
Uzw, Uzw, Ql, Ql, Uzw, Ql, Ql, Qxua, Qxua, Ql, Qxua, Qxua, Ql, Ql, Qxua, Qxua, Ql, Qxua, Qxua, Qxua, Qxua, Qxua, Xv, Xv, Xv, Xv, Xv, Xv, Xv, Xv, Xv, Xv, Xv, Qxua, Qxua, Qxua, Qxua, Qxua, Qxua, Ql, Ql, Ql, Ql, Uzw, Ql, Ql, Ql, Uzw, Uzw, Ql, Ql, Uzw, Ql, Ql
Uzw, Uzw, Ql, Ql, Ql, Ql, Ql, Ql, Uzw, Qxua, Qxua, Ql, Qxua, Qxua, Qxua, Qxua, Ql, Qxua, Qxua, Qxua, Qxua, Qxua, Xv, Xv, Qxua, Xv, Xv, Xv, Xv, Xv, Qxua, Xv, Qxua, Xv, Qxua, Qxua, Qxua, Qxua, Qxua, Qxua, Qxua, Qxua, Ql, Ql, Ql, Ql, Uzw, Ql, Uzw, Ql, Ql, Ql, Uzw, Uzw
Uzw, Ql, Ql, Ql, Uzw, Uzw, Ql, Uzw, Uzw, Qxua, Qxua, Qxua, Qxua, Ql, Qxua, Qxua, Ql, Qxua, Qxua, Qxua, Qxua, Xv, Qxua, Qxua, Qxua, Xv, Xv, Xv, Xv, Xv, Xv, Qxua, Xv, Qxua, Qxua, Qxua, Ql, Qxua, Ql, Qxua, Qxua, Ql, Ql, Ql, Ql, Ql, Uzw, Ql, Ql, Ql, Ql, Ql, Uzw, Uzw
Uzw, Uzw, Ql, Uzw, Uzw, Uzw, Uzw, Ql, Qxua, Qxua, Ql, Qxua, Qxua, Ql, Qxua, Qxua, Qxua, Qxua, Qxua, Qxua, Qxua, Qxua, Qxua, Qxua, Qxua, Xv, Xv, Qxua, Xv, Xv, Qxua, Qxua, Qxua, Xv, Xv, Ql, Qxua, Qxua, Qxua, Qxua, Ql, Ql, Ql, Ql, Ql, Uzw, Qxua, Qxua, Ql, Ql, Ql, Ql, Ql, Uzw
Ql, Ql, Ql, Ql, Uzw, Uzw, Uzw, Ql, Ql, Ql, Ql, Ql, Qxua, Qxua, Qxua, Qxua, Qxua, Qxua, Qxua, Ql, Qxua, Qxua, Xv, Xv, Xv, Xv, Qxua, Qxua, Xv, Xv, Xv, Qxua, Qxua, Xv, Xv, Qxua, Qxua, Qxua, Qxua, Ql, Ql, Qxua, Qxua, Ql, Ql, Ql, Qxua, Ql, Ql, Ql, Uzw, Uzw, Ql, Uzw
Uzw, Uzw, Ql, Uzw, Uzw, Ql, Uzw, Ql, Ql, Ql, Ql, Qxua, Qxua, Qxua, Qxua, Qxua, Ql, Qxua, Qxua, Qxua, Ql, Qxua, Qxua, Qxua, Qxua, Xv, Qxua, Xv, Xv, Qxua, Qxua, Xv, Xv, Xv, Qxua, Xv, Qxua, Qxua, Ql, Qxua, Qxua, Qxua, Ql, Ql, Ql, Qxua, Qxua, Uzw, Ql, Ql, Ql, Uzw, Ql, Ql
Uzw, Uzw, Uzw, Uzw, Uzw, Ql, Ql, Uzw, Ql, Ql, Ql, Ql, Qxua, Uzw, Uzw, Qxua, Ql, Ql, Qxua, Qxua, Qxua, Qxua, Qxua, Qxua, Qxua, Xv, Qxua, Qxua, Qxua, Qxua, Qxua, Xv, Qxua, Xv, Qxua, Qxua, Qxua, Qxua, Qxua, Qxua, Ql, Qxua, Qxua, Ql, Qxua, Qxua, Ql, Ql, Uzw, Ql, Ql, Uzw, Ql, Ql
Ql, Uzw, Ql, Uzw, Ql, Ql, Uzw, Ql, Ql, Ql, Ql, Qxua, Ql, Uzw, Ql, Ql, Ql, Ql, Ql, Qxua, Qxua, Ql, Ql, Qxua, Qxua, Qxua, Qxua, Qxua, Qxua, Qxua, Qxua, Xv, Ql, Qxua, Qxua, Qxua, Qxua, Ql, Ql, Ql, Ql, Ql, Qxua, Qxua, Uzw, Ql, Ql, Ql, Ql, Uzw, Ql, Ql, Ql, Ql
Ql, Uzw, Ql, Ql, Ql, Uzw, Uzw, Ql, Ql, Ql, Ql, Ql, Ql, Ql, Ql, Ql, Ql, Ql, Ql, Ql, Qxua, Qxua, Qxua, Qxua, Qxua, Qxua, Qxua, Qxua, Qxua, Qxua, Qxua, Ql, Ql, Qxua, Qxua, Ql, Qxua, Ql, Ql, Qxua, Uzw, Ql, Qxua, Ql, Uzw, Uzw, Ql, Ql, Uzw, Uzw, Uzw, Ql, Uzw, Ql
Ql, Ql, Ql, Ql, Uzw, Uzw, Uzw, Uzw, Ql, Ql, Ql, Ql, Ql, Ql, Ql, Ql, Ql, Ql, Ql, Ql, Qxua, Qxua, Qxua, Qxua, Uzw, Qxua, Qxua, Qxua, Ql, Ql, Qxua, Qxua, Qxua, Qxua, Qxua, Qxua, Ql, Qxua, Ql, Qxua, Qxua, Ql, Qxua, Ql, Ql, Uzw, Uzw, Ql, Ql, Uzw, Ql, Ql, Uzw, Uzw
Uzw, Ql, Ql, Ql, Ql, Ql, Ql, Ql, Ql, Ql, Ql, Ql, Ql, Ql, Uzw, Ql, Ql, Ql, Ql, Ql, Uzw, Ql, Qxua, Qxua, Ql, Ql, Qxua, Qxua, Qxua, Qxua, Qxua, Qxua, Ql, Qxua, Uzw, Qxua, Qxua, Qxua, Ql, Qxua, Qxua, Qxua, Ql, Ql, Ql, Ql, Uzw, Ql, Uzw, Ql, Ql, Ql, Uzw, Ql
Uzw, Uzw, Ql, Ql, Ql, Ql, Ql, Ql, Ql, Ql, Uzw, Ql, Ql, Ql, Uzw, Uzw, Uzw, Uzw, Ql, Ql, Uzw, Ql, Ql, Ql, Ql, Qxua, Uzw, Ql, Qxua, Qxua, Ql, Ql, Ql, Ql, Uzw, Uzw, Qxua, Ql, Ql, Ql, Qxua, Ql, Ql, Uzw, Uzw, Uzw, Ql, Ql, Ql, Ql, Ql, Ql, Ql, Ql
Ql, Ql, Ql, Ql, Ql, Ql, Ql, Ql, Ql, Uzw, Uzw, Uzw, Ql, Ql, Ql, Uzw, Uzw, Uzw, Ql, Ql, Uzw, Uzw, Uzw, Ql, Uzw, Uzw, Uzw, Ql, Ql, Ql, Uzw, Uzw, Ql, Uzw, Ql, Ql, Ql, Ql, Ql, Ql, Uzw, Uzw, Ql, Uzw, Uzw, Uzw, Uzw, Ql, Ql, Ql, Uzw, Ql, Ql, Uzw
Ql, Ql, Ql, Uzw, Ql, Ql, Uzw, Ql, Uzw, Ql, Uzw, Uzw, Ql, Ql, Ql, Ql, Ql, Uzw, Ql, Ql, Ql, Ql, Uzw, Ql, Ql, Uzw, Uzw, Uzw, Ql, Uzw, Uzw, Uzw, Uzw, Uzw, Uzw, Ql, Uzw, Ql, Uzw, Uzw, Ql, Uzw, Uzw, Uzw, Uzw, Uzw, Ql, Ql, Uzw, Ql, Uzw, Uzw, Ql, Uzw
Uzw, Ql, Uzw, Uzw, Uzw, Ql, Uzw, Ql, Uzw, Uzw, Uzw, Uzw, Ql, Uzw, Uzw, Ql, Ql, Ql, Uzw, Uzw, Ql, Ql, Ql, Uzw, Ql, Ql, Uzw, Uzw, Ql, Uzw, Ql, Uzw, Uzw, Uzw, Uzw, Uzw, Uzw, Uzw, Uzw, Ql, Ql, Ql, Uzw, Uzw, Uzw, Uzw, Ql, Ql, Uzw, Ql, Ql, Ql, Ql, Uzw
Uzw, Uzw, Uzw, Uzw, Uzw, Ql, Uzw, Uzw, Uzw, Uzw, Uzw, Uzw, Uzw, Ql, Uzw, Uzw, Uzw, Uzw, Uzw, Uzw, Uzw, Uzw, Uzw, Ql, Uzw, Uzw, Uzw, Uzw, Uzw, Uzw, Uzw, Ql, Ql, Uzw, Uzw, Uzw, Uzw, Uzw, Uzw, Uzw, Uzw, Ql, Uzw, Uzw, Uzw, Uzw, Uzw, Uzw, Uzw, Uzw, Uzw, Ql, Uzw, Uzw
