border_size=1
usage=map

Xv, Xv, Xv, Xv, Xv, Xv, Xv, Xv, Xv, Xv, Xv, Xv, Xv, Xv, Xv, Xv, Xv, Xv, Xv, Xv, Xv, Xv, Xv, Xv, Xv, Xv, Xv^Gov, Xv, Xv, Xv, Xv, Xv, Xv, Xv, Xv, Xv, Xv, Xv, Xv, Xv, Xv, Xv, Xv, Xv, Xv, Xv, Xv, Xv, Xv, Xv, Xv, Xv, Xv, Xv
Xv, Xv, Xv, Xv, Xv, Xv, Xv, Xv, Xv, Xv, Xv, Xv, Xv, Xv, Xv, Xv, Xv, Xv, Xv, Xv, Xv, Xv, Xv, Xv, Xv, Xv, Xv^Gov, Xv, Xv, Xv, Xv, Xv, Xv, Xv, Xv, Xv, Xv, Xv, Xv, Xv, Xv, Xv, Xv, Xv, Xv, Xv, Xv, Xv, Xv, Xv, Xv, Xv, Xv, Xv
Xv, Xv, Xv, Xv, Xv, Xv, Xv, Xv, Xv, Xv, Xv, Xv, Xv, Xv, Xv, Xv, Xv, Xv, Xv, Xv, Xv, Xv, Xv, Xv, Xv, Xv, Xv^Gov, Xv, Xv, Xv, Xv, Xv, Xv, Xv, Xv, Xv, Xv, Xv, Xv, Xv, Xv, Xv, Xv, Xv, Xv, Xv, Xv, Xv, Xv, Xv, Xv, Xv, Xv, Xv
Xv, Xv, Xv, Xv, Xv, Xv, Xv, Xv, Xv, Xv, Xv, Xv, Xv, Xv, Xv, Xv, Xv, Xv, Xv, Xv, Xv, Xv, Xv, Xv, Xv, Xv, Xv^Gov, Xv, Xv, Xv, Xv, Xv, Xv, Xv, Xv, Xv, Xv, Xv, Xv, Xv, Xv, Xv, Xv, Xv, Xv, Xv, Xv, Xv, Xv, Xv, Xv, Xv, Xv, Xv
Xv, Xv, Xv, Xv, Xv, Xv, Xv, Xv, Xv, Xv, Xv, Xv, Xv, Xv, Xv, Xv, Xv, Xv, Xv, Xv, Xv, Xv, Xv, Xv, Xv, Xv, Xv^Gov, Xv, Xv, Xv, Xv, Xv, Xv, Xv, Xv, Xv, Xv, Xv, Xv, Xv, Xv, Xv, Xv, Xv, Xv, Xv, Xv, Xv, Xv, Xv, Xv, Xv, Xv, Xv
Xv, Xv, Xv, Xv, Xv, Xv, Xv, Xv, Xv, Xv, Xv, Xv, Xv, Xv, Xv, Xv, Xv, Xv, Xv, Xv, Xv, Xv, Xv, Xv, Xv, Xv, Xv^Gov, Xv, Xv, Xv, Xv, Xv, Xv, Xv, Xv, Xv, Xv, Xv, Xv, Xv, Xv, Xv, Xv, Xv, Xv, Xv, Xv, Xv, Xv, Xv, Xv, Xv, Xv, Xv
Xv, Xv, Xv, Xv, Xv, Xv, Xv, Xv, Xv, Xv, Xv, Xv, Xv, Xv, Xv, Xv, Xv, Xv, Xv, Xv, Xv, Xv, Xv, Xv, Xv, Xv, Xv^Gov, Xv, Xv, Xv, Xv, Xv, Xv, Xv, Xv, Xv, Xv, Xv, Xv, Xv, Xv, Xv, Xv, Xv, Xv, Xv, Xv, Xv, Xv, Xv, Xv, Xv, Xv, Xv
Xv, Xv, Xv, Xv, Xv, Xv, Xv, Xv, Xv, Xv, Xv, Xv, Xv, Xv, Xv, Xv, Xv, Xv, Xv, Xv, Xv, Xv, Xv, Xv, Xv, Xv, Xv^Gov, Xv, Xv, Xv, Xv, Xv, Xv, Xv, Xv, Xv, Xv, Xv, Xv, Xv, Xv, Xv, Xv, Xv, Xv, Xv, Xv, Xv, Xv, Xv, Xv, Xv, Xv, Xv
Xv, Xv, Xv, Xv, Xv, Xv, Xv, Xv, Xv, Xv, Xv, Xv, Xv, Xv, Xv, Xv, Xv, Xv, Xv, Xv, Xv, Xv, Xv, Xv, Xv, Xv, Xv^Gov, Xv, Xv, Xv, Xv, Xv, Xv, Xv, Xv, Xv, Xv, Xv, Xv, Xv, Xv, Xv, Xv, Xv, Xv, Xv, Xv, Xv, Xv, Xv, Xv, Xv, Xv, Xv
Xv, Xv, Xv, Xv, Xv, Xv, Xv, Xv, Xv, Xv, Xv, Xv, Xv, Xv, Xv, Xv, Xv, Xv, Xv, Xv, Xv, Xv, Xv, Xv, Xv, Xv, Xv^Gov, Xv, Xv, Xv, Xv, Xv, Xv, Xv, Xv, Xv, Xv, Xv, Xv, Xv, Xv, Xv, Xv, Xv, Xv, Xv, Xv, Xv, Xv, Xv, Xv, Xv, Xv, Xv
Xv, Xv, Xv, Xv, Xv, Xv, Xv, Xv, Xv, Xv, Xv, Xv, Xv, Xv, Xv, Xv, Xv, Xv, Xv, Xv, Xv, Xv, Xv, Xv, Xv, Xv, Xv^Gov, Xv, Xv, Xv, Xv, Xv, Xv, Xv, Xv, Xv, Xv, Xv, Xv, Xv, Xv, Xv, Xv, Xv, Xv, Xv, Xv, Xv, Xv, Xv, Xv, Xv, Xv, Xv
Xv, Xv, Xv, Xv, Xv, Xv, Xv, Xv, Xv, Xv, Xv, Xv, Xv, Xv, Xv, Xv, Xv, Xv, Xv, Xv, Xv, Xv, Xv, Xv, Xv, Xv, Xv^Gov, Xv, Xv, Xv, Xv, Xv, Xv, Xv, Xv, Xv, Xv, Xv, Xv, Xv, Xv, Xv, Xv, Xv, Xv, Xv, Xv, Xv, Xv, Xv, Xv, Xv, Xv, Xv
Xv^Xo, Xv^Xo, Xv^Xo, Xv^Xo, Xv^Xo, Xv^Xo, Xv^Xo, Xv^Xo, Xv^Xo, Xv^Xo, Xv^Xo, Xv^Xo, Xv^Xo, Xv^Xo, Xv^Xo, Xv^Xo, Xv^Xo, Xv^Xo, Xv^Xo, Xv^Xo, Xv^Xo, Xv^Xo, Xv^Xo, Xv^Xo, Xv^Xo, Xv^Xo, Xv^Xo, Xv^Xo, Xv^Xo, Xv^Xo, Xv^Xo, Xv^Xo, Xv^Xo, Xv^Xo, Xv^Xo, Xv^Xo, Xv^Xo, Xv^Xo, Xv^Xo, Xv^Xo, Xv^Xo, Xv^Xo, Xv^Xo, Xv^Xo, Xv^Xo, Xv^Xo, Xv^Xo, Xv^Xo, Xv^Xo, Xv^Xo, Xv^Xo, Xv^Xo, Xv^Xo, Xv^Xo
Xv, Xv, Xv, Xv, Xv, Xv, Xv, Xv, Xv, Xv, Xv, Xv, Xv, Xv, Xv, Xv, Xv, Xv, Xv, Xv, Xv, Xv, Xv, Xv, Xv, Xv, Xv^Gov, Xv, Xv, Xv, Xv, Xv, Xv, Xv, Xv, Xv, Xv, Xv, Xv, Xv, Xv, Xv, Xv, Xv, Xv, Xv, Xv, Xv, Xv, Xv, Xv, Xv, Xv, Xv
Xv, Xv, Xv, Xv, Xv, Xv, Xv, Xv, Xv, Xv, Xv, Xv, Xv, Xv, Xv, Xv, Xv, Xv, Xv, Xv, Xv, Xv, Xv, Xv, Xv, Xv, Xv^Gov, Xv, Xv, Xv, Xv, Xv, Xv, Xv, Xv, Xv, Xv, Xv, Xv, Xv, Xv, Xv, Xv, Xv, Xv, Xv, Xv, Xv, Xv, Xv, Xv, Xv, Xv, Xv
Xv, Xv, Xv, Xv, Xv, Xv, Xv, Xv, Xv, Xv, Xv, Xv, Xv, Xv, Xv, Xv, Xv, Xv, Xv, Xv, Xv, Xv, Xv, Xv, Xv, Xv, Xv^Gov, Xv, Xv, Xv, Xv, Xv, Xv, Xv, Xv, Xv, Xv, Xv, Xv, Xv, Xv, Xv, Xv, Xv, Xv, Xv, Xv, Xv, Xv, Xv, Xv, Xv, Xv, Xv
Xv, Xv, Xv, Xv, Xv, Xv, Xv, Xv, Xv, Xv, Xv, Xv, Xv, Xv, Xv, Xv, Xv, Xv, Xv, Xv, Xv, Xv, Xv, Xv, Xv, Xv, Xv^Gov, Xv, Xv, Xv, Xv, Xv, Xv, Xv, Xv, Xv, Xv, Xv, Xv, Xv, Xv, Xv, Xv, Xv, Xv, Xv, Xv, Xv, Xv, Xv, Xv, Xv, Xv, Xv
Xv, Xv, Xv, Xv, Xv, Xv, Xv, Xv, Xv, Xv, Xv, Xv, Xv, Xv, Xv, Xv, Xv, Xv, Xv, Xv, Xv, Xv, Xv, Xv, Xv, Xv, Xv^Gov, Xv, Xv, Xv, Xv, Xv, Xv, Xv, Xv, Xv, Xv, Xv, Xv, Xv, Xv, Xv, Xv, Xv, Xv, Xv, Xv, Xv, Xv, Xv, Xv, Xv, Xv, Xv
Xv, Xv, Xv, Xv, Xv, Xv, Xv, Xv, Xv, Xv, Xv, Xv, Xv, Xv, Xv, Xv, Xv, Xv, Xv, Xv, Xv, Xv, Xv, Xv, Xv, Xv, Xv^Gov, Xv, Xv, Xv, Xv, Xv, Xv, Xv, Xv, Xv, Xv, Xv, Xv, Xv, Xv, Xv, Xv, Xv, Xv, Xv, Xv, Xv, Xv, Xv, Xv, Xv, Xv, Xv
Xv, Xv, Xv, Xv, Xv, Xv, Xv, Xv, Xv, Xv, Xv, Xv, Xv, Xv, Xv, Xv, Xv, Xv, Xv, Xv, Xv, Xv, Xv, Xv, Xv, Xv, Xv^Gov, Xv, Xv, Xv, Xv, Xv, Xv, Xv, Xv, Xv, Xv, Xv, Xv, Xv, Xv, Xv, Xv, Xv, Xv, Xv, Xv, Xv, Xv, Xv, Xv, Xv, Xv, Xv
Xv, Xv, Xv, Xv, Xv, Xv, Xv, Xv, Xv, Xv, Xv, Xv, Xv, Xv, Xv, Xv, Xv, Xv, Xv, Xv, Xv, Xv, Xv, Xv, Xv, Xv, Xv^Gov, Xv, Xv, Xv, Xv, Xv, Xv, Xv, Xv, Xv, Xv, Xv, Xv, Xv, Xv, Xv, Xv, Xv, Xv, Xv, Xv, Xv, Xv, Xv, Xv, Xv, Xv, Xv
Xv, Xv, Xv, Xv, Xv, Xv, Xv, Xv, Xv, Xv, Xv, Xv, Xv, Xv, Xv, Xv, Xv, Xv, Xv, Xv, Xv, Xv, Xv, Xv, Xv, Xv, Xv^Gov, Xv, Xv, Xv, Xv, Xv, Xv, Xv, Xv, Xv, Xv, Xv, Xv, Xv, Xv, Xv, Xv, Xv, Xv, Xv, Xv, Xv, Xv, Xv, Xv, Xv, Xv, Xv
Xv, Xv, Xv, Xv, Xv, Xv, Xv, Xv, Xv, Xv, Xv, Xv, Xv, Xv, Xv, Xv, Xv, Xv, Xv, Xv, Xv, Xv, Xv, Xv, Xv, Xv, Xv^Gov, Xv, Xv, Xv, Xv, Xv, Xv, Xv, Xv, Xv, Xv, Xv, Xv, Xv, Xv, Xv, Xv, Xv, Xv, Xv, Xv, Xv, Xv, Xv, Xv, Xv, Xv, Xv
Xv, Xv, Xv, Xv, Xv, Xv, Xv, Xv, Xv, Xv, Xv, Xv, Xv, Xv, Xv, Xv, Xv, Xv, Xv, Xv, Xv, Xv, Xv, Xv, Xv, Xv, Xv^Gov, Xv, Xv, Xv, Xv, Xv, Xv, Xv, Xv, Xv, Xv, Xv, Xv, Xv, Xv, Xv, Xv, Xv, Xv, Xv, Xv, Xv, Xv, Xv, Xv, Xv, Xv, Xv
Xv, Xv, Xv, Xv, Xv, Xv, Xv, Xv, Xv, Xv, Xv, Xv, Xv, Xv, Xv, Xv, Xv, Xv, Xv, Xv, Xv, Xv, Xv, Xv, Xv, Xv, Xv^Gov, Xv, Xv, Xv, Xv, Xv, Xv, Xv, Xv, Xv, Xv, Xv, Xv, Xv, Xv, Xv, Xv, Xv, Xv, Xv, Xv, Xv, Xv, Xv, Xv, Xv, Xv, Xv
Xv, Xv, Xv, Xv, Xv, Xv, Xv, Xv, Xv, Xv, Xv, Xv, Xv, Xv, Xv, Xv, Xv, Xv, Xv, Xv, Xv, Xv, Xv, Xv, Xv, Xv, Xv^Gov, Xv, Xv, Xv, Xv, Xv, Xv, Xv, Xv, Xv, Xv, Xv, Xv, Xv, Xv, Xv, Xv, Xv, Xv, Xv, Xv, Xv, Xv, Xv, Xv, Xv, Xv, Xv
Xv, Xv, Xv, Xv, Xv, Xv, Xv, Xv, Xv, Xv, Xv, Xv, Xv, Xv, Xv, Xv, Xv, Xv, Xv, Xv, Xv, Xv, Xv, Xv, Xv, Xv, Xv^Gov, Xv, Xv, Xv, Xv, Xv, Xv, Xv, Xv, Xv, Xv, Xv, Xv, Xv, Xv, Xv, Xv, Xv, Xv, Xv, Xv, Xv, Xv, Xv, Xv, Xv, Xv, Xv
Xv, Xv, Xv, Xv, Xv, Xv, Xv, Xv, Xv, Xv, Xv, Xv, Xv, Xv, Xv, Xv, Xv, Xv, Xv, Xv, Xv, Xv, Xv, Xv, Xv, Xv, Xv^Gov, Xv, Xv, Xv, Xv, Xv, Xv, Xv, Xv, Xv, Xv, Xv, Xv, Xv, Xv, Xv, Xv, Xv, Xv, Xv, Xv, Xv, Xv, Xv, Xv, Xv, Xv, Xv
Xv, Xv, Xv, Xv, Xv, Xv, Xv, Xv, Xv, Xv, Xv, Xv, Xv, Xv, Xv, Xv, Xv, Xv, Xv, Xv, Xv, Xv, Xv, Xv, Qxua, Xv, Xv^Gov, Xv, Xv, Xv, Xv, Xv, Xv, Xv, Xv, Xv, Xv, Xv, Xv, Xv, Xv, Xv, Xv, Xv, Xv, Xv, Xv, Xv, Xv, Xv, Xv, Xv, Xv, Xv
Xv, Xv, Xv, Xv, Xv, Xv, Xv, Xv, Xv, Xv, Xv, Xv, Xv, Xv, Xv, Xv, Xv, Xv, Xv, Xv, Xv, Xv, Xv, Qxua, Xv, Xv, Xv^Gov, Xv, Xv, Xv, Xv, Xv, Qxua, Xv, Xv, Xv, Xv, Xv, Xv, Xv, Xv, Xv, Xv, Xv, Xv, Xv, Xv, Xv, Xv, Xv, Xv, Xv, Xv, Xv
Xv, Xv, Xv, Xv, Xv, Xv, Xv, Xv, Xv, Xv, Xv, Xv, Xv, Xv, Xv, Xv, Xv, Xv, Xv, Xv, Xv, Xv, Qxua, Qxua, Qxua, Xv, Xv^Gov, Xv, Xv, Xv, Xv, Qxua, Xv, Xv, Xv, Xv, Xv, Xv, Xv, Xv, Xv, Xv, Xv, Xv, Xv, Xv, Xv, Xv, Xv, Xv, Xv, Xv, Xv, Xv
Xv, Xv, Xv, Xv, Xv, Xv, Xv, Xv, Xv, Xv, Xv, Xv, Xv, Xv, Xv, Xv, Xv, Xv, Xv, Xv, Xv, Xv, Xv, Xv, Xv, Xv, Xv^Gov, Xv, Xv, Xv, Xv, Qxua, Qxua, Xv, Xv, Xv, Xv, Xv, Xv, Xv, Xv, Xv, Xv, Xv, Xv, Xv, Xv, Xv, Xv, Xv, Xv, Xv, Xv, Xv
Xv, Xv, Xv, Xv, Xv, Xv, Xv, Xv, Xv, Xv, Xv, Xv, Xv, Xv, Xv, Xv, Xv, Xv, Xv, Xv, Qxua, Qxua, Xv, Xv, Qxua, Xv, Xv^Gov, Xv, Xv, Xv, Xv, Qxua, Qxua, Qxua, Xv, Xv, Xv, Xv, Xv, Xv, Xv, Xv, Xv, Xv, Xv, Xv, Xv, Xv, Xv, Xv, Xv, Xv, Xv, Xv
Xv, Xv, Xv, Xv, Xv, Xv, Xv, Xv, Xv, Xv, Xv, Xv, Xv, Xv, Xv, Xv, Xv, Xv, Qxua, Xv, Qxua, Xv, Xv, Xv, Xv, Qxua, Qxua^Gov, Qxua, Xv, Xv, Qxua, Qxua, Qxua, Xv, Xv, Xv, Xv, Xv, Xv, Xv, Xv, Xv, Xv, Xv, Xv, Xv, Xv, Xv, Xv, Xv, Xv, Xv, Xv, Xv
Xv, Xv, Xv, Xv, Xv, Xv, Xv, Xv, Xv, Xv, Xv, Xv, Xv, Xv, Xv, Xv, Xv, Xv, Xv, Qxua, Xv, Xv, Xv, Xv, Xv, Xv, Qxua^Gov, Qxua, Xv, Xv, Xv, Xv, Xv, Qxua, Xv, Xv, Xv, Xv, Xv, Xv, Xv, Xv, Xv, Xv, Xv, Xv, Xv, Xv, Xv, Xv, Xv, Xv, Xv, Xv
Xv, Xv, Xv, Xv, Xv, Xv, Xv, Xv, Xv, Xv, Xv, Xv, Xv, Xv, Xv, Xv, Xv, Xv, Xv, Xv, Xv, Xv, Qxua, Xv, Xv, Xv, Xv^Gov, Xv, Xv, Qxua, Xv, Qxua, Xv, Xv, Xv, Qxua, Xv, Xv, Xv, Xv, Xv, Xv, Xv, Xv, Xv, Xv, Xv, Xv, Xv, Xv, Xv, Xv, Xv, Xv
Xv, Xv, Xv, Xv, Xv, Xv, Xv, Xv, Xv, Xv, Xv, Xv, Xv, Xv, Xv, Xv, Xv, Xv, Xv, Xv, Xv, Qxua, Qxua, Xv, Xv, Qxua, Qxua^Gov, Xv, Qxua, Qxua, Xv, Qxua, Xv, Xv, Xv, Xv, Xv, Xv, Xv, Xv, Xv, Xv, Xv, Xv, Xv, Xv, Xv, Xv, Xv, Xv, Xv, Xv, Xv, Xv
Xv, Xv, Xv, Xv, Xv, Xv, Xv, Xv, Xv, Xv, Xv, Xv, Xv, Xv, Xv, Qxua, Qxua, Xv, Xv, Xv, Qxua, Xv, Qxua, Qxua, Qxua, Xv, Qxua^Gov, Qxua, Xv, Qxua, Xv, Xv, Xv, Qxua, Xv, Xv, Qxua, Xv, Qxua, Qxua, Xv, Xv, Xv, Xv, Xv, Xv, Xv, Xv, Xv, Xv, Xv, Xv, Xv, Xv
Xv, Xv, Xv, Xv, Xv, Xv, Xv, Xv, Xv, Xv, Xv, Xv, Xv, Xv, Xv, Xv, Xv, Qxua, Xv, Xv, Xv, Qxua, Qxua, Xv, Qxua, Xv, Qxua^Gov, Xv, Qxua, Qxua, Xv, Xv, Xv, Qxua, Xv, Xv, Xv, Qxua, Xv, Xv, Xv, Xv, Xv, Xv, Xv, Xv, Xv, Xv, Xv, Xv, Xv, Xv, Xv, Xv
Xv, Xv, Xv, Xv, Xv, Xv, Xv, Xv, Xv, Xv, Xv, Xv, Xv, Xv, Xv, Xv, Xv, Xv, Xv, Qxua, Xv, Qxua, Qxua, Xv, Xv, Qxua, Qxua^Gov, Qxua, Xv, Xv, Xv, Qxua, Qxua, Xv, Xv, Xv, Xv, Xv, Xv, Xv, Xv, Xv, Xv, Xv, Xv, Xv, Xv, Xv, Mm, Xv, Mm^Xm, Mm, Mm, Xv
Xv, Xv, Xv, Xv, Xv, Xv, Xv, Xv, Xv, Xv, Xv, Xv, Xv, Xv, Xv, Xv, Xv, Xv, Xv, Xv, Xv, Qxua, Qxua, Qxua, Xv, Xv, Xv^Gov, Qxua, Xv, Qxua, Qxua, Qxua, Xv, Xv, Xv, Xv, Xv, Xv, Mm, Mm^Xm, Mm^Xm, Xv, Xv, Xv, Mm^Xm, Xv, Mm, Mm^Xm, Mm, Mm, Mm, Mm, Mm, Mm
Xv, Xv, Xv, Xv, Mm, Xv, Mm, Xv, Xv, Xv, Mm^Xm, Mm, Mm, Mm, Mm^Xm, Mm, Mm, Xv, Mm, Mm, Mm^Xm, Xv, Xv, Qxua, Xv, Xv, Xv^Gov, Xv, Qxua, Qxua, Xv, Xv, Mm^Xm, Xv, Xv, Xv, Mm, Mm^Xm, Mm, Mm, Mm, Mm^Xm, Mm, Mm, Mm, Mm^Xm, Mm, Mm, Mm, Mm, Mm, Mm, Mm^Xm, Mm
Xv, Xv, Mm, Mm, Mm, Mm, Mm, Mm, Mm, Mm, Mm, Mm, Mm, Mm, Mm, Mm, Mm, Mm, Mm, Mm, Mm^Xm, Mm^Xm, Mm, Xv, Qxua, Xv, 1 Xv^Gov, Xv, Qxua, Mm, Mm, Mm, Mm, Mm^Xm, Mm, Mm, Mm, Mm, Mm^Xm, Mm, Mm, Mm, Mm, Mm, Mm, Mm, Mm, Mm, Mm, Mm, Mm, Mm^Xm, Mm, Mm
Mm, Mm, Mm^Xm, Mm, Mm, Mm, Mm^Xm, Mm, Mm, Mm, Mm, Mm, Ql, Mm, Mm, Mm, Mm, Mm, Mm, Mm, Mm, Mm, Mm, Mm, Qxua, Xv, Xv, Xv, Qxua, Mm, Mm, Mm, Mm, Mm, Mm, Mm, Mm, Mm, Mm, Mm, Mm, Mm, Mm, Mm, Mm, Mm, Mm, Mm, Mm, Mm, Mm, Mm, Mm^Xm, Mm
Mm, Mm, Mm, Mm, Mm, Mm, Mm, Mm, Zw, Mm, Mm, Mm, Ql, Zw, Ql, Mm, Mm, Zw, Mm, Mm, Mm, Mm, Ql, Ql, Qxua, Xv, Xv, Qxua, Qxua, Mm, Mm, Mm, Zw, Mm, Zw, Mm, Mm, Mm, Mm, Mm, Mm, Mm, Zw, Zw, Zw, Mm, Zw, Mm, Mm, Mm, Mm, Mm, Mm, Mm
Mm, Mm, Mm, Mm, Mm, Mm, Mm, Mm, Ql, Zw, Mm, Mm, Ql, Zw, Ql, Mm, Mm, Zw, Zw, Mm, Zw, Zw, Ql, Ql, Qxua, Qxua, Xv, Qxua, Qxua, Qxua, Ql, Zw, Zw, Zw, Zw, Mm, Zw, Zw, Zw, Mm, Zw, Zw, Zw, Zw, Zw, Mm, Zw, Zw, Zw, Zw, Mm, Mm, Mm, Mm
Zw, Mm, Mm, Zw, Zw, Mm, Zw, Zw, Ql, Zw, Zw, Zw, Zw, Ql, Ql, Zw, Mm, Zw, Zw, Zw, Zw, Ql, Ql, Qxua, Qxua, Qxua, Xv, Xv, Qxua, Qxua, Ql, Ql, Ql, Ql, Zw, Zw, Ql, Ql, Zw, Zw, Zw, Zw, Zw, Zw, Zw, Zw, Zw, Zw, Zw, Mm, Zw, Zw, Zw, Mm
Zw, Zw, Zw, Zw, Ql, Ql, Ql, Zw, Ql, Ql, Zw, Zw, Ql, Ql, Ql, Ql, Ql, Zw, Ql, Ql, Ql, Ql, Qxua, Qxua, Qxua, Qxua, Xv, Qxua, Qxua, Qxua, Qxua, Ql, Ql, Ql, Zw, Zw, Ql, Ql, Ql, Zw, Zw, Zw, Zw, Zw, Zw, Ql, Ql, Zw, Ql, Zw, Zw, Zw, Zw, Zw
Zw, Zw, Zw, Zw, Ql, Ql, Ql, Zw, Ql, Ql, Zw, Ql, Ql, Zw, Ql, Ql, Ql, Zw, Ql, Ql, Ql, Qxua, Qxua, Qxua, Qxua, Xv, Xv, Xv, Xv, Qxua, Qxua, Ql, Ql, Ql, Ql, Ql, Zw, Zw, Ql, Zw, Zw, Zw, Ql, Zw, Zw, Ql, Ql, Zw, Ql, Ql, Zw, Zw, Zw, Zw
Zw, Zw, Ql, Ql, Ql, Ql, Ql, Ql, Ql, Zw, Zw, Ql, Ql, Ql, Ql, Ql, Ql, Ql, Ql, Ql, Ql, Qxua, Qxua, Qxua, Qxua, Qxua, Xv, Qxua, Xv, Qxua, Qxua, Qxua, Ql, Ql, Ql, Ql, Zw, Zw, Zw, Ql, Ql, Zw, Ql, Zw, Ql, Ql, Zw, Zw, Zw, Ql, Ql, Zw, Zw, Zw
Zw, Zw, Zw, Ql, Zw, Zw, Zw, Ql, Ql, Ql, Ql, Ql, Ql, Ql, Ql, Ql, Ql, Qxua, Qxua, Qxua, Qxua, Qxua, Qxua, Qxua, Qxua, Xv, Qxua, Qxua, Qxua, Xv, Qxua, Qxua, Ql, Ql, Qxua, Ql, Zw, Zw, Zw, Zw, Ql, Ql, Ql, Ql, Zw, Zw, Zw, Zw, Zw, Zw, Zw, Ql, Ql, Zw
Ql, Zw, Zw, Ql, Ql, Ql, Ql, Ql, Ql, Ql, Ql, Ql, Ql, Ql, Ql, Ql, Qxua, Qxua, Qxua, Qxua, Qxua, Qxua, Qxua, Qxua, Xv, Xv, Xv, Qxua, Qxua, Qxua, Qxua, Qxua, Ql, Qxua, Qxua, Qxua, Ql, Zw, Ql, Zw, Ql, Ql, Ql, Ql, Ql, Zw, Zw, Zw, Zw, Ql, Zw, Ql, Ql, Ql
Ql, Ql, Ql, Zw, Ql, Ql, Ql, Ql, Ql, Ql, Ql, Ql, Ql, Qxua, Qxua, Ql, Qxua, Ql, Ql, Qxua, Qxua, Qxua, Qxua, Qxua, Qxua, Qxua, Xv, Xv, Xv, Qxua, Qxua, Qxua, Qxua, Qxua, Qxua, Qxua, Ql, Ql, Ql, Ql, Zw, Zw, Ql, Ql, Ql, Zw, Zw, Ql, Ql, Ql, Ql, Ql, Zw, Ql
Zw, Ql, Ql, Ql, Zw, Ql, Ql, Ql, Ql, Ql, Ql, Ql, Qxua, Ql, Ql, Qxua, Qxua, Qxua, Qxua, Qxua, Qxua, Qxua, Qxua, Xv, Xv, Qxua, Qxua, Qxua, Xv, Qxua, Xv, Qxua, Qxua, Ql, Ql, Qxua, Qxua, Ql, Ql, Ql, Zw, Ql, Ql, Ql, Ql, Ql, Ql, Ql, Ql, Ql, Zw, Ql, Zw, Zw
Zw, Zw, Ql, Zw, Zw, Zw, Ql, Ql, Zw, Zw, Ql, Ql, Qxua, Ql, Zw, Qxua, Qxua, Qxua, Qxua, Qxua, Qxua, Qxua, Xv, Xv, Qxua, Qxua, Qxua, Qxua, Xv, Xv, Qxua, Qxua, Qxua, Qxua, Qxua, Qxua, Qxua, Ql, Ql, Zw, Zw, Ql, Ql, Qxua, Zw, Zw, Ql, Zw, Ql, Ql, Ql, Ql, Zw, Zw
Ql, Ql, Zw, Zw, Zw, Zw, Ql, Zw, Zw, Zw, Ql, Ql, Qxua, Qxua, Qxua, Qxua, Qxua, Qxua, Qxua, Qxua, Qxua, Qxua, Xv, Qxua, Xv, Qxua, Xv, Xv, Qxua, Qxua, Qxua, Qxua, Ql, Qxua, Qxua, Ql, Ql, Qxua, Zw, Ql, Qxua, Ql, Qxua, Qxua, Qxua, Ql, Ql, Ql, Ql, Ql, Ql, Zw, Ql, Zw
Ql, Ql, Zw, Ql, Ql, Ql, Ql, Zw, Ql, Ql, Ql, Qxua, Qxua, Qxua, Qxua, Qxua, Ql, Ql, Qxua, Qxua, Xv, Xv, Xv, Xv, Xv, Qxua, Xv, Xv, Xv, Qxua, Qxua, Qxua, Qxua, Qxua, Qxua, Qxua, Qxua, Qxua, Qxua, Qxua, Qxua, Qxua, Qxua, Qxua, Ql, Ql, Ql, Zw, Ql, Ql, Ql, Ql, Ql, Zw
Zw, Ql, Ql, Ql, Ql, Ql, Zw, Ql, Ql, Ql, Ql, Ql, Qxua, Qxua, Ql, Qxua, Qxua, Qxua, Qxua, Qxua, Xv, Qxua, Qxua, Qxua, Xv, Xv, Xv, Xv, Xv, Qxua, Xv, Qxua, Qxua, Qxua, Ql, Qxua, Qxua, Qxua, Qxua, Qxua, Ql, Qxua, Zw, Zw, Ql, Ql, Ql, Zw, Ql, Zw, Ql, Ql, Ql, Ql
Zw, Ql, Zw, Ql, Zw, Zw, Ql, Ql, Ql, Ql, Qxua, Qxua, Ql, Qxua, Qxua, Qxua, Qxua, Qxua, Ql, Qxua, Qxua, Qxua, Xv, Qxua, Xv, Xv, 2 Xv, Xv, Xv, Xv, Qxua, Qxua, Qxua, Qxua, Qxua, Qxua, Qxua, Qxua, Qxua, Ql, Qxua, Ql, Ql, Ql, Ql, Zw, Ql, Ql, Ql, Zw, Zw, Ql, Ql, Ql
Ql, Ql, Zw, Ql, Zw, Zw, Ql, Ql, Ql, Ql, Ql, Qxua, Ql, Qxua, Qxua, Ql, Qxua, Qxua, Qxua, Qxua, Qxua, Xv, Qxua, Xv, Xv, Xv, Xv, Xv, Xv, Xv, Xv, Xv, Xv, Qxua, Qxua, Qxua, Qxua, Qxua, Qxua, Qxua, Ql, Qxua, Ql, Ql, Ql, Ql, Ql, Ql, Ql, Ql, Ql, Ql, Ql, Ql
Zw, Zw, Ql, Ql, Zw, Ql, Ql, Qxua, Qxua, Ql, Qxua, Qxua, Ql, Ql, Qxua, Qxua, Ql, Qxua, Qxua, Qxua, Qxua, Qxua, Xv, Xv, Xv, Xv, Xv, Xv, Xv, Xv, Xv, Xv, Xv, Qxua, Qxua, Qxua, Qxua, Qxua, Qxua, Ql, Ql, Ql, Ql, Zw, Ql, Ql, Ql, Zw, Zw, Ql, Ql, Zw, Ql, Ql
Zw, Zw, Ql, Ql, Ql, Ql, Ql, Ql, Zw, Qxua, Qxua, Ql, Qxua, Qxua, Qxua, Qxua, Ql, Qxua, Qxua, Qxua, Qxua, Qxua, Xv, Xv, Qxua, Xv, Xv, Xv, Xv, Xv, Qxua, Xv, Qxua, Xv, Qxua, Qxua, Qxua, Qxua, Qxua, Qxua, Qxua, Qxua, Ql, Ql, Ql, Ql, Zw, Ql, Zw, Ql, Ql, Ql, Zw, Zw
Zw, Ql, Ql, Ql, Zw, Zw, Ql, Zw, Zw, Qxua, Qxua, Qxua, Qxua, Ql, Qxua, Qxua, Ql, Qxua, Qxua, Qxua, Qxua, Xv, Qxua, Qxua, Qxua, Xv, Xv, Xv, Xv, Xv, Xv, Qxua, Xv, Qxua, Qxua, Qxua, Ql, Qxua, Ql, Qxua, Qxua, Ql, Ql, Ql, Ql, Ql, Zw, Ql, Ql, Ql, Ql, Ql, Zw, Zw
Zw, Zw, Ql, Zw, Zw, Zw, Zw, Ql, Qxua, Qxua, Ql, Qxua, Qxua, Ql, Qxua, Qxua, Qxua, Qxua, Qxua, Qxua, Qxua, Qxua, Qxua, Qxua, Qxua, Xv, Xv, Qxua, Xv, Xv, Qxua, Qxua, Qxua, Xv, Xv, Ql, Qxua, Qxua, Qxua, Qxua, Ql, Ql, Ql, Ql, Ql, Zw, Qxua, Qxua, Ql, Ql, Ql, Ql, Ql, Zw
Ql, Ql, Ql, Ql, Zw, Zw, Zw, Ql, Ql, Ql, Ql, Ql, Qxua, Qxua, Qxua, Qxua, Qxua, Qxua, Qxua, Ql, Qxua, Qxua, Xv, Xv, Xv, Xv, Qxua, Qxua, Xv, Xv, Xv, Qxua, Qxua, Xv, Xv, Qxua, Qxua, Qxua, Qxua, Ql, Ql, Qxua, Qxua, Ql, Ql, Ql, Qxua, Ql, Ql, Ql, Zw, Zw, Ql, Zw
Zw, Zw, Ql, Zw, Zw, Ql, Zw, Ql, Ql, Ql, Ql, Qxua, Qxua, Qxua, Qxua, Qxua, Ql, Qxua, Qxua, Qxua, Ql, Qxua, Qxua, Qxua, Qxua, Xv, Qxua, Xv, Xv, Qxua, Qxua, Xv, Xv, Xv, Qxua, Xv, Qxua, Qxua, Ql, Qxua, Qxua, Qxua, Ql, Ql, Ql, Qxua, Qxua, Zw, Ql, Ql, Ql, Zw, Ql, Ql
Zw, Zw, Zw, Zw, Zw, Ql, Ql, Zw, Ql, Ql, Ql, Ql, Qxua, Zw, Zw, Qxua, Ql, Ql, Qxua, Qxua, Qxua, Qxua, Qxua, Qxua, Qxua, Xv, Qxua, Qxua, Qxua, Qxua, Qxua, Xv, Qxua, Xv, Qxua, Qxua, Qxua, Qxua, Qxua, Qxua, Ql, Qxua, Qxua, Ql, Qxua, Qxua, Ql, Ql, Zw, Ql, Ql, Zw, Ql, Ql
Ql, Zw, Ql, Zw, Ql, Ql, Zw, Ql, Ql, Ql, Ql, Qxua, Ql, Zw, Ql, Ql, Ql, Ql, Ql, Qxua, Qxua, Ql, Ql, Qxua, Qxua, Qxua, Qxua, Qxua, Qxua, Qxua, Qxua, Xv, Ql, Qxua, Qxua, Qxua, Qxua, Ql, Ql, Ql, Ql, Ql, Qxua, Qxua, Zw, Ql, Ql, Ql, Ql, Zw, Ql, Ql, Ql, Ql
Ql, Zw, Ql, Ql, Ql, Zw, Zw, Ql, Ql, Ql, Ql, Ql, Ql, Ql, Ql, Ql, Ql, Ql, Ql, Ql, Qxua, Qxua, Qxua, Qxua, Qxua, Qxua, Qxua, Qxua, Qxua, Qxua, Qxua, Ql, Ql, Qxua, Qxua, Ql, Qxua, Ql, Ql, Qxua, Zw, Ql, Qxua, Ql, Zw, Zw, Ql, Ql, Zw, Zw, Zw, Ql, Zw, Ql
Ql, Ql, Ql, Ql, Zw, Zw, Zw, Zw, Ql, Ql, Ql, Ql, Ql, Ql, Ql, Ql, Ql, Ql, Ql, Ql, Qxua, Qxua, Qxua, Qxua, Zw, Qxua, Qxua, Qxua, Ql, Ql, Qxua, Qxua, Qxua, Qxua, Qxua, Qxua, Ql, Qxua, Ql, Qxua, Qxua, Ql, Qxua, Ql, Ql, Zw, Zw, Ql, Ql, Zw, Ql, Ql, Zw, Zw
Zw, Ql, Ql, Ql, Ql, Ql, Ql, Ql, Ql, Ql, Ql, Ql, Ql, Ql, Zw, Ql, Ql, Ql, Ql, Ql, Zw, Ql, Qxua, Qxua, Ql, Ql, Qxua, Qxua, Qxua, Qxua, Qxua, Qxua, Ql, Qxua, Zw, Qxua, Qxua, Qxua, Ql, Qxua, Qxua, Qxua, Ql, Ql, Ql, Ql, Zw, Ql, Zw, Ql, Ql, Ql, Zw, Ql
Zw, Zw, Ql, Ql, Ql, Ql, Ql, Ql, Ql, Ql, Zw, Ql, Ql, Ql, Zw, Zw, Zw, Zw, Ql, Ql, Zw, Ql, Ql, Ql, Ql, Qxua, Zw, Ql, Qxua, Qxua, Ql, Ql, Ql, Ql, Zw, Zw, Qxua, Ql, Ql, Ql, Qxua, Ql, Ql, Zw, Zw, Zw, Ql, Ql, Ql, Ql, Ql, Ql, Ql, Ql
Ql, Ql, Ql, Ql, Ql, Ql, Ql, Ql, Ql, Zw, Zw, Zw, Ql, Ql, Ql, Zw, Zw, Zw, Ql, Ql, Zw, Zw, Zw, Ql, Zw, Zw, Zw, Ql, Ql, Ql, Zw, Zw, Ql, Zw, Ql, Ql, Ql, Ql, Ql, Ql, Zw, Zw, Ql, Zw, Zw, Zw, Zw, Ql, Ql, Ql, Zw, Ql, Ql, Zw
Ql, Ql, Ql, Zw, Ql, Ql, Zw, Ql, Zw, Ql, Zw, Zw, Ql, Ql, Ql, Ql, Ql, Zw, Ql, Ql, Ql, Ql, Zw, Ql, Ql, Zw, Zw, Zw, Ql, Zw, Zw, Zw, Zw, Zw, Zw, Ql, Zw, Ql, Zw, Zw, Ql, Zw, Zw, Zw, Zw, Zw, Ql, Ql, Zw, Ql, Zw, Zw, Ql, Zw
Zw, Ql, Zw, Zw, Zw, Ql, Zw, Ql, Zw, Zw, Zw, Zw, Ql, Zw, Zw, Ql, Ql, Ql, Zw, Zw, Ql, Ql, Ql, Zw, Ql, Ql, Zw, Zw, Ql, Zw, Ql, Zw, Zw, Zw, Zw, Zw, Zw, Zw, Zw, Ql, Ql, Ql, Zw, Zw, Zw, Zw, Ql, Ql, Zw, Ql, Ql, Ql, Ql, Zw
Zw, Zw, Zw, Zw, Zw, Ql, Zw, Zw, Zw, Zw, Zw, Zw, Zw, Ql, Zw, Zw, Zw, Zw, Zw, Zw, Zw, Zw, Zw, Ql, Zw, Zw, Zw, Zw, Zw, Zw, Zw, Ql, Ql, Zw, Zw, Zw, Zw, Zw, Zw, Zw, Zw, Ql, Zw, Zw, Zw, Zw, Zw, Zw, Zw, Zw, Zw, Ql, Zw, Zw
