border_size=1
usage=map

Xv, Xv, Xv, Xv, Xv, Xv, Xv, Xv, Xv, Xv, Xv, Xv, Xv, Xv, Xv, Xv, Xv, Xv, Xv, Xv, Xv, Xv, Xv, Xv, Xv, Xv, Xv^Gov, Xv, Xv, Xv, Xv, Xv, Xv, Xv, Xv, Xv, Xv, Xv, Xv, Xv, Xv, Xv, Xv, Xv, Xv, Xv, Xv, Xv, Xv, Xv, Xv, Xv, Xv, Xv
Xv, Xv, Xv, Xv, Xv, Xv, Xv, Xv, Xv, Xv, Xv, Xv, Xv, Xv, Xv, Xv, Xv, Xv, Xv, Xv, Xv, Xv, Xv, Xv, Xv, Xv, 1 Xv^Gov, Xv, Xv, Xv, Xv, Xv, Xv, Xv, Xv, Xv, Xv, Xv, Xv, Xv, Xv, Xv, Xv, Xv, Xv, Xv, Xv, Xv, Xv, Xv, Xv, Xv, Xv, Xv
Xv, Xv, Xv, Xv, Xv, Xv, Xv, Xv, Xv, Xv, Xv, Xv, Xv, Xv, Xv, Xv, Xv, Xv, Xv, Xv, Xv, Xv, Xv, Xv, Xv, Xv, Xv^Gov, Xv, Xv, Xv, Xv, Xv, Xv, Xv, Xv, Xv, Xv, Xv, Xv, Xv, Xv, Xv, Xv, Xv, Xv, Xv, Xv, Xv, Xv, Xv, Xv, Xv, Xv, Xv
Xv, Xv, Xv, Xv, Xv, Xv, Xv, Xv, Xv, Xv, Xv, Xv, Xv, Xv, Xv, Xv, Xv, Xv, Xv, Xv, Xv, Xv, Xv, Xv, Xv, Xv, Xv^Gov, Xv, Xv, Xv, Xv, Xv, Xv, Xv, Xv, Xv, Xv, Xv, Xv, Xv, Xv, Xv, Xv, Xv, Xv, Xv, Xv, Xv, Xv, Xv, Xv, Xv, Xv, Xv
Xv, Xv, Xv, Xv, Xv, Xv, Xv, Xv, Xv, Xv, Xv, Xv, Xv, Xv, Xv, Xv, Xv, Xv, Xv, Xv, Xv, Xv, Xv, Xv, Xv, Xv, Xv^Gov, Xv, Xv, Xv, Xv, Xv, Xv, Xv, Xv, Xv, Xv, Xv, Xv, Xv, Xv, Xv, Xv, Xv, Xv, Xv, Xv, Xv, Xv, Xv, Xv, Xv, Xv, Xv
Xv, Xv, Xv, Xv, Xv, Xv, Xv, Xv, Xv, Xv, Xv, Xv, Xv, Xv, Xv, Xv, Xv, Xv, Xv, Xv, Xv, Xv, Xv, Xv, Xv, Xv, Xv^Gov, Xv, Xv, Xv, Xv, Xv, Xv, Xv, Xv, Xv, Xv, Xv, Xv, Xv, Xv, Xv, Xv, Xv, Xv, Xv, Xv, Xv, Xv, Xv, Xv, Xv, Xv, Xv
Xv, Xv, Xv, Xv, Xv, Xv, Xv, Xv, Xv, Xv, Xv, Xv, Xv, Xv, Xv, Xv, Xv, Xv, Xv, Xv, Xv, Xv, Xv, Xv, Xv, Xv, Xv^Gov, Xv, Xv, Xv, Xv, Xv, Xv, Xv, Xv, Xv, Xv, Xv, Xv, Xv, Xv, Xv, Xv, Xv, Xv, Xv, Xv, Xv, Xv, Xv, Xv, Xv, Xv, Xv
Xv, Xv, Xv, Xv, Xv, Xv, Xv, Xv, Xv, Xv, Xv, Xv, Xv, Xv, Xv, Xv, Xv, Xv, Xv, Xv, Xv, Xv, Xv, Xv, Xv, Xv, Xv^Gov, Xv, Xv, Xv, Xv, Xv, Xv, Xv, Xv, Xv, Xv, Xv, Xv, Xv, Xv, Xv, Xv, Xv, Xv, Xv, Xv, Xv, Xv, Xv, Xv, Xv, Xv, Xv
Xv, Xv, Xv, Xv, Xv, Xv, Xv, Xv, Xv, Xv, Xv, Xv, Xv, Xv, Xv, Xv, Xv, Xv, Xv, Xv, Xv, Xv, Xv, Xv, Xv, Xv, Xv^Gov, Xv, Xv, Xv, Xv, Xv, Xv, Xv, Xv, Xv, Xv, Xv, Xv, Xv, Xv, Xv, Xv, Xv, Xv, Xv, Xv, Xv, Xv, Xv, Xv, Xv, Xv, Xv
Xv, Xv, Xv, Xv, Xv, Xv, Xv, Xv, Xv, Xv, Xv, Xv, Xv, Xv, Xv, Xv, Xv, Xv, Xv, Xv, Xv, Xv, Xv, Xv, Xv, Xv, Xv^Gov, Xv, Xv, Xv, Xv, Xv, Xv, Xv, Xv, Xv, Xv, Xv, Xv, Xv, Xv, Xv, Xv, Xv, Xv, Xv, Xv, Xv, Xv, Xv, Xv, Xv, Xv, Xv
Xv, Xv, Xv, Xv, Xv, Xv, Xv, Xv, Xv, Xv, Xv, Xv, Xv, Xv, Xv, Xv, Xv, Xv, Xv, Xv, Xv, Xv, Xv, Xv, Xv, Xv, Xv^Gov, Xv, Xv, Xv, Xv, Xv, Xv, Xv, Xv, Xv, Xv, Xv, Xv, Xv, Xv, Xv, Xv, Xv, Xv, Xv, Xv, Xv, Xv, Xv, Xv, Xv, Xv, Xv
Xv, Xv, Xv, Xv, Xv, Xv, Xv, Xv, Xv, Xv, Xv, Xv, Xv, Xv, Xv, Xv, Xv, Xv, Xv, Xv, Xv, Xv, Xv, Xv, Xv, Xv, Xv^Gov, Xv, Xv, Xv, Xv, Xv, Xv, Xv, Xv, Xv, Xv, Xv, Xv, Xv, Xv, Xv, Xv, Xv, Xv, Xv, Xv, Xv, Xv, Xv, Xv, Xv, Xv, Xv
Xv^Xo, Xv^Xo, Xv^Xo, Xv^Xo, Xv^Xo, Xv^Xo, Xv^Xo, Xv^Xo, Xv^Xo, Xv^Xo, Xv^Xo, Xv^Xo, Xv^Xo, Xv^Xo, Xv^Xo, Xv^Xo, Xv^Xo, Xv^Xo, Xv^Xo, Xv^Xo, Xv^Xo, Xv^Xo, Xv^Xo, Xv^Xo, Xv^Xo, Xv^Xo, Xv^Xo, Xv^Xo, Xv^Xo, Xv^Xo, Xv^Xo, Xv^Xo, Xv^Xo, Xv^Xo, Xv^Xo, Xv^Xo, Xv^Xo, Xv^Xo, Xv^Xo, Xv^Xo, Xv^Xo, Xv^Xo, Xv^Xo, Xv^Xo, Xv^Xo, Xv^Xo, Xv^Xo, Xv^Xo, Xv^Xo, Xv^Xo, Xv^Xo, Xv^Xo, Xv^Xo, Xv^Xo
Xv, Xv, Xv, Xv, Xv, Xv, Xv, Xv, Xv, Xv, Xv, Xv, Xv, Xv, Xv, Xv, Xv, Xv, Xv, Xv, Xv, Xv, Xv, Xv, Xv, Xv, Xv^Gov, Xv, Xv, Xv, Xv, Xv, Xv, Xv, Xv, Xv, Xv, Xv, Xv, Xv, Xv, Xv, Xv, Xv, Xv, Xv, Xv, Xv, Xv, Xv, Xv, Xv, Xv, Xv
Xv, Xv, Xv, Xv, Xv, Xv, Xv, Xv, Xv, Xv, Xv, Xv, Xv, Xv, Xv, Xv, Xv, Xv, Xv, Xv, Xv, Xv, Xv, Xv, Xv, Xv, Xv^Gov, Xv, Xv, Xv, Xv, Xv, Xv, Xv, Xv, Xv, Xv, Xv, Xv, Xv, Xv, Xv, Xv, Xv, Xv, Xv, Xv, Xv, Xv, Xv, Xv, Xv, Xv, Xv
Xv, Xv, Xv, Xv, Xv, Xv, Xv, Xv, Xv, Xv, Xv, Xv, Xv, Xv, Xv, Xv, Xv, Xv, Xv, Xv, Xv, Xv, Xv, Xv, Xv, Xv, Xv^Gov, Xv, Xv, Xv, Xv, Xv, Xv, Xv, Xv, Xv, Xv, Xv, Xv, Xv, Xv, Xv, Xv, Xv, Xv, Xv, Xv, Xv, Xv, Xv, Xv, Xv, Xv, Xv
Xv, Xv, Xv, Xv, Xv, Xv, Xv, Xv, Xv, Xv, Xv, Xv, Xv, Xv, Xv, Xv, Xv, Xv, Xv, Xv, Xv, Xv, Xv, Xv, Xv, Xv, Xv^Gov, Xv, Xv, Xv, Xv, Xv, Xv, Xv, Xv, Xv, Xv, Xv, Xv, Xv, Xv, Xv, Xv, Xv, Xv, Xv, Xv, Xv, Xv, Xv, Xv, Xv, Xv, Xv
Xv, Xv, Xv, Xv, Xv, Xv, Xv, Xv, Xv, Xv, Xv, Xv, Xv, Xv, Xv, Xv, Xv, Xv, Xv, Xv, Xv, Xv, Xv, Xv, Xv, Xv, Xv^Gov, Xv, Xv, Xv, Xv, Xv, Xv, Xv, Xv, Xv, Xv, Xv, Xv, Xv, Xv, Xv, Xv, Xv, Xv, Xv, Xv, Xv, Xv, Xv, Xv, Xv, Xv, Xv
Xv, Xv, Xv, Xv, Xv, Xv, Xv, Xv, Xv, Xv, Xv, Xv, Xv, Xv, Xv, Xv, Xv, Xv, Xv, Xv, Xv, Xv, Xv, Xv, Xv, Xv, Xv^Gov, Xv, Xv, Xv, Xv, Xv, Xv, Xv, Xv, Xv, Xv, Xv, Xv, Xv, Xv, Xv, Xv, Xv, Xv, Xv, Xv, Xv, Xv, Xv, Xv, Xv, Xv, Xv
Xv, Xv, Xv, Xv, Xv, Xv, Xv, Xv, Xv, Xv, Xv, Xv, Xv, Xv, Xv, Xv, Xv, Xv, Xv, Xv, Xv, Xv, Xv, Xv, Xv, Xv, Xv^Gov, Xv, Xv, Xv, Xv, Xv, Xv, Xv, Xv, Xv, Xv, Xv, Xv, Xv, Xv, Xv, Xv, Xv, Xv, Xv, Xv, Xv, Xv, Xv, Xv, Xv, Xv, Xv
Xv, Xv, Xv, Xv, Xv, Xv, Xv, Xv, Xv, Xv, Xv, Xv, Xv, Xv, Xv, Xv, Xv, Xv, Xv, Xv, Xv, Xv, Xv, Xv, Xv, Xv, Xv^Gov, Xv, Xv, Xv, Xv, Xv, Xv, Xv, Xv, Xv, Xv, Xv, Xv, Xv, Xv, Xv, Xv, Xv, Xv, Xv, Xv, Xv, Xv, Xv, Xv, Xv, Xv, Xv
Xv, Xv, Xv, Xv, Xv, Xv, Xv, Xv, Xv, Xv, Xv, Xv, Xv, Xv, Xv, Xv, Xv, Xv, Xv, Xv, Xv, Xv, Xv, Xv, Xv, Xv, Xv^Gov, Xv, Xv, Xv, Xv, Xv, Xv, Xv, Xv, Xv, Xv, Xv, Xv, Xv, Xv, Xv, Xv, Xv, Xv, Xv, Xv, Xv, Xv, Xv, Xv, Xv, Xv, Xv
Xv, Xv, Xv, Xv, Xv, Xv, Xv, Xv, Xv, Xv, Xv, Xv, Xv, Xv, Xv, Xv, Xv, Xv, Xv, Xv, Xv, Xv, Xv, Xv, Xv, Xv, Xv^Gov, Xv, Xv, Xv, Xv, Xv, Xv, Xv, Xv, Xv, Xv, Xv, Xv, Xv, Xv, Xv, Xv, Xv, Xv, Xv, Xv, Xv, Xv, Xv, Xv, Xv, Xv, Xv
Xv, Xv, Xv, Xv, Xv, Xv, Xv, Xv, Xv, Xv, Xv, Xv, Xv, Xv, Xv, Xv, Xv, Xv, Xv, Xv, Xv, Xv, Xv, Xv, Xv, Xv, Xv^Gov, Xv, Xv, Xv, Xv, Xv, Xv, Xv, Xv, Xv, Xv, Xv, Xv, Xv, Xv, Xv, Xv, Xv, Xv, Xv, Xv, Xv, Xv, Xv, Xv, Xv, Xv, Xv
Xv, Xv, Xv, Xv, Xv, Xv, Xv, Xv, Xv, Xv, Xv, Xv, Xv, Xv, Xv, Xv, Xv, Xv, Xv, Xv, Xv, Xv, Xv, Xv, Xv, Xv, Xv^Gov, Xv, Xv, Xv, Xv, Xv, Xv, Xv, Xv, Xv, Xv, Xv, Xv, Xv, Xv, Xv, Xv, Xv, Xv, Xv, Xv, Xv, Xv, Xv, Xv, Xv, Xv, Xv
Xv, Xv, Xv, Xv, Xv, Xv, Xv, Xv, Xv, Xv, Xv, Xv, Xv, Xv, Xv, Xv, Xv, Xv, Xv, Xv, Xv, Xv, Xv, Xv, Xv, Xv, Xv^Gov, Xv, Xv, Xv, Xv, Xv, Xv, Xv, Xv, Xv, Xv, Xv, Xv, Xv, Xv, Xv, Xv, Xv, Xv, Xv, Xv, Xv, Xv, Xv, Xv, Xv, Xv, Xv
Xv, Xv, Xv, Xv, Xv, Xv, Xv, Xv, Xv, Xv, Xv, Xv, Xv, Xv, Xv, Xv, Xv, Xv, Xv, Xv, Xv, Xv, Xv, Xv, Xv, Xv, Xv^Gov, Xv, Xv, Xv, Xv, Xv, Xv, Xv, Xv, Xv, Xv, Xv, Xv, Xv, Xv, Xv, Xv, Xv, Xv, Xv, Xv, Xv, Xv, Xv, Xv, Xv, Xv, Xv
Xv, Xv, Xv, Xv, Xv, Xv, Xv, Xv, Xv, Xv, Xv, Xv, Xv, Xv, Xv, Xv, Xv, Xv, Xv, Xv, Xv, Xv, Xv, Xv, Xv, Xv, Xv^Gov, Xv, Xv, Xv, Xv, Xv, Xv, Xv, Xv, Xv, Xv, Xv, Xv, Xv, Xv, Xv, Xv, Xv, Xv, Xv, Xv, Xv, Xv, Xv, Xv, Xv, Xv, Xv
Xv, Xv, Xv, Xv, Xv, Xv, Xv, Xv, Xv, Xv, Xv, Xv, Xv, Xv, Xv, Xv, Xv, Xv, Xv, Xv, Xv, Xv, Xv, Xv, Xv, Xv, Xv^Gov, Xv, Xv, Xv, Xv, Xv, Xv, Xv, Xv, Xv, Xv, Xv, Xv, Xv, Xv, Xv, Xv, Xv, Xv, Xv, Xv, Xv, Xv, Xv, Xv, Xv, Xv, Xv
Xv, Xv, Xv, Xv, Xv, Xv, Xv, Xv, Xv, Xv, Xv, Xv, Xv, Xv, Xv, Xv, Xv, Xv, Xv, Xv, Xv, Xv, Xv, Xv, Xv, Xv, Xv^Gov, Xv, Xv, Xv, Xv, Xv, Xv, Xv, Xv, Xv, Xv, Xv, Xv, Xv, Xv, Xv, Xv, Xv, Xv, Xv, Xv, Xv, Xv, Xv, Xv, Xv, Xv, Xv
Xv, Xv, Xv, Xv, Xv, Xv, Xv, Xv, Xv, Xv, Xv, Xv, Xv, Xv, Xv, Xv, Xv, Xv, Xv, Xv, Xv, Xv, Xv, Xv, Xv, Xv, Xv^Gov, Xv, Xv, Xv, Xv, Xv, Xv, Xv, Xv, Xv, Xv, Xv, Xv, Xv, Xv, Xv, Xv, Xv, Xv, Xv, Xv, Xv, Xv, Xv, Xv, Xv, Xv, Xv
Xv, Xv, Xv, Xv, Xv, Xv, Xv, Xv, Xv, Xv, Xv, Xv, Xv, Xv, Xv, Xv, Xv, Xv, Xv, Xv, Xv, Xv, Xv, Xv, Xv, Xv, Xv^Gov, Xv, Xv, Xv, Xv, Xv, Xv, Xv, Xv, Xv, Xv, Xv, Xv, Xv, Xv, Xv, Xv, Xv, Xv, Xv, Xv, Xv, Xv, Xv, Xv, Xv, Xv, Xv
Xv, Xv, Xv, Xv, Xv, Xv, Xv, Xv, Xv, Xv, Xv, Xv, Xv, Xv, Xv, Xv, Xv, Xv, Xv, Xv, Xv, Xv, Xv, Xv, Xv, Xv, Xv^Gov, Xv, Xv, Xv, Xv, Xv, Xv, Xv, Xv, Xv, Xv, Xv, Xv, Xv, Xv, Xv, Xv, Xv, Xv, Xv, Xv, Xv, Xv, Xv, Xv, Xv, Xv, Xv
Xv, Xv, Xv, Xv, Xv, Xv, Xv, Xv, Xv, Xv, Xv, Xv, Xv, Xv, Xv, Xv, Xv, Xv, Xv, Xv, Xv, Xv, Xv, Xv, Xv, Xv, Xv^Gov, Xv, Xv, Xv, Xv, Xv, Xv, Xv, Xv, Xv, Xv, Xv, Xv, Xv, Xv, Xv, Xv, Xv, Xv, Xv, Xv, Xv, Xv, Xv, Xv, Xv, Xv, Xv
Xv, Xv, Xv, Xv, Xv, Xv, Xv, Xv, Xv, Xv, Xv, Xv, Xv, Xv, Xv, Xv, Xv, Xv, Xv, Xv, Xv, Xv, Xv, Xv, Xv, Xv, Xv^Gov, Xv, Xv, Xv, Xv, Xv, Xv, Xv, Xv, Xv, Xv, Xv, Xv, Xv, Xv, Xv, Xv, Xv, Xv, Xv, Xv, Xv, Xv, Xv, Xv, Xv, Xv, Xv
Xv, Xv, Xv, Xv, Xv, Xv, Xv, Xv, Xv, Xv, Xv, Xv, Xv, Xv, Xv, Xv, Xv, Xv, Xv, Xv, Xv, Xv, Xv, Xv, Xv, Xv, Xv^Gov, Xv, Xv, Xv, Xv, Xv, Xv, Xv, Xv, Xv, Xv, Xv, Xv, Xv, Xv, Xv, Xv, Xv, Xv, Xv, Xv, Xv, Xv, Xv, Xv, Xv, Xv, Xv
Xv, Xv, Xv, Xv, Xv, Xv, Xv, Xv, Xv, Xv, Xv, Xv, Xv, Xv, Xv, Xv, Xv, Xv, Xv, Xv, Xv, Xv, Xv, Xv, Xv, Xv, Xv^Gov, Xv, Xv, Xv, Xv, Xv, Xv, Xv, Xv, Xv, Xv, Xv, Xv, Xv, Xv, Xv, Xv, Xv, Xv, Xv, Xv, Xv, Xv, Xv, Xv, Xv, Xv, Xv
Xv, Xv, Xv, Xv, Xv, Xv, Xv, Xv, Xv, Xv, Xv, Xv, Xv, Xv, Xv, Xv, Xv, Xv, Xv, Xv, Xv, Xv, Xv, Xv, Xv, Xv, Xv^Gov, Xv, Xv, Xv, Xv, Xv, Xv, Xv, Xv, Xv, Xv, Xv, Xv, Xv, Xv, Xv, Xv, Xv, Xv, Xv, Xv, Xv, Xv, Xv, Xv, Xv, Xv, Xv
Xv, Xv, Xv, Xv, Xv, Xv, Xv, Xv, Xv, Xv, Xv, Xv, Xv, Xv, Xv, Xv, Xv, Xv, Xv, Xv, Xv, Xv, Xv, Xv, Xv, Xv, Xv^Gov, Xv, Xv, Xv, Xv, Xv, Xv, Xv, Xv, Xv, Xv, Xv, Xv, Xv, Xv, Xv, Xv, Xv, Xv, Xv, Xv, Xv, Xv, Xv, Xv, Xv, Xv, Xv
Xv, Xv, Xv, Xv, Xv, Xv, Xv, Xv, Xv, Xv, Xv, Xv, Xv, Xv, Xv, Xv, Xv, Xv, Xv, Xv, Xv, Xv, Xv, Xv, Xv, Xv, Xv^Gov, Xv, Xv, Xv, Xv, Xv, Xv, Xv, Xv, Xv, Xv, Xv, Xv, Xv, Xv, Xv, Xv, Xv, Xv, Xv, Xv, Xv, Mm, Xv, Mm^Xm, Mm, Mm, Xv
Xv, Xv, Xv, Xv, Xv, Xv, Xv, Xv, Xv, Xv, Xv, Xv, Xv, Xv, Xv, Xv, Xv, Xv, Xv, Xv, Xv, Xv, Xv, Xv, Xv, Xv, Cv, Xv, Xv, Xv, Xv, Xv, Xv, Xv, Xv, Xv, Xv, Xv, Mm, Mm^Xm, Mm^Xm, Xv, Xv, Xv, Mm^Xm, Xv, Mm, Mm^Xm, Mm, Mm, Mm, Mm, Mm, Mm
Xv, Xv, Xv, Xv, Mm, Xv, Mm, Xv, Xv, Xv, Mm^Xm, Mm, Mm, Mm, Mm^Xm, Mm, Mm, Xv, Mm, Mm, Mm^Xm, Xv, Xv, Xv, Cv, Cv, Kv, Cv, Cv, Xv, Xv, Xv, Mm^Xm, Xv, Xv, Xv, Mm, Mm^Xm, Mm, Mm, Mm, Mm^Xm, Mm, Mm, Mm, Mm^Xm, Mm, Mm, Mm, Mm, Mm, Mm, Mm^Xm, Mm
Xv, Xv, Mm, Mm, Mm, Mm, Mm, Mm, Mm, Mm, Mm, Mm, Mm, Mm, Mm, Mm, Mm, Mm, Mm, Mm, Mm^Xm, Mm^Xm, Mm, Mm, Cv, Kv, Kv, Kv, Cv, Mm, Mm, Mm, Mm, Mm^Xm, Mm, Mm, Mm, Mm, Mm^Xm, Mm, Mm, Mm, Mm, Mm, Mm, Mm, Mm, Mm, Mm, Mm, Mm, Mm^Xm, Mm, Mm
Mm, Mm, Mm^Xm, Mm, Mm, Mm, Mm^Xm, Mm, Mm, Mm, Mm, Mm, Hh, Mm, Mm, Mm, Mm, Mm, Mm, Mm, Mm, Mm, Mm, Mm, Cv, Kv, Kv, Kv, Cv, Mm, Mm, Mm, Mm, Mm, Mm, Mm, Mm, Mm, Mm, Mm, Mm, Mm, Mm, Mm, Mm, Mm, Mm, Mm, Mm, Mm, Mm, Mm, Mm^Xm, Mm
Mm, Mm, Mm, Mm, Mm, Mm, Mm, Mm, Hh, Mm, Mm, Mm, Hh, Hh, Mm, Mm, Mm, Hh, Mm, Mm, Mm, Mm, Hh, Mm, Cv, Cv, Rp, Cv, Cv, Mm, Mm, Mm, Hh, Mm, Hh, Mm, Mm, Mm, Mm, Mm, Mm, Mm, Cv, Cv, Cv, Mm, Hh, Mm, Mm, Mm, Mm, Mm, Mm, Mm
Mm, Mm, Mm, Mm, Mm, Mm, Mm, Mm, Cv, Hh, Mm, Mm, Hh^Fms, Hh^Fms, Hh, Mm, Mm, Hh, Hh, Mm, Hh, Hh, Gg, Hh, Hh, Rp, Rp, Rp, Hh, Mm, Hh, Hh, Hh, Hh, Hh^Fms, Mm, Hh, Hh, Hh, Mm, Hh, Hh, Cv, Kv, Cv, Mm, Hh, Hh, Hh, Hh, Mm, Mm, Mm, Mm
Hh, Mm, Mm, Hh, Hh, Mm, Hh, Hh, Hh, Hh, Gg, Gg, Hh^Fms, Hh^Fp, Gll^Fp, Hh, Mm, Hh, Hh, Hh, Gg, Gg, Gg, Gg, Gg^Efm, Rp, Rp, Rp, Gg^Efm, Hh, Gg, Hh, Gg, Hh, Gg, Hh, Gg, Gg, Gg, Hh, Gg, Hh, Hh, Cv, Hh, Mm, Hh, Hh^Fms, Hh, Mm, Hh, Hh, Hh, Mm
Hh^Fms, Hh, Hh, Hh, Cv, Cv, Cv, Hh, Gg, Gg, Gg, Gll, Gll^Fds, Gs^Fms, Gll^Fp, Gg, Gg, Gg, Gg, Gg, Gg, Cv, Gg, Gg^Fet, Gg^Efm, Rp, Rp, Rp, Gg^Efm, Gg^Fet, Gg, Cv, Gg, Gg, Gg, Gg, Wwf, Gg^Ve, Wwf, Gg, Gg, Gg, Gll^Fms, Gs^Fds, Gg, Hh, Hh, Hh, Hh, Hh^Fms, Hh, Hh^Fms, Hh^Fms, Hh
Hh, Gg, Gg, Hh, Cv, Kv, Cv, Gg, Gg, Gg^Ve, Gg, Gg, Gll^Fp, Gs^Fds, Gll^Fds, Gs^Fms, Gg, Gg, Gg, Cv, Gg, Gg, Gg, Gg^Efm, Gg^Efm, Rp, Rp, Rp, Gg^Efm, Gg^Efm, Gg, Gg, Gg, Cv, Wwf, Wwt, Wwt, Wwt, Wwt, Wwf^Es, Gg, Gll^Em, Gll^Fms, Gs^Fds, Cv, Hh, Gg, Hh^Fds, Gg, Hh, Gg, Hh, Hh^Fms, Hh
Gg, Gg, Gg^Efm, Gg, Gg, Cv, Gg, Gg^Efm, Gll, Gg, Wwf^Es, Ww^Ewl, Wwt, Gll^Fds, Gs^Fds, Gll, Gg, Gg, Gg^Efm, Gg, Gg, Cv, Gg, Gg^Fet, Gg^Efm, Rp, Rp, Rp, Gg^Efm, Gg^Fet, Gg, Cv, Gg, Gg, Gg^Efm, Wwf^Es, Wwt, Ww^Vm, Wwt, Gs^Fds, Gll^Fp, Gll, Gs^Fds, Gll^Fds, Gll^Fds, Gs^Fms, Gg, Gg, Gs^Fds, Gg, Gs^Fms, Gg, Gll^Fp, Hh^Fds
Gg, Gg, Gg^Efm, Gs, Gs, Gs^Fds, Gs^Fds, Gll, Gs^Fms, Gs^Fms, Wwf, Ww^Ewl, Ww^Ewl, Wwt, Wwf, Wwf^Es, Gg, Gg^Efm, Gg^Efm, Gg, Gg, Gg, Gg, Gg^Efm, Gg^Efm, Rp, Rp, Rp, Gg^Efm, Gg^Efm, Gg, Gg, Gg, Gg^Ve, Gg, Gg^Efm, Gg^Efm, Wwt, Wwt, Gs^Fds, Gll^Fds, Gs^Fds, Ss, Gs^Fds, Gll^Em, Gg, Gg, Gs^Fds, Kv, Gs^Fds, Gs^Fms, Gll^Fp, Gll^Fp, Gll^Fp
Gg, Gg^Efm, Gg^Efm, Gs, Gs, Gs^Fds, Gs^Fds, Gll, Gll^Fds, Gll^Fms, Gs^Fms, Wwt, Ww^Ewf, Ww^Ewf, Wwt, Wwt, Gg^Efm, Gg^Efm, Gg, Gg^Ve, Gg, Gg, Gg^Efm, Gg^Fet, Gg^Efm, Rp, Rp, Rp, Gg^Efm, Gg^Fet, Gg^Efm, Gg, Gg, Gg, Gg, Gg^Efm, Gg^Efm, Gg, Wwt, Gll^Fp, Gll^Fds, Gll^Fms, Gs^Fds, Ss, Gll^Fds, Gll^Em, Gg, Gg, Gg^Uf, Cv, Cv, Gs^Fms, Gs^Fms, Gs^Fds
Gg, Gg, Gs, Gg^Ve, Gg, Gs^Fms, Gs^Fds, Gs^Fds, Gll^Fds, Gll^Fds, Wwf^Es, Wwt, Wwt, Ww^Ewl, Gg, Gg, Gg^Efm, Gg, Gg^Fet, Gg^Efm, Kv, Gg^Efm, Gg^Efm, Gg^Efm, Gg^Efm, Rp, Rp, Rp, Gg^Efm, Gg^Efm, Gg^Efm, Gg^Efm, Kv, Gg, Gg^Fet, Gg, Rp, Gg, Wwt, Wwt, Wwf, Gll^Fds, Gs^Fds, Ss, Gll^Fds, Gll^Emf, Gg, Gg^Em, Gg^Em, Gg^Emf, Cv, Gs^Fds, Gs^Fms, Gll^Fp
Cv, Gg, Gg, Gg, Gg^Efm, Gs^Fms, Gs^Fms, Gll^Fds, Gs^Fds, Wwf, Gll^Fds, Wwf^Es, Gll^Fds, Gll^Fds, Gs^Fms, Gg, Gg, Gg, Gg, Gg^Efm, Cv, Gg^Efm, Gg^Efm, Gg^Fet, Gg^Efm, Rp, Rp, Rp, Gg^Efm, Gg^Fet, Gg^Efm, Gg^Efm, Cv, Rp, Rp, Rp, Gll^Fp, Rp, Rp, Wwt, Wwt, Gs^Fds, Wwt, Wwt, Gg, Gs^Fds, Gg, Gg^Ve, Gg^Emf, Gg^Uf, Cv, Gs^Fds, Gs^Fds, Gs^Fms
Cv, Cv, Cv, Gg, Gg, Gg, Gg, Gs^Fms, Gs^Fds, Gll^Fms, Gll^Fds, Gll^Fds, Gll^Fds, Gll^Fds, Gs^Fms, Gg, Gg, Gg, Gg^Fet, Gg^Efm, Cv, Gg^Efm, Gg^Efm, Gg^Efm, Gg^Efm, Rp, Rp, Rp, Gg^Efm, Gg^Efm, Gg^Efm, Gg^Efm, Cv, Gg^Efm, Gg^Fet, Gg, Gll, Gll^Fms, Wwt, Wwt^Bw\, Gs^Fds, Wwt, Wwt, Wwt, Wwt, Gg, Gg, Gg, Gs^Fds, Gg, Cv, Gs^Fms, Gs^Fds, Gll^Fp
Gg, Cv, Cv, Cv, Cv, Gg, Gg, Gs^Fms, Gs, Gs^Fms, Gs^Fds, Gs^Fds, Gll^Fds, Gs^Fms, Gg, Gg^Efm, Gg, Gg, Gg, Gg^Efm, Cv, Gg^Efm, Gg^Efm, Gg^Fet, Gg^Efm, Rp, Rp, Rp, Gg^Efm, Gg^Fet, Gg^Efm, Gg^Efm, Cv, Gg^Efm, Gg, Gg, Wwf, Wwf, Wwt, Gs^Fds, Wwt, Gg, Gg^Ve, Wwf^Es, Wwt, Wwt, Gg, Gll^Fp, Gs^Fms, Cv, Gg, Gg, Gs^Fms, Gll^Fp
Gg, Gg, Gg, Cv, Cv, Cv, Cv, Gg, Gs, Gg, Gg, Gs^Fds, Gs^Fds, Gll, Gg, Gg, Gg^Es, Gg, Gg^Fet, Gg^Efm, Cv, Gg^Efm, Gg^Efm, Gg^Efm, Gg^Efm, Rp, Rp, Rp, Gg^Efm, Gg^Efm, Gg^Efm, Gg^Efm, Cv, Gg^Efm, Gg^Fet, Gg, Wwf^Es, Wwt, Wwt, Wwt, Wot, Wwt, Wwt, Gg, Wwt, Wwt, Wwt, Gll^Fp, Gll^Fp, Gs^Fms, Gll^Fp, Gg, Gg, Gll^Fp
Gs, Gs, Gs^Efm, Gg^Efm, Gg, Cv, Cv, Gg, Gg, Gg, Gg^Ve, Gll, Gll, Gs^Fds, Gg, Gg, Gg, Gg, Gg, Gg^Efm, Gg^Efm, Cv, Cv, Gg^Efm, Cv, Rp, Kv, Rp, Cv, Gg^Efm, Cv, Cv, Gg^Efm, Gg^Efm, Gg, Gg, Wwt, Wwt, Wwt, Wot, Wwt, Wot, Ww^Vm, Wwt, Wot, Wot, Wwt, Gg, Wwt, Gs^Fds, Gg, Gg, Wwf, Wwf
Gll^Fds, Gs, Gll^Em, Gg^Efm, Gg, Kv, Cv, Cv, Cv, Gg, Gg, Gg, Gs, Gll, Gll, Gs, Gs, Gg, Gg, Gg^Fet, Gg, Gg^Efm, Gg^Efm, Cv, Cv, Kv, Kv, Kv, Cv, Cv, Gg^Efm, Gg^Efm, Gg, Gg^Fet, Wwt, Wwt, Gll^Fms, Gs^Fds, Wwf, Wwt, Gg, Wwt, Wwt, Wwt, Wwt, Wot, Wot, Wwt, Wwt, Wwt, Wwt, Wwt, Wwt, Wwt
Gs^Fds, Gll, Gll^Em, Gg, Gg, Gg, Gg, Cv, Cv, Cv, Cv, Gs, Gs, Gll^Fds, Gll^Fds, Gs, Gs, Gs, Gg, Gg, Gg, Gg^Fet, Gg, Gg^Efm, Gg^Efm, Kv, Kv, Kv, Gg^Efm, Gg^Efm, Gg, Gg^Fet, Gg, Gg, Wwt, Gll^Fds, Gll^Fms, Gs^Fds, Gll, Gg, Gg^Ve, Gg, Gs^Fds, Wwf^Es, Wwf^Es, Wwt, Wwt, Wot, Wwt, Wot, Wot, Wot, Wot, Wwt
Gs^Fds, Gll^Fds, Gll^Fds, Gll^Em, Gs, Gg, Gs^Fds, Gg, Gll, Cv, Cv, Gg, Gs, Gs, Gll^Fds, Gll^Fds, Gg, Gs, Gg^Efm, Gg, Gg, Gg, Gg, Gg^Fet, Gg, Rp, Rp, Rp, Gg, Gg^Fet, Gg, Gg, Wwt, Wwt, Gs^Fms, Gll^Fms, Gll^Fds, Gll^Fds, Gg, Gg, Gg, Gg^Efm, Gll, Gll^Fds, Gs^Fms, Gll^Fms, Gg, Wwt, Wwt, Wwt, Wwt, Wot, Wwt, Wot
Gs^Fds, Gll^Fds, Gll^Fds, Gs, Gs, Gs, Gll^Fds, Gll^Fds, Gg, Cv, Cv, Gg, Gg, Gs, Gll, Gs^Fds, Gs^Fds, Gg, Gg, Gg^Ve, Rp, Rp, Rp, Gg, Gg, Rp, Rp, Rp, Gg, Gg, Wwt, Wwt, Gg, Gll, Gll^Fms, Gll^Em, Gg, Gg, Kv, Gg, Gg, Gg, Gg, Gg, Gg, Gll, Gg, Wwt, Wwt, Wwf, Wwf^Es, Wwt, Wwt, Wwt
Gs^Fms, Gs^Fms, Gs^Fds, Gll^Fds, Gll^Fds, Gs, Gg, Gll, Gg, Cv, Cv, Gg, Gg, Gg, Gs, Gll, Gs^Fds, Gg, Gg, Gg, Gg^Ve, Rp, Rp, Rp, Rp, Rp, 2 Rp, Rp, Gg^Ve, Gg, Wwt, Gg, Gg, Gll, Gg, Gll^Em, Gg^Ve, Gg, Cv, Cv, Gg, Gg^Efm, Gg, Gs, Gg^Efm, Gg^Ve, Gg, Gg, Gs^Fms, Wwf^Es, Wwf^Es, Wwt, Gg^Ve, Wwt
Gs^Fms, Gs^Fms, Gs^Fms, Gll^Em, Gll^Fms, Gg, Gg^Efm, Gg, Wwf^Es, Cv, Cv, Gg, Gg, Gg, Gg, Gg, Gg, Gg, Gg^Efm, Gg, Rp, Rp, Rp, Rp, Rp, Rp, Rp, Rp, Gg, Gg, Wwt, Gg, Gg, Gg, Gg, Gg, Gg^Em, Gg, Cv, Cv, Cv, Gg, Gg^Emf, Gg^Efm, Gg^Efm, Gg, Gg, Gs^Fds, Gll^Fp, Gs^Fds, Gs^Fms, Gg^Fet, Gll^Fp, Gg
Gs^Fds, Gll^Fp, Gll^Fp, Gll^Fms, Gll^Fms, Gs^Fds, Gg, Wwt, Wwt, Kv, Cv, Cv, Cv, Gg, Gg, Gg^Es, Gg, Gg, Gg^Efm, Gg^Ve, Rp, Rp, Wwt, Wwt, Wwt, Rp, Wwt^Bsb|, Rp, Wwt, Wwt, Gg, Gg, Gg, Gg^Ve, Gg, Gg^Efm, Gg, Gs^Fds, Gll^Fp, Cv, Cv, Cv, Cv, Gg, Gg, Gg, Gg, Gs^Fms, Gs^Fms, Gll^Fp, Gs^Fms, Gs^Fds, Gs^Fms, Gs^Fms
Gs^Fds, Gs^Fms, Gll^Fds, Gs^Fms, Gs^Fms, Gs, Gg, Wwt, Wot, Wwt, Wwt, Cv, Cv, Cv, Cv, Gg, Gg, Gg^Efm, Gg, Gg, Rp, Rp, Wwt, Wwt, Wwt, Wwt, Rp, Wwt, Gg, Gg, Gg, Gg, Gs, Gg, Gg, Gg^Efm, Gs^Fds, Gs^Fds, Gg^Fet, Gs^Fms, Gs^Fms, Cv, Cv, Cv, Cv, Gg, Cv, Cv, Cv, Gg, Gg, Gll^Fp, Cv, Gll^Fp
Hh, Hh^Fms, Hh^Fms, Gs^Fds, Gs^Fms, Gg, Gg, Wwt, Wwt, Wot, Wot, Wwt, Wwt, Cv, Cv, Gg, Gg, Gg, Gg, Gg, Gg^Ve, Rp, Wwt, Wwt, Gg, Rp, Rp, Rp, Gg, Gg, Gg^Fet, Gg, Gs, Gg, Gg^Ve, Gg, Gs^Fds, Gs^Fds, Gs^Fms, Gs^Fms, Gs^Fds, Gs^Fms, Cv, Kv, Cv, Cv, Cv, Cv, Cv, Cv, Cv, Cv, Cv, Cv
Hh, Hh, Hh^Fms, Hh^Fms, Gg, Gs^Fms, Gg, Gg^Efm, Wwt, Wot, Wot, Wwt, Wwt, Cv, Cv, Cv, Cv, Gg, Wwf^Es, Gg, Wwt, Wwt, Gg, Gg, Gg, Rp, Rp, Rp, Gg, Gg, Gs^Efm, Gs, Gs, Gg^Em, Gg, Gg^Emf, Cv, Gs^Fds, Gs^Fds, Gs^Fds, Cv, Cv, Cv, Cv, Rp, Cv, Rp, Gg^Efm, Gg^Efm, Cv, Cv, Cv, Gg, Cv
Md, Hh, Hh^Fms, Gg, Hh, Gg, Hh, Gg, Wwt, Wot, Ww^Vm, Wot, Wot, Wwt, Wwf, Cv, Cv, Wwt, Wwt, Wwt, Wwt, Wwt, Cv, Kv, Gg, Rp, Rp, Rp, Gg, Gg^Efm, Gg, Gg, Gg, Gg^Emf, Cv, Cv, Cv, Cv, Cv, Cv, Cv, Cv, Gg^Efm, Gg^Efm, Rp, Rp, Rp, Gg, Gg^Efm, Gg, Gg, Gg, Gs^Fds, Gg
Md, Hh^Fms, Md, Hh, Hh, Hh^Fds, Hh^Fds, Wwt, Wot, Wot, Wwt, Wwt, Wwt, Wwt, Wwf^Es, Kv, Cv, Cv, Cv, Wwt, Wwf^Es, Wwf, Cv, Cv, Gg, Rp, Rp, Rp, Gg, Gg^Efm, Gg, Gg, Cv, Cv, Cv, Cv, Gg, Cv, Kv, Cv, Gg, Gg^Efm, Gg, Gg, Gg, Rp, Rp, Rp, Rp, Gg, Gg, Gs^Fds, Gll^Fp, Gll^Fp
Md, Md, Md, Md, Md, Hh, Hh^Fds, Wwt, Wot, Wwt, Wwt, Wwt, Gg, Wwf, Gg, Gg, Gg, Cv, Cv, Cv, Cv, Cv, Cv, Cv, Gg, Rp, Rp, Rp, Gg, Gg, Cv, Cv, Cv, Cv, Gg^Efm, Gg^Efm, Gg, Gg, Gg, Gg^Efm, Gg, Gg, Gg, Gs^Fms, Gll^Em, Gg, Gg^Ve, Rp, Cv, Cv, Cv, Gll, Gs^Fms, Gll^Fp
Md, Md, Md, Md, Md, Hh, Wwt, Wwt, Wwt, Wwt, Gg^Efm, Gg^Efm, Gg, Gg, Gg, Gg, Gg^Efm, Gg, Gg, Cv, Cv, Cv, Gg, Gg, Gg^Ve, Rp, Rp, Rp, Gg, Kv, Cv, Cv, Gg, Gg, Gg^Efm, Gg, Gg, Gs^Es, Gg^Ve, Gg, Gs^Fds, Gll, Gll, Gs^Fms, Gll^Fds, Gll, Gg, Gg, Cv, Kv, Cv, Gll, Gs^Fms, Gs^Fms
Md, Md, Md, Md, Wwt, Wwt, Ww^Vm, Wwt, Wwf, Gg^Es, Gg, Gg, Hh, Hh^Fms, Hh, Gg, Gg, Gg, Gg^Efm, Gg, Gg, Gg, Gg, Gs, Gg^Efm, Rp, Rp, Rp, Gg, Cv, Cv, Gg, Gg, Gg^Efm, Gg, Gg, Gs^Fds, Gs, Gs, Gg, Gs^Fds, Gll^Fds, Gll^Fds, Gll^Fms, Gs^Fds, Gll^Em, Gg^Emf, Gg, Gg, Cv, Rp, Gg, Gll, Gll^Fp
Hh, Md, Hh, Hh, Wot, Wot, Wwt, Wwt, Gg, Gg^Es, Hh, Gg, Hh^Fds, Hh, Hh, Gg, Gg, Gg, Gg, Gg^Efm, Gg, Gg^Es, Gs, Gs^Efm, Gg, Rp, Rp, Rp, Gg, Cv, Gg, Gg, Gg, Gs, Gll, Gll^Fp, Gs^Fds, Gs^Fds, Gg, Gg, Gg, Gg, Gll, Gll^Fds, Gs^Fds, Gll^Fp, Gll^Em, Gll, Gg^Ve, Rp, Rp, Gg^Efm, Gg, Gs^Fds
Hh, Hh, Hh^Fms, Hh^Fds, Wot, Wot, Hh, Gg, Hh, Hh, Hh, Gg, Hh, Hh, Mm, Hh, Hh^Fp, Hh, Gg, Gg^Efm, Gg, Gg, Gs, Gg^Efm, Gg, Rp, Rp, Rp, Gg, Gg, Gg^Ve, Gg^Es, Gs, Gs, Gll^Fms, Gs^Fds, Gs^Fds, Gll, Gg, Gll^Fp, Gg, Gg^Ve, Gll, Gll^Fp, Gs^Fms, Gs^Fds, Gs^Fms, Gs^Fds, Gll^Fp, Rp, Rp, Rp, Rp, Gg
Hh, Hh, Wwt, Wot, Wwt, Wwt, Hh^Fms, Hh^Fds, Hh, Hh^Fms, Hh, Hh, Mm, Mm, Mm, Hh, Hh^Fms, Hh^Fms, Hh, Hh, Hh, Gg, Gg, Gg, Gg, Rp, Rp, Rp, Gg, Gg, Gg, Gg, Gg, Gll^Fp, Gg, Gs^Fds, Gll, Gll, Gg, Gg, Gll^Fp, Gg, Gg, Gll, Gll^Fp, Gll^Fp, Gll^Fp, Gs^Fds, Gs^Fds, Gg, Gg, Rp, Rp, Rp
