Sm, Sm, Ss, Sm, Sm, Sm, Sm, Gs^Fmw, Gs^Fmw, Gs^Fmw, Rd, Gs^Fmw, Hh, Gs^Fmw, Gs^Fmw, Hh^Qhh, Hh^Qhh, Hh^Qhh, Mm^Qhh, Mm^Qhh, Mm^Qhh, Mm^Qhh, Mm^Qhh, Mm^Qhh, Mm^Qhh, Mm^Qhh, Mm^Qhh, Gg^Qhh, Mm^Qhh, Mm^Qhh, Wo, Wo, Mm^Xm, Mm^Xm, Mm^Xm, Mm^Xm, Mm^Xm, Mm^Xm, Mm^Xm, Mm^Xm, Mm^Xm, Mm
Ss, Ss, Chs, Ss, Ss^Vhs, Sm, Ss^Tf, Gs^Fdw, Ss, Gs^Fmw, Rd, Gs^Fmw, Gs^Fmw, Hh, Hh, Gs^Fmw, Gs^Qhhf, Hh, Hh, Mm, Mm^Vhh, Mm, Mm^Xm, Mm^Xm, Mm^Qhh, Mm^Xm, Mm^Xm, Mm, Mm, Wo, Mm^Xm, Mm, Mm^Xm, Mm^Xm, Mm^Xm, Mm^Xm, Mm^Xm, Mm^Xm, Mm^Xm, Mm^Xm, Mm^Xm, Mm
Ss, Chs, Gs^Fp, Ss, Ss, Ss, Chs, Chs, Chr, Gs^Fmw, Rd, Gs^Fmw, Gg, Gs^Fmf, Hh, Gs^Fmw, Gs^Qhhf, Gs^Es, Gs^Fp, Hh, Hh, Mm, Mm^_mh, Mm^Xm, Mm^Xm, Mm^Qhh, Mm^Qhh, Mm, Wo, Wo, Mm^Xm, Mm^Xm, Mm^Xm, Mm^Xm, Mm^Xm, Mm^Xm, Mm^Xm, Mm^Xm, Mm^Xm, Mm^Xm, Mm^Xm, Mm
Sm, Sm, Gs^Vct, Gs^Fp, Ss, Chs, Chs, 3 Khr, Chr, Ss, Rd, Gs^Es, Gg, Gg, Gs^Fp, Hh^Qhh, Mm, Gs, Hh, Hh, Mm, Mm^Xm, Mm, Mm, Mm^Xm, Mm^Xm, Mm^Qhh, Wo, Mm^Xm, Mm^Xm, Mm^Xm, Mm^Xm, Mm^Xm, Mm^Xm, Mm^Xm, Mm^Xm, Mm^Xm, Mm^Xm, Mm^Xm, Mm^Xm, Mm^Xm, Mm^Xm
Ss, Sm, Ss, Ss, Chs, Ss, Ss, Ss, Ss, Ss, Gs, Re, Rd, Gg^Es, Gg, Hh^Qhh, Mm^Qhh, Mm, Hh, Hh, Hh, Mm, Mm, Hh, Mm, Mm, Mm^Qhh, Wo, Mm^Xm, Mm^Xm, Mm^Xm, Mm^Xm, Mm^Xm, Mm^Xm, Mm^Xm, Mm^Xm, Mm^Xm, Mm^Xm, Mm^Xm, Mm^Xm, Mm^Xm, Mm^Xm
Mm^Qhh, Mm^Qhh, Mm^Qhh, Hh, Mm, Hh, Gs^Vct, Ss, Ss^Vhs, Sm, Sm, Gg, Gg, Re, Hh, Hh, Gg, Hh^Qhh, Hh, Mm, Hh, Mm^Xm, Mm, Hh, Mm^Qhh, Mm^Qhh, Wo, Wo, Mm^Xm, Mm^Xm, Mm^Qhh, Mm^Xm, Mm^Xm, Mm^Xm, Mm^Xm, Mm^Xm, Mm^Xm, Mm^Xm, Mm^Xm, Mm^Xm, Mm^Xm, Mm^Xm
Mm^Qhh, Mm^Xm, Mm^Xm, Mm^Qhh, Mm^Qhh, Hh, Hh, Hh, Sm, Sm, Mm, Hh, Gg, Re, Gg, Gg, Hh, Gs^Qhh, Gll^Fmf, Hh, Mm, Mm, Mm^Xm, Mm^Qhh, Wo, Wo, Mm^Xm, Mm^Xm, Mm^Xm, Mm^Xm, Mm^Qhh, Mm^Xm, Mm, Mm^Xm, Mm^Xm, Mm^Xm, Mm^Xm, Mm^Xm, Mm^Xm, Mm^Xm, Mm^Xm, Mm^Xm
Mm^Qhh, Mm^Xm, Mm^Xm, Mm^Xm, Mm, Hh^Qhh, Hh, Mm, Gs^Fp, Hh, Hh, Hh, Gg, Rd, Gg, Gg, Gs^Em, Gll^Qhhf, Hh^Qhhf, Hh, Hh, Mm^Xm, Mm^Xm, Mm^Qhh, Wo, Mm^Xm, Mm^Xm, Mm, Mm^Qhh, Mm^Qhh, Mm^Xm, Mm^Xm, Mm, Mm^Xm, Mm, Mm^Xm, Mm^Xm, Mm^Xm, Mm^Xm, Mm^Xm, Mm, Mm^Xm
Mm^Qhh, Hh, Mm, Mm, Hh, Hh^Qhh, Mm^Qhh, Hh, Gs^Fp, Mm, Gs^Fmf, Gg, Rd, Rd, Gs^Fmf, Gs, Gd^Fdf, Gll^Fp, Gll^Fmf, Hh^Qhhf, Hh^Qhh, Mm^Xm, Mm^Xm, Mm^Qhh, Wo, Mm^Xm, Mm^Xm, Mm, Mm^Qhh, Mm^Xm, Mm, Mm, Mm^Vd, Mm, Mm, Mm^Xm, Mm, Mm^_mh, Mm^Xm, Mm^Xm, Mm, Gll^Fp
Mm^Qhh, Hh, Mm, Mm^_mh, Hh, Hh, Mm, Mm^Qhh, Hh, Gs^Fp, Gg, Gg, Gs, Gg, Gg, Gg^Em, Gll^Fmf, Gll^Fp, Gll^Fmf, Gs, Mm^Qhh, Mm^Xm, Mm^Xm, Mm^Qhh, Mm^Xm, Wo, Mm^Xm, Mm, Mm^Qhh, Mm, Mm, Mm, Mm, Mm, Mm, Mm, Mm, Mm, Mm, Gll^Fp, Mm, Mm
Mm^Qhh, Mm, Mm^Xm, Mm^Xm, Mm, Hh, Hh, Hh^Qhh, Gs^Fmf, Gs^Em, Gs, Gg, Gs, Gg, Gs, Gd^Fdf, Gll^Fmf, Gs, Mm, Hh, Mm^Qhh, Mm^Xm, Mm^Qhh, Mm^Qhh, Wo, Wo, Mm^Xm, Mm, Hh^Qhh, Mm, Mm, Mm, Mm, Mm, Hh^Fp, Mm, Hh, Mm, Gll^Fp, Mm, Mm, Mm
Mm^Qhh, Mm^Xm, Mm, Mm, Mm, Hh, Gs^Fp, Gs^Qhhf, Gs^Fmf, Gs^Fp, Gs^Fp, Re, Gs, Hh, Gs^Fp, Gs, Gs^Fp, Hh, Mm, Mm, Gs^Fp, Hh^Qhh, Hh, Mm, Ww, Mm^Xm, Mm^Xm, Mm, Hh^Qhh, Hh, Hh^Fp, Hh, Hh, Mm, Hh, Hh, Hh^Fp, Hh^Fp, Hh^Fp, Mm, Hh, Mm
Mm^Qhh, Mm^Xm, Mm, Mm, Hh, Gs^Fmf, Gs^Qhhf, Gs^Qhhf, Gs, Gs^Em, Gs^Es, Re, Gg, Gs, Gs^Fmf, Gs^Fmf, Gs^Fp, Gs, Gs^Em, Hh, Gs^Fmf, Gs^Fp, Gs^Es, Mm, Mm, Wo, Mm^Qhh, Hh^Qhhf, Hh^Fp, Hh^Qhh, Hh^Qhh, Hh^Qhh, Hh^Qhh, Mm, Hh, Hh, Hh, Hh, Hh^Fp, Hh^Fp, Hh, Hh
Mm^Qhh, Mm^Xm, Mm, Hh, Hh, Gs^Fmf, Gs^Qhhf, Gg^Em, Gs^Fp, Gg, Gg, Re, Gg, Gg^Vl, Gs^Fp, Gs^Fmf, Wwr, Wwf, Gs^Fp, Gs^Fmf, Hh, Hh^Fmf, Gs^Fp, Mm, Wo, Wo, Hh, Gll^Fp, Hh, Hh, Hh^Fp, Hh^Fmf, Hh^Qhh, Hh, Hh, Gll^Fp, Gll^Fp, Hh, Hh^Fp, Hh^Fp, Hh^Fmf, Hh
Mm^Qhh, Mm^Qhh, Mm^Qhh, Hh^Qhh, Hh^Qhh, Gs^Qhhf, Gs^Fp, Gs^Fp, Re^Gvs, Re^Gvs, Gg, Rp, Re, Gg, Re^Gvs, Gs^Fp, Ww, Wwf, Ww, Gg, Ww, Gs^Fmf, Gs^Fdf, Hh, Ww, Gs^Fmw, Gs^Fmf, Gg^Em, Hh^Fp, Gg, Gll^Fmf, Hh, Hh^Qhh, Gll^Fmf, Gll^Fmf, Gll^Fp, Gll^Fmf, Gs, Gll^Qhhf, Hh^Fmf, Gll^Qhhf, Gll^Qhhf
Mm^Xm, Mm^Xm, Mm^Xm, Mm, Mm, Hh, Ww, Re^Gvs, Gg, Gg^Wm, Re^Gvs, Gg, Re, Re^Gvs, Wwf, Ww, Gg, Ww, Wwr, Ww, Gg^Es, Ww, Ww, Ww, Gll^Fmf, Gll^Fmf, Gs^Fmf, Hh^Fp, Gll^Fp, Gs^Emf, Gll^Fp, Gll^Fmf, Gll^Qhhf, Gll^Fmf, Gll^Fp, Gll^Fp, Gll^Fmf, Gll^Qhhf, Gll^Fmf, Gll^Qhhf, Gll^Fp, Gll^Qhhf
Mm^Xm, Mm^Xm, Mm, Mm, Hh, Hh, Gg, Ww, Re^Gvs, Re^Gvs, Gg, Gg, Rp, Ww, Re^Gvs, Re^Gvs, Gg, Ww, Wwf, Gs^Fmf, Gs^Fmf, Wwr, Ww, Ss, Gll^Fmf, Gll^Fmf, Gs^Fmw, Gll^Fp, Gll^Fp, Gll^Fp, Gll^Fmf, Gll^Fp, Gll^Qhhf, Gll^Fp, Gll^Fmf, Gs^Vl, Gll^Qhhf, Gll^Qhhf, Gll^Fmf, Gll^Fmf, Gg, Gg
Mm, Mm, Mm, Mm^Xm, Mm, Mm, Hh, Ww, Ww, Gg^Vl, Re^Gvs, Re^Gvs, Wwf, Ww, Gg, Gg^Wm, Gs, Wwf, Gs^Fp, Ss, Ss, Wwf, Ww, Ss^Emf, Gll^Fmf, Gll^Fmf, Gll^Fmf, Gll^Fmf, Gll^Fmf, Gll^Fmf, Gg, Gll^Fp, Gs^Em, Gll^Qhhf, Gll^Qhhf, Gll^Qhhf, Gll^Fp, Gs^Vl, Rp, Gg, Rp, Rp
Mm, Hh, Hh, Mm, Gs^Tf, Hh, Gs^Fp, Gs^Fp, Ww, Re^Gvs, Ww, Wwf, Gs, Rr, Rr, Gs, Ch, Gs^Fmf, Gs^Fp, Gs^Fp, Gs^Fmw, Ww, Wwr, Gs^Fdf, Hh, Hh, Gll^Fmf, Gll^Fp, Gll^Fmf, Ch, Ch, Gs, Gs, Gg^Efm, Gs, Gs, Rp, Rp, Rp, Rp, Gs, Gs
Mm^Xm, Hh, Hh, Gs^Tf, Hh, Gs^Fp, Gs^Fp, Gs^Fp, Gg^Em, Ww, Gg, Gs, Ch, Gs^Es, Rr, Ch, Gll^Fmf, Gs^Fp, Gs, Gg, Gs^Vh, Ww, Ww, Gs^Fp, Rrc, Gll^Fmf, Rrc, Gg, Gg, Kh, Ch, Gs, Gs, Gg, Rr, Rp, Gs^Efm, Gs^Em, Gll^Fp, Gs^Em, Gll^Fp, Gll^Fp
Mm^Xm, Mm, Hh, Hh, Gs^Fp, Hh, Hh, Hh, Gg, Gg, Ch, Ch, Gll^Fmf, Gs, Rrc, Gs, Gll^Fmf, Gll^Fmf, Gs, Gs, Gs, Gs, Ww^Bsb/, Rrc, Rrc, Rrc, Gs^Fp, Rrc, Rrc, Gg, Gs, Ch, Gs, Gs, Rr, Rp, Gs, Gs, Gll^Fmf, Gll^Fp, Hh^Fp, Gll^Fp
Mm, Mm, Mm, Hh, Hh^Fp, Gs^Fp, Hh, Hh, Hh, Hh, Ch, Gll^Fmf, Gll^Fmf, Gs, Rrc, Gs, Rrc, Gll^Fmf, Rrc, Rrc, Rrc, Rrc, Ww, Ww, Gs, Gg, Gs^Em, Gs, Rrc, Gs^Vh, Gs, Gs, Rr, Rr, Gg, Gg^Efm, Gg, Gll^Fmf, Gll^Fp, Hh^Fmf, Hh^Fp, Gll^Fp
Hh, Hh, Hh, Hh, Gll^Fp, Gg^Fp, Hh, Mm^Xm, Mm, Gll^Fp, Gll^Fp, Gll^Fmf, Gs^Vh, Gs, Gs, Rrc, Rrc, Rrc, Gs, Gs, Ch, Ch, Gg^Fet, Ww, Ww, Gg, Gs, Gs, Gg, Rrc, Rrc, Rr, Gg, Ch, Gll^Fp, Gg, Hh, Hh, Hh^Fp, Hh^Fp, Hh, Hh
Gg, Hh, Gd, Gll^Fp, Gll^Fp, Gll^Fp, Mm, Mm^Xm, Mm, Gll^Fp, Gll^Fp, Gll^Fmf, Gg, Gg^Efm, Gs, Gs, Rrc, Rrc, Gs, Gll^Fmf, Ch, 2 Kh, Ch, Gll^Fp, Gg, Ww, Ww, Gg, Rrc, Rrc, Gs, Gs, Kh, Ch, Gll^Qhhf, Gll^Fp, Hh^Fp, Hh^Fp, Mm, Hh^Fp, Hh, Mm
Gd, Gd^Es, Gd, Gll^Fp, Gll^Fp, Gll^Fp, Hh, Mm, Gs^Fp, Hh, Ch, Gll^Fmf, Gg, Gg, Gs^Efm, Gs, Rrc, Rrc, Gll^Fp, Gll^Fp, Gll^Fp, Gll^Fp, Gll^Fp, Gs, Gg, Gg, Rrc, Ww^Bsb/, Ww, Gg, Gs, Gs, Ch, Ch, Gll^Qhhf, Gll^Qhhf, Hh^Qhhf, Mm^Qhu, Mm^Qhu, Mm^Qhu, Md^Qhu, Md^Qhu
Gd^Qhu, Gd^Qhu, Gd^Qhu, Gd, Gll^Fp, Hh, Gll^Fp, Hh, Gs, Ds, Ch, Gll^Fmf, Gs, Gs, Gs, Gs, Rrc, Rrc, Rrc, Gll^Fp, Gs, Gll^Fp, Gs, Gs, Rrc, Rrc, Gs^Vh, Gg, Ww, Gs^Em, Hh, Ch, Hh^Qhhf, Hh^Qhhf, Hh, Hh^Fp, Mm, Mm, Mm, Md, Md, Md
Gd^Qhu, Gd^Es, Gd^Fdf, Gll^Qhuf, Gd^Qhu, Gll^Fmf, Gll^Fmf, Gll^Fp, Gs^Fmf, Gs, Gs, Ch, Ch, Gs, Rr, Rrc, Rrc, Rrc, Gg, Rrc, Rrc, Rrc, Rrc, Rrc, Gg^Efm, Gs, Gs, Gs, Wwf, Mm, Mm, Hh^Fp, Hh^Qhhf, Hh^Qhhf, Hh, Mm, Mm, Mm, Md, Md, Md, Md
Gd^Qhu, Gs, Gs^_ml, Gll^Fmf, Gd^Qhu, Gd, Dd, Gd^Fdf, Gs^Fmf, Gd^Fdf, Gs, Gg, Rr, Rp, Rr, Rrc, Gs, Gs^Es, Gs, Gs^Vh, Gs^Fmf, Gs^Fmf, Gs^Fp, Gg, Gg, Gs, Hh, Gg, Md, Wwr, Wwr, Hh, Mm, Mm^Qhh, Mm, Mm, Md^Xm, Md, Md^_mh, Md^Xm, Md^Xm, Md
Gg^Qhu, Gd, Gs^Es, Gd^Fdf, Gs^Qhu, Gd, Gs, Gd^Fdf, Gs, Gs, Rd, Rp, Rp, Rr, Gs, Ch, Ch, Kh, Ch, Gs, Ch, Gs^Fp, Gs^Fp, Gg, Hh, Hh^Fp, Mm, Md, Md, Md, Md, Ww, Wwr, Md^Qhh, Md, Mm, Md, Md^Xm, Md^Xm, Md, Md^Xm, Md
Gg^Qhu, Gg, Gs^Qhu, Gs^Qhu, Gg, Gd^Es, Gg, Gs, Rd, 1 Rd, Gd, Rp, Gg, Gs, Gd, Gs, Gs, Ch, Gs, Ch, Hh, Hh, Gs^Fp, Gs^Fp, Hh, Mm, Mm^Xm, Md, Md^Xm, Md, Md, Ww, Ww, Md^Qhh, Md^Qhh, Md, Md, Md^Xm, Md^Xm, Md, Md, Md^Xm
Gd^Qhu, Gd, Gd^Qhu, Gd, Gd^Es, Gd, Re, Re, Gd^Es, Gd, Gd, Gg^Es, Gd, Gs^Fmf, Gs^Fdf, Gd, Gs^Fdf, Gs, Gs^Fp, Gs, Hh, Hh, Hh, Hh, Mm, Mm, Mm^Xm, Md, Md, Md^Xm, Md, Md, Wwr, Ww, Md^Qhh, Md, Md^Xm, Md^Xm, Md^Xm, Md^Xm, Md^Xm, Md^Xm
Dd^Qhu, Gd^Qhu, Dd, Gd, Dd, Rd, Gs, Gs, Gd, Gd, Gd^Es, Gs, Gs, Gd, Gd^Es, Gs^Fmf, Gd, Gd, Gd, Gs^Fmf, Gg, Hh, Mm, Mm, Mm^Xm, Mm^Xm, Mm^Xm, Md^Xm, Md^Xm, Md^Xm, Md^Xm, Md, Md, Ww, Ww, Md^Qhh, Md^Qhh, Md^Xm, Md^Xm, Md^Xm, Md^Xm, Md^Xm
