Ms^Xm, Ms^Xm, Ms^Xm, Ms^Xm, Ms^Xm, Ms^Xm, Ms^Xm, Mm^Xm, Mm^Xm, Mm^Xm, Ms^Xm, Ms^Xm, Ms^Xm, Ms^Xm, Ms^Xm, Ms^Xm, Ms^Xm, Ms^Xm, Ms^Xm, Ms^Xm, Ms^Xm, Mm^Xm, Ms^Xm, Mm^Xm, Ms^Xm, Ms^Xm, Ms^Xm, Ms^Xm, Ms, Ms, Ha, Ai, Ai, Ha, Aa^Fda, Ha, Aa^Fpa, Ha, Ha, Ha, Ha, Ha, Ha^Fda, Aa, Aa, Ha, Ha
Ms^Xm, Ms^Xm, Ms^Xm, Ms^Xm, Ms^Xm, Ms^Xm, Ms^Xm, Mm^Xm, Mm^Xm, Ms^Xm, Ms^Xm, Ms^Xm, Ms^Xm, Ms^Xm, Ms^Xm, Ms^Xm, Ms^Xm, Ms^Xm, Ms^Xm, Ms^Xm, Ms^Xm, Ms^Xm, Ms^Xm, Ms^Xm, Ms^Xm, Ms^Xm, Ms^Xm, Ms^Xm, Ms, Ms, Ha^Fma, Ai, Ai, Ha, Aa^Fma, Aa^Fda, Aa^Fda, Aa^Feta, Aa^Fma, Aa^Fma, Ha, Ha^Fda, Aa^Fda, Aa, Aa^Fma, Ha^Fma, Ha
Mm^Xm, Ms^Xm, Ms^Xm, Ms^Xm, Ms^Xm, Ms^Xm, Mm^Xm, Mm^Xm, Mm^Xm, Ms^Xm, Mm^Xm, Ms^Xm, Ms^Xm, Ms^Xm, Ms^Xm, Ms^Xm, Ms, Ms^Xm, Ms, Ms, Ms, Ms^Xm, Ms^Xm, Ms^Xm, Ms^Xm, Ms^Xm, Ms^Xm, Ms^Xm, Ms, Ms, Ha, Ai, Wo, Ha, Ha^Fpa, Chr, Aa^Fma, Aa^Fda, Ha^Fda, Aa^Fda, Ha^Voa, Aa, Aa, Aa, Ha^Fda, Ai, Ms
Mm^Xm, Mm^Xm, Ms^Xm, Ms^Xm, Ms^Xm, Mm^Xm, Mm^Xm, Ms^Xm, Mm^Xm, Mm^Xm, Mm^Xm, Mm^Xm, Mm^Xm, Ms^Xm, Ms^Xm, Ms^Xm, Ms, Ha, Ha^Fda, Ha, Ha, Ms, Ms^Xm, Ms^Xm, Ms, Ms^Xm, Ms, Ms, Ms, Ms, Aa^Fpa, Ha, Ai, Ai, Ai, Aa^Fpa, Ha, Aa^Fda, Aa, Aa, Aa, Aa, Aa, Ha^Fda, Ms, Ha, Ms
Mm^Xm, Mm^Xm, Mm^Xm, Ms^Xm, Mm^Xm, Mm^Xm, Ms^Xm, Mm^Xm, Mm^Xm, Ms^Xm, Mm^Xm, Mm^Xm, Mm^Xm, Ms^Xm, Ms^Xm, Ms^Xm, Ms, Ha^Fma, Aa^Fma, Aa^Feta, Aa^Fma, Ms, Ms, Ms, Ms, Ms, Ms, Ms, Ms, Ms, Aa^Fda, Aa^Fma, Ha, Wo, Wo, Aa^Fpa, Cha, Aa, Cha, Aa^Fdw, Cha, Rb, Aa^Fda, Aa, Aa^Fpa, Ms, Aa^Fpa
Mm^Xm, Mm^Xm, Mm^Xm, Mm^Xm, Mm^Xm, Mm^Xm, Ms^Xm, Mm^Xm, Mm^Xm, Mm^Xm, Mm^Xm, Mm^Xm, Mm^Xm, Ms^Xm, Ms^Xm, Ms, Ha, Aa^Fma, Ha, Aa^Edb, Ha, Ha, Ms, Ms, Ms, Ms, Ms, Ms, Ha, Ha, Ha^Fda, Ha, Aa^Fpa, Ai, Ai, Aa^Fpa, Aa^Fpa, Aa, Aa^Vca, Cha, 2 Kha, Cha, Aa^Fma, Aa^Fma, Aa^Fda, Aa^Fpa, Aa^Fpa
Mm^Xm, Mm^Xm, Mm^Xm, Mm^Xm, Mm^Xm, Mm^Xm, Mm^Xm, Mm^Xm, Mm^Xm, Mm^Xm, Mm^Xm, Mm^Xm, Mm^Xm, Ms^Xm, Ms^Xm, Ms, Ms, Ha, Ms^Xm, Ms^Xm, Ms^Xm, Ms^Xm, Ms, Ms, Ha, Ha, Aa^Fma, Aa^Fpa, Gd^Esa, Aa, Aa^Fda, Ha, Ha^Voa, Aa^Fda, Ai, Ai, Ai, Aa, Aa, Chr, Cha, Chr, Ha, Aa^Feta, Aa^Fma, Aa^Fda, Aa^Fpa
Mm^Xm, Mm^Xm, Mm^Xm, Mm^Xm, Mm^Xm, Mm^Xm, Mm^Xm, Mm^Xm, Mm^Xm, Mm^Xm, Mm^Xm, Mm^Xm, Mm^Xm, Mm^Xm, Mm^Xm, Ms^Xm, Ms^Xm, Ms^Xm, Ms^Xm, Ms^Xm, Ms^Xm, Ms^Xm, Ms^Xm, Ha^Fma, Ha, Chr, Gd, Gll, Aa, Gd, Aa, Aa^Fpa, Gd^Esa, Aa, Ai^Bw/r, Ww, Ai, Ai, Aa^Fpa, Rb^Esa, Chr, Ha, Ha^Vca, Ha, Ha, Ms, Ms
Mm^Xm, Mm^Xm, Mm^Xm, Mm^Xm, Mm, Mm^Xm, Mm^Xm, Mm^Xm, Mm^Xm, Mm^Xm, Mm^Xm, Mm^Xm, Mm^Xm, Mm^Xm, Mm^Xm, Mm^Xm, Mm^Xm, Ms^Xm, Ms^Xm, Ms^Xm, Ms^Xm, Ms^Xm, Ms^Xm, Ha, Aa^Fpa, Aa, Aa, Gd, Aa^Fpa, Ha, Aa^Fpa, Gd^Esa, Gll, Aa^Fpa, Ha, Ha, Ww, Ai, Wo, Aa, Ha, Ha, Ha, Ha^Fda, Ms, Ms, Ms
Hhd, Mm^Xm, Mm^Xm, Mm^Xm, Mm, Mm, Mm, Mm^Xm, Mm^Xm, Mm^Xm, Mm^Xm, Mm^Xm, Mm^Xm, Mm, Mm, Mm, Mm, Mm^Xm, Ms^Xm, Ms^Xm, Ms^Xm, Ms^Xm, Ms, Ms, Aa, Aa, Re^Esa, Re, Cha, Aa^Fda, Gd^Esa, Aa, Aa^Fpa, Aa^Fpa, Aa^Fpa, Chr, Aa, Ai, Ai, Ai, Ai, Ha^Fda, Ms, Ms, Ms, Ms, Ms
Mm, Mm, Hhd, Mm, Mm, Mm, Mm, Hhd, Hhd, Mm^Xm, Mm^Xm, Mm^Xm, Mm^Xm, Mm, Mm, Mm, Ha, Mm, Ms, Ms^Xm, Ms, Ms, Ms, Ha, Aa^Fma, Aa^Fda, Aa^Fma, Re, Re, Aa, Aa, Aa^Fda, Aa^Fpa, Ha, Ha, Ha, Ha, Aa, Ha, Ai, Wo, Ai, Ai, Ms, Ms, Ms, Ms
Hhd, Mm, Hhd, Mm, Hhd, Mm, Mm, Hhd, Hhd, Mm, Mm, Mm, Mm, Mm, Mm, Ha, Ms, Ha, Ha^Fda, Ms, Ms, Ms, Ms, Ha, Aa^Feta, Aa^Fma, Aa^Fma, Gd, Re, Gll, Ms, Aa^Fpa, Ha, Ha, Ha^Fma, Ms, Ms, Ha^Fda, Aa, Aa, Ha, Ai, Wo, Aa^Fpa, Aa^Fpa, Ha^Fma, Ha^Fda
Hhd^Fmw, Mm, Hhd^Fmw, Hhd, Hhd^Fmw, Hhd, Hhd, Hhd^Fmw, Hhd^Fmw, Hhd, Ha^Fma, Mm, Ha, Mm, Ha, Ha, Ww, Ww, Ms, Ha, Ha^Fda, Ha, Ha^Fda, Ha, Ha, Aa^Fma, Re^Esa, Gd, Aa, Ha, Ms, Ha, Ha, Ms, Ms, Ms, Ms^Xm, Ms, Ha, Aa, Ms, Ai, Wo, Aa^Fpa, Ha, Ha^Fma, Ha^Fda
Hhd, Hhd, Gll^Fmw, Hhd^Fmw, Gll^Fmw, Hhd^Fmw, Gll^Fmw, Hhd, Gll^Fp, Hhd^Fmw, Re, Ha, Gs, Ha, Aa, Aa, Ww, Ha^Fda, Ha, Ms, Aa^Fdw, Ha, Ha, Aa^Fpa, Chr, Aa, Re, Re, Aa^Fpa, Aa^Fpa, Ha, Ha, Ha^Fma, Ms, Ms, Ms^Xm, Ms^Xm, Ms, Ms, Ha, Ha^Fda, Ww, Ai, Ha, Aa^Fpa, Ha, Ms
Gll^Fmw, Gll^Fmw, Gll^Fdw, Hhd^Fmw, Gd, Gll^Fmw, Gll, Gll^Fdw, Re, Re, Gd, Re, Re, Re, Re, Aa, Wwf, Ha, Ha, Aa^Fpa, Gll^Fp, Aa^Fma, Ha^Voa, Ha, Gll, Re^Esa, Re, Ha^Voa, Aa^Fda, Aa^Fma, Aa^Fpa, Ha, Ha, Ms, Ms, Ms, Ms, Ms^Xm, Ms, Ms, Ha^Fma, Ai, Ai, Ai, Aa^Fpa, Aa^Fpa, Ms
Gll^Fmw, Gll^Fmw, Ce, Ce, Ce, Gll, Re^Vct, Rp, Gs, Hhd, Gll, Gll^Esa, Aa^Fma, Gs, Chr, Gd, Wwf, Gs, Gs, Gll, Gll, Gd, Gd, Gs, Re, Re, Gll, Ha, Cha, Aa^Fma, Aa^Fda, Ha^Voa, Aa, Ha, Ms, Ms^Xm, Ms^Xm, Ms^Xm, Ms^Xm, Ms, Aa^Fpa, Aa^Fpa, Aa^Fpa, Ww, Ai, Ms, Ms
Hhd, Hhd, Gd, 1 Ke, Ce, Gd, Rp, Re, Hhd^Fmw, Hhd, Hhd, Aa^Fda, Aa^Fma, Aa^Fda, Gll, Gll, Re, Wwf, Re, Re^Esa, Aa, Re^Esa, Re, Re, Aa^Fdw, Re^Esa, Gd, Chr, 3 Khr, Cha, Aa^Fpa, Aa, Aa, Ha, Ha, Ms, Ms^Xm, Ms, Ms, Ms, Ms^Xm, Ms, Ha, Ww, Ai, Ww, Ai
Gll, Gd, Gd, Ce, Gll, Gd, Rr, Re^Vct, Hhd^Fmw, Hhd^Fmw, Hhd^Fmw, Aa^Fma, Gll, Gd, Gll^Esa, Gd, Gll, Wwf, Re, Gd^Fdw, Aa, Aa, Ha, Gd, Gll^Fmw, Aa, Gll^Esa, Cha, Chr, Chr, Ha, Aa^Fpa, Aa^Fma, Aa, Ha, Ms, Ms, Ms^Xm, Ms^Xm, Ms, Ms, Ms, Ha, Ha, Aa^Fpa, Ai, Ai
Rr, Re^Vct, Re, Re, Re, Rr, Hhd^Fdw, Hhd^Fdw, Ha^Fda, Aa, Aa, Gd, Gd^Fdw, Aa^Fda, Aa^Fda, Aa, Gd, Wwf, Ww, Hhd, Aa, Chr, Aa^Fma, Gd, Aa^Fda, Ha^Voa, Aa^Fdw, Aa, Aa, Ha, Ms^Vhha, Ha, Aa^Fma, Aa^Fma, Aa^Fpa, Ms, Ms, Ms^Xm, Ms^Xm, Ms^Xm, Ms, Ms, Ms, Aa^Fpa, Ms, Aa^Fpa, Ms
Gll^Fp, Rp, Gll, Re, Gll^Fmw, Gll^Fmw, Gll^Fp, Gll^Fdw, Gll^Fdw, Aa^Fma, Hhd, Gd, Gll^Fdw, Aa^Fda, Chr, Gd^Esa, Gll, Hhd, Ww, Gd^Fdw, Aa^Fpa, Aa^Fpa, Ha^Fda, Aa^Fda, Aa^Fdw, Ha, Ai, Ai, Aa^Fma, Aa, Aa, Aa^Fpa, Aa, Aa^Fpa, Aa, Ms, Ms, Ms^Xm, Ms, Ms^Xm, Ms^Xm, Ms, Ms^Xm, Ms^Xm, Ms^Xm, Ms^Xm, Ms^Xm
Hhd, Gll^Fmw, Gd, Gll^Fdw, Hhd, Gll^Fp, Mm^Xm, Gll^Fp, Gll^Fmw, Gll^Fp, Hhd, Gll^Fdw, Hhd, Aa^Fda, Aa, Ha, Aa^Fma, Ha, Ms, Ww, Ai, Ha, Aa^Fda, Aa^Fda, Aa^Fma, Ai, Ai, Ai, Aa^Fma, Aa^Fma, Aa^Fpa, Aa, Aa^Fpa, Aa^Fpa, Ha, Ha^Fma, Ha, Ms, Ms, Ms, Ms, Ms^Xm, Ms^Xm, Ms^Xm, Ms^Xm, Ms^Xm, Ms^Xm
Hhd, Gll, Hhd, Hhd, Hhd, Mm, Mm, Mm, Mm, Hhd, Hhd, Mm, Hhd, Ha, Aa^Fma, Aa^Fma, Aa^Fma, Ha, Aa^Fma, Ha, Ha, Ai, Ai, Ai, Ai, Ai, Ai, Ai, Ai, Aa^Fma, Aa, Aa, Ha, Ha, Ha, Ha, Ha, Ha, Ms, Ms, Ms^Xm, Ms^Xm, Ms^Xm, Ms^Xm, Ms^Xm, Ms^Xm, Ms^Xm
Hhd, Hhd, Hhd, Mm, Mm, Hhd, Mm, Mm, Mm^Xm, Mm, Mm^Xm, Mm, Ms, Ha, Ms, Ha, Ms^Xm, Ms, Ms^Xm, Ms^Xm, Ms^Xm, Ha, Ha, Ai, Ai, Ai, Ai, Ai, Ai, Aa, Ha, Aa, Aa, Ms, Ms, Ms, Ms, Ms, Ms, Ms^Xm, Ms^Xm, Ms^Xm, Ms^Xm, Ms^Xm, Ms^Xm, Ms^Xm, Ms^Xm
Hhd, Hhd, Mm, Mm, Mm, Mm^Xm, Mm^Xm, Mm^Xm, Mm^Xm, Mm^Xm, Mm, Mm^Xm, Ms^Xm, Ms^Xm, Ms^Xm, Ms, Ms, Ms, Ms, Ms, Ms, Ms, Gg, Ai, Ai, Ai, Ai, Ai, Ha, Ha, Ha, Ha, Ms, Ha, Ms, Ms, Ms, Ms, Ms, Ms, Ms^Xm, Ms^Xm, Ms^Xm, Ms^Xm, Ms^Xm, Ms^Xm, Ms^Xm
