Ms^Xm, Ms^Xm, Ms^Xm, Ms^Xm, Ms^Xm, Ms^Xm, Ms^Xm, Mm^Xm, Mm^Xm, Mm^Xm, Ms^Xm, Ms^Xm, Ms^Xm, Ms^Xm, Ms^Xm, Ms^Xm, Ms^Xm, Ms^Xm, Ms^Xm, Ms^Xm, Ms^Xm, Mm^Xm, Ms^Xm, Mm^Xm, Ms^Xm, Ms^Xm, Ms^Xm, Ms^Xm, Ms, Ms, Ha, Ai, Ai, Ha, Aa^Fda, Ha, Aa^Fpa, Ha, Ha, Ha, Ha, Ha, Ha^Fda, Aa, Aa, Ha, Ha
Ms^Xm, Ms^Xm, Ms^Xm, Ms^Xm, Ms^Xm, Ms^Xm, Ms^Xm, Mm^Xm, Mm^Xm, Ms^Xm, Ms^Xm, Ms^Xm, Ms^Xm, Ms^Xm, Ms^Xm, Ms^Xm, Ms^Xm, Ms^Xm, Ms^Xm, Ms^Xm, Ms^Xm, Ms^Xm, Ms^Xm, Ms^Xm, Ms^Xm, Ms^Xm, Ms^Xm, Ms^Xm, Ms, Ms, Ha^Fma, Ai, Ai, Ha, Aa^Fma, Aa^Fda, Aa^Fda, Aa^Feza, Aa^Fma, Aa^Fma, Ha, Ha^Fda, Aa^Fda, Aa, Aa^Fma, Ha^Fma, Ha
Mm^Xm, Ms^Xm, Ms^Xm, Ms^Xm, Ms^Xm, Ms^Xm, Mm^Xm, Mm^Xm, Mm^Xm, Ms^Xm, Mm^Xm, Ms^Xm, Ms^Xm, Ms^Xm, Mm^Xm, Ms^Xm, Ms^Xm, Ms^Xm, Ms^Xm, Ms^Xm, Ms^Xm, Ms^Xm, Ms^Xm, Ms^Xm, Ms^Xm, Ms^Xm, Ms^Xm, Ms^Xm, Ms, Ms, Ha, Ai, Ww, Ha, Ha^Fpa, Chr, Aa^Fma, Aa^Fda, Ha^Fda, Aa^Fda, Ha^Voa, Aa, Aa, Aa, Ha^Fda, Ai, Ms
Mm^Xm, Mm^Xm, Ms^Xm, Ms^Xm, Ms^Xm, Mm^Xm, Mm^Xm, Ms^Xm, Mm^Xm, Mm^Xm, Mm^Xm, Mm^Xm, Mm^Xm, Mm^Xm, Mm^Xm, Mm^Xm, Ms^Xm, Ms^Xm, Ms^Xm, Ms^Xm, Ms^Xm, Ms^Xm, Ms^Xm, Ms^Xm, Ms, Ms^Xm, Ms, Ms, Ms, Ms, Aa^Fpa, Ha, Ai, Ai, Ai, Aa^Fpa, Ha, Aa^Fda, Aa, Aa, Aa, Aa, Aa, Ha^Fda, Ms, Ha, Ms
Mm^Xm, Mm^Xm, Mm^Xm, Ms^Xm, Mm^Xm, Mm^Xm, Ms^Xm, Mm^Xm, Mm^Xm, Ms^Xm, Mm^Xm, Mm^Xm, Mm^Xm, Mm^Xm, Mm^Xm, Ms^Xm, Ms^Xm, Ms^Xm, Ms^Xm, Ms^Xm, Ms^Xm, Ms^Xm, Ms^Xm, Ms, Ms, Ms, Ms, Ms, Ms, Ms, Aa^Fda, Aa^Fma, Ha, Ai, Ww, Aa^Fpa, Cha, Aa, Cha, Aa^Fdw, Cha, Aa, Aa^Fda, Aa, Aa^Fpa, Ms, Aa^Fpa
Mm^Xm, Mm^Xm, Mm^Xm, Mm^Xm, Mm^Xm, Mm^Xm, Ms^Xm, Mm^Xm, Mm^Xm, Mm^Xm, Mm^Xm, Mm^Xm, Mm^Xm, Mm^Xm, Mm^Xm, Mm^Xm, Mm^Xm, Ms^Xm, Mm^Xm, Ms^Xm, Ms^Xm, Ms^Xm, Ms, Ms, Ms, Ms, Ms, Ms, Ha, Ha, Ha^Fda, Ha, Aa^Fpa, Ai, Ai, Aa^Fpa, Aa^Fpa, Aa, Aa^Vca, Cha, 2 Kha, Cha, Aa^Fma, Aa^Fma, Aa^Fda, Aa^Fpa, Aa^Fpa
Mm^Xm, Mm^Xm, Mm^Xm, Mm^Xm, Mm^Xm, Mm^Xm, Mm^Xm, Mm^Xm, Mm^Xm, Mm^Xm, Mm^Xm, Mm^Xm, Mm^Xm, Mm^Xm, Mm^Xm, Mm^Xm, Ms^Xm, Mm^Xm, Ms^Xm, Ms^Xm, Ms^Xm, Ms^Xm, Ms, Ms, Ha, Ha, Aa^Fma, Aa^Fpa, Gd, Aa, Aa^Fda, Ha, Ha, Aa, Ai, Ai, Ai, Aa, Aa, Chr, Cha, Chr, Ha, Aa^Feza, Aa^Fma, Aa^Fda, Aa^Fpa
Mm^Xm, Mm^Xm, Mm^Xm, Mm^Xm, Mm^Xm, Mm^Xm, Mm^Xm, Mm^Xm, Mm^Xm, Mm^Xm, Mm^Xm, Mm^Xm, Mm^Xm, Mm^Xm, Mm^Xm, Mm^Xm, Mm^Xm, Ms^Xm, Ms^Xm, Ms^Xm, Ms^Xm, Ms^Xm, Ms^Xm, Ha^Fma, Ha, Chr, Gd, Gll, Aa, Gd, Aa, Aa^Fpa, Gd, Ha, Ha^Voa, Ai, Ai, Ai, Aa^Fpa, Aa, Chr, Ha, Ha^Vca, Ha, Ha, Ms, Ms
Mm^Xm, Mm^Xm, Mm^Xm, Mm^Xm, Mm, Mm^Xm, Mm^Xm, Mm^Xm, Mm^Xm, Mm^Xm, Mm^Xm, Mm^Xm, Mm^Xm, Mm^Xm, Mm^Xm, Mm^Xm, Mm^Xm, Mm^Xm, Ms^Xm, Ms^Xm, Ms^Xm, Ms^Xm, Ms^Xm, Ha, Aa^Fpa, Aa, Aa, Gd, Aa^Fpa, Ha, Aa^Fpa, Gd, Gll, Aa^Fpa, Ha, Ha, Ww, Ai, Ai, Aa, Ha, Ha, Ha, Ha^Fda, Ms, Ms, Ms
Hhd, Mm^Xm, Mm^Xm, Mm^Xm, Mm, Mm, Mm, Mm^Xm, Mm^Xm, Mm^Xm, Mm^Xm, Mm^Xm, Mm^Xm, Mm, Mm, Mm, Mm, Mm^Xm, Ms^Xm, Ms^Xm, Ms^Xm, Ms^Xm, Ms, Ms, Aa, Aa, Aa, Aa, Cha, Aa^Fda, Gd, Aa, Aa^Fpa, Aa^Fpa, Aa^Fpa, Chr, Aa, Ai, Ai, Ai, Ww, Ha^Fda, Ms, Ms, Ms, Ms, Ms
Mm, Mm, Hhd, Mm, Mm, Mm, Mm, Hhd, Hhd, Mm^Xm, Mm^Xm, Mm^Xm, Mm^Xm, Mm, Mm, Mm, Ha, Mm, Ms, Ms^Xm, Ms, Ms, Ms, Ha, Aa^Fma, Aa^Fda, Aa^Fma, Aa, Aa, Aa, Aa, Aa^Fda, Aa^Fpa, Ha, Ha, Ha, Ha, Aa, Ha, Ai, Ai, Ai, Ai, Ms, Ms, Ms, Ms
Hhd, Mm, Hhd, Mm, Hhd, Mm, Mm, Hhd, Hhd, Mm, Mm, Mm, Mm, Mm, Mm, Ha, Ms, Ha, Ha^Fda, Ms, Ms, Ms, Ms, Ha, Aa^Feza, Aa^Fma, Aa^Fma, Gd, Gd, Gll, Ms, Aa^Fpa, Ha, Ha, Ha^Fma, Ms, Ms, Ha^Fda, Aa, Aa, Ha, Ww, Ww, Aa^Fpa, Aa^Fpa, Ha^Fma, Ha^Fda
Hhd^Fmw, Mm, Hhd^Fmw, Hhd, Hhd^Fmw, Hhd, Hhd, Hhd^Fmw, Hhd^Fmw, Hhd, Ha^Fma, Mm, Ha, Mm, Ha, Ha, Ha, Ha, Ms, Ha, Ha^Fda, Ha, Ha^Fda, Ha, Ha, Aa^Fma, Re, Gd, Aa, Ha, Ms, Ha, Ha, Ms, Ms, Ms, Ms^Xm, Ms, Ha, Aa, Ms, Ai, Ww, Aa^Fpa, Ha, Ha^Fma, Ha^Fda
Hhd, Hhd, Gll^Fmw, Hhd^Fmw, Gll^Fmw, Hhd^Fmw, Gll^Fmw, Hhd, Gll^Fp, Hhd^Fmw, Re, Ha, Gs, Ha, Aa, Aa, Gd, Ha^Fda, Ha, Ms, Aa^Fdw, Ha, Ha, Aa^Fpa, Chr, Aa, Aa, Aa, Aa^Fpa, Aa^Fpa, Ha, Ha, Ha^Fma, Ms, Ms, Ms^Xm, Ms^Xm, Ms, Ms, Ha, Ha^Fda, Ai, Ai, Ha, Aa^Fpa, Ha, Ms
Gll^Fmw, Gll^Fmw, Gll^Fdw, Hhd^Fmw, Gd, Gll^Fmw, Gll, Gll^Fdw, Re, Re, Gd, Re, Re, Re, Re, Aa, Gll, Ha, Ha, Aa^Fpa, Gll^Fp, Aa^Fma, Ha^Voa, Ha, Aa^Fpa, Aa, Aa, Ha^Voa, Aa^Fda, Aa^Fma, Aa^Fpa, Ha, Ha, Ms, Ms, Ms, Ms, Ms^Xm, Ms, Ms, Ha^Fma, Ww, Ai, Ai, Aa^Fpa, Aa^Fpa, Ms
Gll^Fmw, Gll^Fmw, Ce, Ce, Ce, Gll, Re^Vct, Rp, Gs, Hhd, Gll, Gll, Aa^Fma, Gs, Chr, Gd, Gll, Gs, Gs, Gll, Gll, Gd, Gd, Gs, Re, Aa^Fpa, Aa, Ha, Cha, Aa^Fma, Aa^Fda, Ha^Voa, Aa, Ha, Ms, Ms^Xm, Ms^Xm, Ms^Xm, Ms^Xm, Ms, Aa^Fpa, Aa^Fpa, Aa^Fpa, Ai, Ai, Ms, Ms
Hhd, Hhd, Gd, 1 Ke, Ce, Gd, Rp, Re, Hhd^Fmw, Hhd, Hhd, Aa^Fda, Aa^Fma, Aa^Fda, Gll, Gll, Aa, Re, Re, Re, Aa, Re, Re, Re, Aa^Fdw, Aa, Gd, Chr, 3 Khr, Cha, Aa^Fpa, Aa, Aa, Ha, Ha, Ms, Ms^Xm, Ms, Ms, Ms, Ms^Xm, Ms, Ha, Ww, Ai, Ww, Ai
Gll, Gd, Gd, Ce, Gll, Gd, Rr, Re^Vct, Hhd^Fmw, Hhd^Fmw, Hhd^Fmw, Aa^Fma, Gll, Gd, Gll, Gd, Gll, Gd, Aa^Fma, Aa^Fma, Aa, Aa, Ha, Gd, Gll^Fmw, Aa, Gll, Cha, Chr, Chr, Ha, Aa^Fpa, Aa^Fma, Aa, Ha, Ms, Ms, Ms^Xm, Ms^Xm, Ms, Ms, Ms, Ha, Ha, Aa^Fpa, Ai, Ai
Rr, Re^Vct, Re, Re, Re, Rr, Hhd^Fdw, Hhd^Fdw, Ha^Fda, Aa, Aa, Gd, Gd^Fdw, Aa^Fda, Aa^Fda, Aa, Gd, Aa, Ha^Fda, Ha, Aa, Chr, Aa^Fma, Gd, Aa^Fda, Ha^Voa, Aa^Fdw, Aa, Aa, Ha, Ms^Vhha, Ha, Aa^Fma, Aa^Fma, Aa^Fpa, Ms, Ms, Ms^Xm, Ms^Xm, Ms^Xm, Ms, Ms, Ms, Aa^Fpa, Ms, Aa^Fpa, Ms
Gll^Fp, Rp, Gll, Re, Gll^Fmw, Gll^Fmw, Gll^Fp, Gll^Fdw, Gll^Fdw, Aa^Fma, Hhd, Gd, Gll^Fdw, Aa^Fda, Chr, Gd, Gll, Ha, Aa^Fma, Aa^Fma, Aa^Fpa, Aa^Fpa, Ha^Fda, Aa^Fda, Aa^Fdw, Ha, Ai, Ai, Aa^Fma, Aa, Aa, Aa^Fpa, Aa, Aa^Fpa, Aa, Ms, Ms, Ms^Xm, Ms, Ms^Xm, Ms^Xm, Ms, Ms^Xm, Ms^Xm, Ms^Xm, Ms^Xm, Ms^Xm
Hhd, Gll^Fmw, Gd, Gll^Fdw, Hhd, Gll^Fp, Mm^Xm, Gll^Fp, Gll^Fmw, Gll^Fp, Hhd, Gll^Fdw, Ha^Fda, Aa^Fda, Aa, Ha, Aa^Fma, Ha, Ms, Aa^Fpa, Ha, Ha, Aa^Fda, Aa^Fda, Aa^Fma, Ai, Ai, Ai, Aa^Fma, Aa^Fma, Aa^Fpa, Aa, Aa^Fpa, Aa^Fpa, Ha, Ha^Fma, Ha, Ms, Ms, Ms, Ms, Ms^Xm, Ms^Xm, Ms^Xm, Ms^Xm, Ms^Xm, Ms^Xm
Hhd, Gll, Hhd, Hhd, Hhd, Mm, Mm, Mm, Hhd, Hhd, Hhd, Mm, Ha, Ha, Aa^Fma, Aa^Fma, Aa^Fma, Ha, Aa^Fma, Aa, Aa^Fma, Aa^Fma, Ai, Ai, Ai, Ai, Ai, Ai, Ai, Aa^Fma, Aa, Aa, Ha, Ha, Ha, Ha, Ha, Ha, Ms, Ms, Ms^Xm, Ms^Xm, Ms^Xm, Ms^Xm, Ms^Xm, Ms^Xm, Ms^Xm
