border_size=1
usage=map

Ms^Xm       , Ms^Xm       , Ms^Xm       , Ms^Xm       , Ms^Xm       , Ms^Xm       , Ms^Xm       , Mm^Xm       , Mm^Xm       , Mm^Xm       , Ms^Xm       , Ms^Xm       , Ms^Xm       , Ms^Xm       , Ms^Xm       , Ms^Xm       , Ms^Xm       , Ms^Xm       , Ms^Xm       , Ms^Xm       , Ms^Xm       , Mm^Xm       , Ms^Xm       , Mm^Xm       , Ms^Xm       , Ms^Xm       , Ms^Xm       , Ms^Xm       , Ms          , Ms          , Ha          , Ai          , Ai          , Ha          , Aa^Fda      , Ha          , Aa^Fpa      , Ha          , Ha          , Ha          , Ha          , Aa          , Ha          , Aa^Fma      , Ha          , Ha          , Ha          
Ms^Xm       , Ms^Xm       , Ms^Xm       , Ms^Xm       , Ms^Xm       , Ms^Xm       , Ms^Xm       , Mm^Xm       , Mm^Xm       , Ms^Xm       , Ms^Xm       , Ms^Xm       , Ms^Xm       , Ms^Xm       , Ms^Xm       , Ms^Xm       , Ms^Xm       , Ms^Xm       , Ms^Xm       , Ms^Xm       , Ms^Xm       , Ms^Xm       , Ms^Xm       , Ms^Xm       , Ms^Xm       , Ms^Xm       , Ms^Xm       , Ms^Xm       , Ms          , Ms          , Ha          , Ai          , Ai          , Ha          , Aa^Fma      , Aa^Fda      , Aa^Fdw      , Aa^Fdw      , Aa^Fma      , Aa^Fma      , Ha          , Ha          , Aa          , Aa^Fma      , Aa^Fma      , Ha          , Ha          
Mm^Xm       , Ms^Xm       , Ms^Xm       , Ms^Xm       , Ms^Xm       , Ms^Xm       , Mm^Xm       , Mm^Xm       , Mm^Xm       , Ms^Xm       , Mm^Xm       , Ms^Xm       , Ms^Xm       , Ms^Xm       , Mm^Xm       , Ms^Xm       , Ms^Xm       , Ms^Xm       , Ms^Xm       , Ms^Xm       , Ms^Xm       , Ms^Xm       , Ms^Xm       , Ms^Xm       , Ms^Xm       , Ms^Xm       , Ms^Xm       , Ms^Xm       , Ms          , Ms          , Ha          , Ai          , Ai          , Ha          , Ha          , Chr         , Aa^Fma      , Aa^Fda      , Ha^Fdw      , Aa^Fdw      , Ha^Voa      , Aa          , Aa^Fdw      , Aa^Fpa      , Ha          , Ai          , Ms          
Mm^Xm       , Mm^Xm       , Ms^Xm       , Ms^Xm       , Ms^Xm       , Mm^Xm       , Mm^Xm       , Ms^Xm       , Mm^Xm       , Mm^Xm       , Mm^Xm       , Mm^Xm       , Mm^Xm       , Mm^Xm       , Mm^Xm       , Mm^Xm       , Ms^Xm       , Ms^Xm       , Ms^Xm       , Ms^Xm       , Ms^Xm       , Ms^Xm       , Ms^Xm       , Ms^Xm       , Ms          , Ms^Xm       , Ms          , Ms          , Ms          , Ms          , Aa^Fpa      , Ha          , Ai          , Ai          , Ai          , Aa^Fpa      , Ha          , Aa^Fdw      , Aa          , Aa          , Aa          , Aa          , Ha          , Ha          , Ms          , Ha          , Ms          
Mm^Xm       , Mm^Xm       , Mm^Xm       , Ms^Xm       , Mm^Xm       , Mm^Xm       , Ms^Xm       , Mm^Xm       , Mm^Xm       , Ms^Xm       , Mm^Xm       , Mm^Xm       , Mm^Xm       , Mm^Xm       , Mm^Xm       , Ms^Xm       , Ms^Xm       , Ms^Xm       , Ms^Xm       , Ms^Xm       , Ms^Xm       , Ms^Xm       , Ms^Xm       , Ms          , Ms          , Ms          , Ms          , Ms          , Ms          , Ms          , Aa^Fdw      , Aa^Fpa      , Ha          , Ai          , Ai          , Aa^Fpa      , Chr         , Aa          , Cha         , Aa^Fdw      , Cha         , Ha          , Aa^Fdw      , Aa          , Aa^Fpa      , Ms          , Aa^Fpa      
Mm^Xm       , Mm^Xm       , Mm^Xm       , Mm^Xm       , Mm^Xm       , Mm^Xm       , Ms^Xm       , Mm^Xm       , Mm^Xm       , Mm^Xm       , Mm^Xm       , Mm^Xm       , Mm^Xm       , Mm^Xm       , Mm^Xm       , Mm^Xm       , Mm^Xm       , Ms^Xm       , Mm^Xm       , Ms^Xm       , Ms^Xm       , Ms^Xm       , Ms          , Ms          , Ms          , Ms          , Ms          , Ms          , Ha          , Ha          , Ha          , Ha          , Aa^Fpa      , Ai          , Ai          , Aa^Fpa      , Aa^Fpa      , Aa          , Aa^Vca      , Cha         , 2 Khr       , Cha         , Aa^Fmw      , Aa^Fmw      , Aa^Fpa      , Aa^Fpa      , Aa^Fpa      
Mm^Xm       , Mm^Xm       , Mm^Xm       , Mm^Xm       , Mm^Xm       , Mm^Xm       , Mm^Xm       , Mm^Xm       , Mm^Xm       , Mm^Xm       , Mm^Xm       , Mm^Xm       , Mm^Xm       , Mm^Xm       , Mm^Xm       , Mm^Xm       , Ms^Xm       , Mm^Xm       , Ms^Xm       , Ms^Xm       , Ms^Xm       , Ms^Xm       , Ms          , Ms          , Ha          , Ha          , Aa^Fma      , Aa^Fpa      , Aa          , Aa          , Aa^Fdw      , Ha          , Ha          , Aa          , Ai          , Ai          , Ai          , Aa          , Aa          , Chr         , Cha         , Chr         , Ha          , Aa          , Aa^Fpa      , Aa^Fpa      , Aa^Fpa      
Mm^Xm       , Mm^Xm       , Mm^Xm       , Mm^Xm       , Mm^Xm       , Mm^Xm       , Mm^Xm       , Mm^Xm       , Mm^Xm       , Mm^Xm       , Mm^Xm       , Mm^Xm       , Mm^Xm       , Mm^Xm       , Mm^Xm       , Mm^Xm       , Mm^Xm       , Ms^Xm       , Ms^Xm       , Ms^Xm       , Ms^Xm       , Ms^Xm       , Ms^Xm       , Ha          , Ha          , Chr         , Gll         , Gll         , Aa          , Gll         , Aa          , Aa^Fpa      , Gll         , Ha          , Ha^Vhha     , Ai          , Ai          , Ai          , Aa^Fpa      , Aa          , Chr         , Ha          , Ha^Vca      , Ha          , Ha          , Ms          , Ms          
Mm^Xm       , Mm^Xm       , Mm^Xm       , Mm^Xm       , Mm          , Mm^Xm       , Mm^Xm       , Mm^Xm       , Mm^Xm       , Mm^Xm       , Mm^Xm       , Mm^Xm       , Mm^Xm       , Mm^Xm       , Mm^Xm       , Mm^Xm       , Mm^Xm       , Mm^Xm       , Ms^Xm       , Ms^Xm       , Ms^Xm       , Ms^Xm       , Ms^Xm       , Ha          , Aa^Fpa      , Aa          , Aa          , Gll         , Aa^Fpa      , Ha          , Aa^Fpa      , Gll         , Gll         , Aa^Fpa      , Ha          , Ha          , Ai          , Ai          , Ai          , Aa          , Ha          , Ha          , Ha          , Ha          , Ms          , Ms          , Ms          
Hh          , Mm^Xm       , Mm^Xm       , Mm^Xm       , Mm          , Mm          , Mm          , Mm^Xm       , Mm^Xm       , Mm^Xm       , Mm^Xm       , Mm^Xm       , Mm^Xm       , Mm          , Mm          , Mm          , Mm          , Mm^Xm       , Ms^Xm       , Ms^Xm       , Ms^Xm       , Ms^Xm       , Ms          , Ms          , Aa          , Aa          , Aa          , Aa          , Chr         , Aa^Fdw      , Gll         , Aa          , Aa^Fpa      , Aa^Fpa      , Aa^Fpa      , Chw         , Aa          , Ai          , Ai          , Ai          , Ai          , Ha          , Ms          , Ms          , Ms          , Ms          , Ms          
Mm          , Mm          , Hh          , Mm          , Mm          , Mm          , Mm          , Hh          , Hh          , Mm^Xm       , Mm^Xm       , Mm^Xm       , Mm^Xm       , Mm          , Mm          , Mm          , Ha          , Mm          , Ms          , Ms^Xm       , Ms          , Ms          , Ms          , Ha          , Aa^Fma      , Aa^Fdw      , Aa^Fma      , Aa          , Aa          , Aa          , Aa          , Aa^Fdw      , Aa^Fpa      , Ha          , Ha          , Ha          , Ha          , Aa          , Ha          , Ai          , Ai          , Ai          , Ai          , Ms          , Ms          , Ms          , Ms          
Hh          , Mm          , Hh          , Mm          , Hh          , Mm          , Mm          , Hh          , Hh          , Mm          , Mm          , Mm          , Mm          , Mm          , Mm          , Ha          , Ms          , Ha          , Ha          , Ms          , Ms          , Ms          , Ms          , Ha          , Aa^Fma      , Aa^Fmw      , Aa^Fma      , Gll         , Gll         , Gll         , Ms          , Aa^Fpa      , Ha          , Ha          , Ha          , Ms          , Ms          , Ha          , Aa          , Aa          , Ha          , Ai          , Ai          , Aa^Fpa      , Aa^Fpa      , Ha          , Ha          
Hh^Fmw      , Mm          , Hh^Fmw      , Hh          , Hh^Fmw      , Hh          , Hh          , Hh^Fmw      , Hh^Fmw      , Hh          , Ha^Fma      , Mm          , Ha          , Mm          , Ha          , Ha          , Ha          , Ha          , Ms          , Ha          , Ha          , Ha          , Ha          , Ha          , Ha          , Aa^Fmw      , Re          , Gll         , Aa          , Ha          , Ms          , Ha          , Ha          , Ms          , Ms          , Ms          , Ms^Xm       , Ms          , Ha          , Aa          , Ms          , Ai          , Ai          , Aa^Fpa      , Ha          , Ha          , Ha          
Hh          , Hh          , Gll^Fmw     , Hh^Fmw      , Gll^Fmw     , Hh^Fmw      , Gll^Fmw     , Hh          , Gll^Fp      , Hh^Fmw      , Re          , Ha          , Gs          , Ha          , Aa          , Aa          , Gll         , Ha^Fdw      , Ha          , Ms          , Aa^Fdw      , Ha          , Ha          , Aa^Fpa      , Chr         , Aa          , Aa          , Aa          , Aa^Fpa      , Aa^Fpa      , Ha          , Ha          , Ha          , Ms          , Ms          , Ms^Xm       , Ms^Xm       , Ms          , Ms          , Ha          , Ha          , Ai          , Ai          , Ha          , Aa^Fpa      , Ha          , Ms          
Gll^Fmw     , Gll^Fmw     , Gll^Fdw     , Hh^Fmw      , Aa          , Gll^Fmw     , Gll         , Gll^Fdw     , Re          , Re          , Gll         , Re          , Re          , Re          , Re          , Aa          , Gll         , Ha          , Ha          , Aa^Fpa      , Gll^Fp      , Aa^Fmw      , Ha^Voa      , Ha          , Aa^Fpa      , Aa          , Aa          , Ha^Voa      , Aa^Fdw      , Aa^Fmw      , Aa^Fpa      , Ha          , Ha          , Ms          , Ms          , Ms          , Ms          , Ms^Xm       , Ms          , Ms          , Ha          , Ai          , Ai          , Ai          , Aa^Fpa      , Aa^Fpa      , Ms          
Gll^Fmw     , Gll^Fmw     , Ce          , Ce          , Ce          , Gll         , Re^Vct      , Rp          , Gs          , Hh          , Gll         , Gll         , Aa^Fma      , Gs          , Chr         , Gll         , Gll         , Gs          , Gs          , Gll         , Gll         , Gll         , Gll         , Gs          , Re          , Aa^Fpa      , Aa          , Ha          , Cha         , Aa^Fmw      , Aa^Fdw      , Ha^Voa      , Aa          , Ha          , Ms          , Ms^Xm       , Ms^Xm       , Ms^Xm       , Ms^Xm       , Ms          , Aa^Fpa      , Aa^Fpa      , Aa^Fpa      , Ai          , Ai          , Ms          , Ms          
Hh          , Hh          , Aa          , 1 Ke        , Ce          , Gll         , Rp          , Re          , Hh^Fmw      , Hh          , Hh          , Aa^Fda      , Aa^Fma      , Aa^Fda      , Gll         , Gll         , Aa          , Re          , Re          , Re          , Aa          , Re          , Re          , Re          , Aa^Fdw      , Aa          , Gll         , Chr         , 3 Khr       , Cha         , Aa^Fpa      , Aa          , Aa          , Ha          , Ha          , Ms          , Ms^Xm       , Ms          , Ms          , Ms          , Ms^Xm       , Ms          , Ha          , Ai          , Ai          , Ai          , Ai          
Gll         , Aa          , Aa          , Ce          , Gll         , Gll         , Rr          , Re^Vct      , Hh^Fmw      , Hh^Fmw      , Hh^Fmw      , Aa^Fma      , Gll         , Gll         , Gll         , Gll         , Gll         , Gll         , Aa^Fma      , Aa^Fma      , Aa          , Aa          , Ha          , Gll         , Gll^Fmw     , Aa          , Gll         , Cha         , Chr         , Chr         , Ha          , Aa^Fpa      , Aa^Fdw      , Aa          , Ha          , Ms          , Ms          , Ms^Xm       , Ms^Xm       , Ms          , Ms          , Ms          , Ha          , Ha          , Aa^Fpa      , Ha          , Ai          
Rr          , Re^Vct      , Re          , Re          , Re          , Rr          , Hh^Fdw      , Hh^Fdw      , Ha^Fdw      , Aa          , Aa          , Gll         , Gll^Fda     , Aa^Fda      , Aa^Fda      , Aa          , Gll         , Aa          , Ha          , Ha          , Aa          , Chr         , Aa^Fmw      , Gll         , Aa^Fda      , Ha^Voa      , Aa^Fdw      , Aa          , Aa          , Ha          , Ms^Vhha     , Ha          , Aa^Fmw      , Aa^Fmw      , Aa^Fpa      , Ms          , Ms          , Ms^Xm       , Ms^Xm       , Ms^Xm       , Ms          , Ms          , Ms          , Aa^Fpa      , Ms          , Aa^Fpa      , Ms          
Gll^Fp      , Rp          , Gll         , Re          , Gll^Fmw     , Gll^Fmw     , Gll^Fp      , Gll^Fma     , Gll^Fma     , Aa^Fma      , Hh          , Gll         , Gll^Fdw     , Aa^Fda      , Chr         , Gll         , Gll         , Ha          , Aa^Fma      , Aa^Fma      , Aa^Fpa      , Aa^Fmw      , Ha^Fda      , Aa^Fda      , Aa^Fdw      , Ha          , Ai          , Ai          , Aa^Fmw      , Aa          , Aa          , Aa^Fpa      , Aa          , Aa^Fpa      , Aa          , Ms          , Ms          , Ms^Xm       , Ms          , Ms^Xm       , Ms^Xm       , Ms          , Ms^Xm       , Ms^Xm       , Ms^Xm       , Ms^Xm       , Ms^Xm       
Hh          , Gll^Fmw     , Gll         , Gll^Fda     , Hh          , Gll^Fp      , Mm^Xm       , Gll^Fp      , Gll^Fmw     , Gll^Fp      , Hh          , Gll^Fdw     , Ha          , Aa^Fda      , Aa          , Ha          , Aa^Fma      , Ha          , Ms          , Aa^Fpa      , Ha          , Ha          , Aa^Fda      , Aa^Fda      , Aa^Fma      , Ai          , Ai          , Ai          , Aa^Fma      , Aa^Fdw      , Aa^Fpa      , Aa          , Aa^Fpa      , Aa^Fpa      , Ha          , Ha          , Ha          , Ms          , Ms          , Ms          , Ms          , Ms^Xm       , Ms^Xm       , Ms^Xm       , Ms^Xm       , Ms^Xm       , Ms^Xm       
Hh          , Gll         , Hh          , Hh          , Hh          , Mm          , Mm          , Mm          , Hh          , Hh          , Hh          , Mm          , Ha          , Ha          , Aa^Fma      , Aa^Fma      , Aa^Fma      , Ha          , Aa^Fma      , Aa          , Aa^Fma      , Aa^Fma      , Ai          , Ai          , Ai          , Ai          , Ai          , Ai          , Ai          , Aa^Fmw      , Aa          , Aa          , Ha          , Ha          , Ha          , Ha          , Ha          , Ha          , Ms          , Ms          , Ms^Xm       , Ms^Xm       , Ms^Xm       , Ms^Xm       , Ms^Xm       , Ms^Xm       , Ms^Xm       
