border_size=1
usage=map

Gs^Fp, Gll^Fp, Gll^Fp, Gll^Fp, Gs^Fp, Gs^Fp, Gll^Fp, Gll^Fp, Gll^Fp, Gs^Fp, Hh, Hh, Hh, Hh, Gs^Fp, Gg, Re, Re, Gg, Gg, Gs^Fp, Gs^Fp, Gs^Fp, Gs^Fp, Hh, Hh, Gs^Fp, Gs^Fp, Gll^Fp, Gll^Fp, Gll^Fp, Gs^Fp, Gs^Fp, Gs^Fp, Gs^Fp, Gs^Fp, Hh, Hh, Mm, Mm, Mm, Mm, Mm, Mm, Hh^Fp, Hh^Fp, Gs^Fp, Gs^Fp, Gg, Gg, Re, Re, Gg, Gs^Fp, Gs^Fp, Mm, Gs^Fp, Hh, Mm, Mm, Mm, Mm, Mm, Mm, Hh, Hh, Gs^Fp, Ww, Ww
Hh, Gs^Fp, Hh, Gll^Fp, Gll^Fp, Gll^Fp, Gll^Fp, Gll^Fp, Gll^Fp, Gs^Fp, Hh, Hh, Gg^Vl, Gs^Fp, Gg^Em, Gg, Gs^Fp, Gg, Gs^Fp, Gg, Hh^Fp, Gs^Fp, Gs^Fp, Gs^Fp, Hh, Gs^Fp, Gs^Fmw, Gll^Fp, Gs^Fmw, Gll^Fp, Gll^Fp, Gll^Fp, Gs^Fp, Gs^Fp, Hh^Fp, Hh, Hh, Hh, Hh, Hh, Mm, Mm, Mm, Mm, Hh, Hh^Fp, Gs^Fp, Gg^Es, Re, Re, Gs^Fp, Gg, Gll^Fp, Gll^Fp, Gs^Fp, Gs^Fp, Gg^Em, Mm, Hh, Mm, Hh, Mm, Mm, Hh, Gll^Fp, Gs^Fp, Ww, Ww, Gs^Fp
Hh^Fmw, Hh, Hh^Fp, Hh^Fp, Gs^Fp, Gll^Fp, Gll^Fmw, Gll^Fp, Hh^Fmw, Hh^Fp, Hh^Fmw, Hh, Gs^Fp, Gs^Fp, Gg, Re, Gs^Fp, Gg, Gs^Fp, Gs^Fmw, Hh^Fp, Hh^Fp, Hh^Fp, Hh, Hh, Gs^Fmw, Gs^Fmw, Gs^Fp, Gll^Fp, Gll^Fmw, Gll^Fmw, Gs^Fp, Gll^Fmw, Gs^Fmw, Hh, Hh^Fp, Hh, Hh^Fp, Hh, Mm, Mm^Vhh, Mm, Hh^Fp, Mm, Hh, Gs^Fp, Gs^Fp, Gs^Fp, Re, Gs^Fp, Gll^Fp, Gs^Fp, Gs^Fp, Gll^Fp, Gs^Fp, Gs^Fp, Gll^Fp, Gg, Hh, Mm, Gs^Fp, Hh, Hh, Hh, Gs^Fp, Gs^Fp, Ww, Gs^Fp, Gs^Fp
Hh^Fp, Hh^Fmw, Hh^Fp, Hh^Fmw, Hh^Fp, Gll^Fp, Gll^Fp, Hh^Fp, Hh^Fmw, Hh^Fp, Hh, Hh^Fmw, Gs^Fp, Gs^Fp, Gg^Es, Re, Gg, Gg, Gs^Fp, Hh, Hh, Hh, Hh^Fmw, Hh^Fp, Hh, Hh, Gs^Fmw, Gs^Fmw, Gs^Fp, Gs^Fp, Gs^Fp, Gll^Fp, Gs^Fmw, Hh^Fp, Gs^Fmw, Hh^Fp, Hh, Hh, Mm, Mm, Hh, Hh^Fp, Hh^Fp, Mm, Hh, Gg, Gg, Gs^Fp, Re, Gs^Fp, Gg, Gs^Fp, Gg, Gg^Efm, Gg^Efm, Gs^Fp, Gg^Em, Gg, Hh, Hh, Gll^Fp, Gs^Fp, Hh, Gs^Fp, Ww, Ww, Gll^Fp, Gll^Fp, Gll^Fp
Hh, Hh^Fp, Hh^Fmw, Hh, Gs^Fp, Gll^Fp, Gll^Fmw, Gs^Fmw, Gs^Fp, Hh^Fp, Gs^Fp, Gs^Fp, Gs^Fp, Gs^Fp, Gg, Gg, Re, Gg^Efm, Gs^Fp, Gs^Fp, Gs^Fp, Hh^Fmw, Hh^Fmw, Hh, Hh, Gs^Fp, Rp, Gs^Fp, Gs^Fp, Hh^Fp, Gll^Fp, Gs^Fmw, Hh^Fp, Hh^Fp, Gll^Fp, Hh^Fp, Hh^Fdw, Gs^Fmw, Mm, Mm, Hh, Hh, Gg, Hh, Gg, Gg, Re, Re, Gg, Gs^Fp, Gg, Gg, Gg^Vh, Gg, Gg^Efm, Gg, Gs^Fp, Gg^Em, Gg, Gll^Fp, Gs^Fp, Gg, Gs^Fp, Gs^Fp, Ww, Ww, Gs^Fp, Gll^Fp, Gll^Fp
Hh, Hh^Fmw, Gs^Fp, Gs^Fp, Gll^Fp, Gll^Fp, Gll^Fp, Gll^Fmw, Gll^Fp, Gs^Fp, Gll^Fp, Gs^Fp, Gs^Fp, Gg^Efm, Gs^Fdw, Gs^Fmw, Re, Gs^Fp, Gs^Fmw, Gs^Fmw, Gs^Fp, Gs^Fp, Hh^Fmw, Gs^Fmw, Rp, Rp, Gs^Fp, Gs^Fp, Gs^Fmw, Gll^Fp, Gs^Fp, Hh^Fp, Gll^Fmw, Gs^Fmw, Gll^Fmw, Gll^Fmw, Gs^Fmw, Gs^Fmw, Hh, Hh, Gs^Fp, Hh^Fp, Gs^Fp, Gg, Re, Re, Gg, Gg, Gg^Efm, Gg, Ww, Gg^Efm, Re^Gvs, Re^Gvs, Re, Gg, Gg, Gg^Em, Gg, Gs^Fp, Gg^Em, Gg, Ww, Ww, Ww, Gs^Fp, Gll^Fp, Gll^Fp, Gll^Fp
Gs^Fp, Gs^Fp, Gs^Fp, Gll^Fp, Gs^Fp, Gs^Fp, Gll^Fp, Gll^Fp, Gll^Fp, Gll^Fp, Gs^Fmw, Gs^Fmw, Gs^Fmw, Gg, Gs^Fmw, Gs^Fp, Re, Gs^Fp, Gs^Fmw, Gs^Fmw, Gs^Fdw, Gs^Fp, Gs^Fp, Gs^Fp, Rp, Gs^Fp, Hh, Hh^Fmw, Gs^Fmw, Gll^Fmw, Gs^Fp, Hh^Fp, Gs^Fp, Gll^Fmw, Gll^Fp, Gll^Fmw, Gs^Fmw, Hh^Fdw, Gll^Fp, Gs^Fp, Gs, Gs, Gg, Gg^Em, Re, Gs^Fp, Gg, Gg, Ww, Ww, Re^Gvs, Ww, Ww, Re, Gg, Gg^Wm, Re^Gvs, Gg, Gg, Gg, Ww, Ww, Gs^Fp, Gs^Fp, Gs^Fp, Ww, Gll^Fp, Gs^Fp, Gll^Fp
Gs^Fp, Gs^Fp, Gs^Fmw, Gs^Fp, Gll^Fmw, Gll^Fdw, Gll^Fp, Gll^Fp, Gs^Fp, Gs^Fmw, Gs^Fmw, Gs^Fdw, Gg, Gg, Gs, Re, Gs, Gs^Fp, Gs^Fdw, Gs^Fdw, Gs^Fp, Gs^Fmw, Gs^Fp, Gs^Fp, Gs^Fp, Rp, Hh, Hh, Gs^Fp, Gll^Fmw, Gs^Fp, Hh^Fp, Gs^Fp, Gll^Fmw, Gll^Fp, Gll^Fp, Gll^Fmw, Gll^Fp, Gll^Fp, Gll, Gll^Fp, Gs^Fp, Gs^Fp, Re, Gs^Fp, Gs^Fp, Ww, Ww, Re, Re^Gvs, Re^Gvs, Re, Re^Gvs, Ww, Ww, Re^Gvs, Re^Gvs, Re^Gvs, Ww, Ww, Gs^Fp, Gs^Fp, Gg^Em, Gs^Fp, Gs^Fp, Ww, Gll^Fp, Gll^Fp, Gll^Fp
Gg, Gs^Fp, Gs^Fdw, Gs^Fmw, Gs^Fmw, Gll^Fmw, Gs^Fp, Gll^Fp, Gs^Fp, Gs^Fmw, Gs^Fmw, Gg^Efm, Gg, Gg, Gs^Vhr, Rp, Gs, Gd^Dr, Gg^Es, Gg, Gs^Vl, Gs^Fdw, Gs^Fp, Gs^Fp, Rp, Rp, Gs^Fp, Hh, Gs^Fmw, Gs^Fp, Gs^Fp, Gs^Fp, Gs^Fp, Gll^Fp, Gll^Fp, Gs^Fp, Gs^Fp, Gs^Fp, Gs^Fp, Gs^Em, Gll^Em, Gll^Fp, Gs^Fp, Re, Gg, Gs^Fp, Gs^Fp, Ww, Ww, Re, Re^Gvs, Re^Gvs, Gg^Wm, Gg, Gg, Ww, Ww, Ww, Gg^Efm, Gg, Gg, Gg, Gg, Gg, Gs^Fp, Ww, Gs^Fp, Gll^Fp, Gll^Fp
Rp, Gg^Efm, Gg^Efm, Gg^Em, Gg, Gs^Fdw, Gs^Fp, Gs^Fp, Gg^Em, Gs^Fdw, Gs^Fdw, Gg, Gg, Gs, Gg, Rp, Ce, Gs, Rp, Rp, Gs^Es, Gs^Es, Gs, Rp, Gs^Fp, Hh, Rp, Rp, Rp, Rp, Rp, Rp, Re, Gs^Fp, Gs^Fp, Gs^Fp, Gs^Fp, Gs^Fp, Gs, Gs^Em, Gs^Fp, Gll^Fp, Gs^Fp, Re, Re, Gs^Fp, Gs^Fp, Gs^Fp, Re^Gvs, Ww, Ww, Gg, Re^Gvs, Re^Gvs, Re^Gvs, Gg^Vh, Ww, Ww, Ww, Gg, Gg, Gs^Fp, Gg, Gg^Es, Ww, Ww, Gs^Fp, Gll^Fp, Gll^Fp
Gg, Rp, Rp, Rp, Rp, Gg, Gg, Gg, Gg^Vl, Gg, Gg, Gg, Ce, Ce, Gg, Rp, Rp, Rp, Ce, Gg, Gs, Gd^Dr, Gg^Ettz, Rp, Rp, Rp, Gs^Fp, Gs^Fp, Hh, Hh, Gs^Fp, Gs^Fp, Gs^Fp, Rp, Gs^Fp, Gs^Fp, Hh^Fp, Gs^Fp, Gg, Gs^Fp, Gg^Es, Gg, Gg, Gg, Re, Gs^Fp, Gs^Fp, Gs^Fp, Re, Re^Gvs, Ww, Gg, Gg^Wm, Re^Gvs, Ww, Ww, Gg, Re^Gvs, Re^Gvs, Ww, Ww, Gs^Fp, Ww, Ww, Gs^Fp, Gs^Fp, Gll^Fp, Gll^Fp, Gs^Fp
Gs^Fp, Gg, Gs^Fp, Gg, Gg, Rp, Rp, Rp, Rp, Gg, Gg, Ce, Gg, Gg, Ce, Gs, Rp, Gg, Gs^Fp, Ce, Ce, Gs^Es, Rp, Rp, Gs^Fp, Gs^Fp, Gll^Fp, Gll^Fp, Hh^Fp, Hh^Fp, Hh^Fp, Gs^Fp, Gll^Fp, Re, Hh, Gs^Fp, Hh^Fp, Gg, Gg, Gg, Gg, Gg, Gg, Gg^Vh, Re, Re, Re, Gs^Fp, Re^Gvs, Re^Gvs, Ww, Re^Gvs, Gg^Efm, Ww, Re, Re^Gvs, Gg^Vh, Gg, Gg, Gg^Wm, Re^Gvs, Ww, Ww, Gs^Fp, Gs^Fp, Gll^Fp, Gs^Fp, Gll^Fp, Gs^Fp
Gs^Fp, Gs^Fp, Gll^Fp, Gs^Fp, Gs^Fp, Gg, Gs^Fp, Gg, Gg^Efm, Rp, Rp, Gg, Gg, Ce, 2 Ke, Ce, Rp, Gg, Gs^Fp, Gs^Fp, Gs^Fp, Rp, Gs^Ettz, Gg, Gg, Gs^Fp, Gs^Fp, Gll^Fp, Gll^Fp, Hh^Fp, Gs^Fp, Gll^Fp, Gll^Fp, Re, Re, Hh, Gg, Gg, Gs^Fp, Gs^Fp, Re, Gg, Re, Re, Gll^Fp, Gs^Fp, Gs^Fp, Re, Gg^Vh, Re^Gvs, Ww, Re^Gvs, Gg^Vh, Re^Gvs, Re^Gvs, Re^Gvs, Gg^Efm, Gg, Re^Gvs, Re^Gvs, Ww, Ww, Gg, Gg^Em, Gg, Gs^Fp, Gg^Es, Gll^Fp, Gg
Hh^Fp, Gll^Fp, Gll^Fp, Gll^Fp, Gll^Fp, Gll^Fp, Gs^Fp, Gg, Gs^Vhr, Gg, Ce, Rp, Rp^Ettz, Ce, Ce, Ce, Rp, Gg, Ww, Ww, Ww, Ce, Gs, Gg, Gg, Gs^Fp, Hh, Gll^Fp, Gll^Fp, Gll^Fp, Gs^Fp, Gll^Fp, Gll^Fp, Gll^Fp, Hh, Re, Re, Re, Re, Re, Gg, Re, Gg, Gll^Fp, Gll^Fp, Gll^Fp, Gg^Em, Re, Re^Gvs, Re, Ww, Re^Gvs, Gg, Re^Gvs, Gg^Wm, Gg, Re^Gvs, Re^Gvs, Re^Gvs, Ww, Wo, Ww, Gg, Gg^Es, Gg, Gg, Gg, Gg, Gg
Hh, Hh, Hh, Hh, Hh^Fp, Hh^Fp, Gs^Fp, Gg, Gg, Gs, Ce, Gg, Gs^Es, Rp^Ettz, Rp, Rp, Gg, Gg^Vl, Ww, Wo, Ww, Ce, Gs, Gs, Gg, Gg, Hh^Fp, Hh^Fp, Hh^Fp, Hh, Gll^Fp, Gll^Fp, Gll^Fp, Hh^Fp, Hh^Fp, Hh, Gs^Fp, Gg, Re, Gg^Es, Gg, Gg, Gll^Fp, Gll^Fp, Gll^Fp, Gs^Fp, Gg, Re, Re^Gvs, Re^Gvs, Ww, Gg, Gg, Gg^Efm, Re^Gvs, Re^Gvs, Re^Gvs, Re^Gvs, Ww, Ww, Wo, Ww, Ww, Ww, Ww, Ww, Ww, Ww, Ww
Hh, Hh^Fp, Hh, Hh^Fp, Hh, Hh, Gs^Fp, Gs^Fp, Gg, Gg, Gg, Ce, Ce, Gd^Dr, Rp^Ettz, Gg^Vhr, Ww, Ww, Gs^Fp, Ww, Gs^Fp, Ce, Gg, Hh, Hh, Hh, Hh, Hh^Fp, Gll^Fp, Gs^Fp, Gll^Fp, Gll^Fp, Gll^Fp, Gs^Fp, Gll^Fp, Gll^Fp, Gg, Gg, Gg, Gg, Gs^Fp, Gs^Fp, Gll^Fp, Gll^Fp, Ww, Gs^Fp, Gg, Re, Ww, Ww, Ww, Gg, Gg, Gg, Ww, Re^Gvs, Ww, Ww, Wo, Wo, Wo, Ww, Gs^Fp, Gs^Fp, Gs^Fp, Gs^Fp, Gs^Fp, Ww, Ww
Gs^Fp, Gs^Fp, Hh, Hh, Hh^Fp, Hh^Fp, Hh, Gs^Fp, Gg, Gg^Vl, Gg, Gs, Ce, Gs^Es, Rp, Gg, Ww, Gs^Fp, Ce, Ce, Gg, Gg, Gg, Gs, Gs, Gg, Gg, Gs^Fp, Gll^Fp, Gll^Fp, Gs^Fp, Gll^Fp, Gll^Fp, Gll^Fp, Gll^Fp, Gll^Fp, Re, Gg, Gs^Fp, Ds, Ds, Ds, Ww, Ww, Wo, Ww, Wo, Wo, Wo, Wo, Wo, Ww, Ww, Ww, Wo, Ww, Wo, Wo, Wo, Wo, Wo, Ww, Ww, Ww, Ww, Gs^Fp, Ww, Ww, Ww
Gs^Fp, Hh, Gs^Fp, Gs^Fp, Hh, Hh, Gg^Es, Gg^Efm, Gg, Gg, Gs^Fp, Gg, Gg, Gg, Ww, Ww^Bw\r, Rp, Gg, Gg, Gs, Gg, Ce, Gs^Ettz, Gs^Ettz, Gs, Gg, Gs^Fp, Gs^Fp, Gll^Fp, Gll^Fp, Gll^Fp, Gs^Fp, Gll^Fp, Gll^Fp, Chr, Re, Gg, Chr, Chw, Ds, Ww, Ww, Wo, Wo, Ww, Wo, Wo, Wo, Wo, Wo, Wo, Wo, Wo, Wo, Wo, Wo, Wo, Wo, Ww, Ww, Ww, Wo, Ww, Ww, Ww, Ww, Ww, Ww, Ww
Ds, Hh, Ds, Gs^Fp, Gs^Fp, Gs^Fp, Gg, Gg, Gs^Fp, Gll^Fp, Gs^Fp, Gg^Es, Gg, Ww, Ds, Gg, Gg, Rp, Rp, Gs^Ettz, Gg, Gs, Ds^Es, Ds, Ds, Gg, Gg, Gg, Ds, Gs^Fp, Gs^Fp, Gs^Fp, Gs^Fp, Gll^Fp, Gg, Gg, Wwf, Ww, Wo, Ww, Wo, Wo, Ww, Ww, Ds, Ww, Ww, Wo, Ww, Wo, Ww, Wo, Ww, Wo, Ww, Wo, Ww, Ww, Ww, Ww, Gs^Fp, Ww, Gs^Fp, Gs^Fp, Gs^Fp, Gs^Fp, Gs^Fp, Ds, Ds
Ww, Ds, Ww, Ds, Ds, Gs^Fp, Ds, Gg, Gg, Gs^Fp, Ds, Ds, Ww, Ww, Ds, Ce, Ce, Gg, Ds, Rp, Ds, Ds, Ww, Ww, Ww, Ww, Ww, Ds, Ww, Ds, Ds, Ds, Ds, Ds, Wwf, Ds, Wwf, Wo, Wo, Wo, Ww^Xo, Ww, Gg, Ds, Gs^Fp, Ds, Ss, Ww, Ss, Ww, Ss, Ww, Ss, Ww, Ww, Ww, Ww, Ww, Gs^Fp, Ds, Ss, Gs^Fp, Gs^Fp, Gs^Fp, Gs^Fp, Gs^Fp, Gs^Fp, Gs^Fp, Gs^Fp
Wo, Ww, Wo, Ww, Ww, Ds, Ww, Wwf, Ww, Ds, Ww, Ww, Ww, Ww, Ww, Ds, Ds, Ce, Wwf, Rp, Ww, Wwf, Wo, Wo, Wo, Wo, Wo, Wo, Wo, Wo, Wo, Ww, Wo, Ww, Ww, Ww, Ww, Wo, Wo, Ww^Xo, Ds, Gg^Xo, Gg^Xo, Gs^Fp, Hh, Gs^Fp, Gs^Fp, Ss, Gs^Fp, Ss, Ss, Ss, Ss, Ss, Ss, Ss, Gs^Fp, Gs^Fp, Ss, Gs^Fp, Ss, Ss, Ss, Ss, Gs^Fp, Gll^Fp, Gll^Fp, Gll^Fp, Gll^Fp
Ww, Wo, Wo, Wo, Wo, Ww, Wo, Ww, Wo, Ww, Wo, Wo, Wo, Wo, Wo, Ww, Ww, Ds^Es, Ww, Wwf^Es, Wwf, Ww, Wwf, Wo, Ww^Xo, Ww^Xo, Ww^Xo, Ww^Xo, Ww^Xo, Wo, Wo, Wo, Ww, Ww, Wwf^Xo, Wwf, Ww, Wo, Ww^Xo, Ww^Xo, Ds, Gs^Fp, Gs^Fp, Hh^Xo, Hh^Xo, Hh, Gs^Fp, Gs^Fp, Ss, Ss, Ss, Ss, Ss, Ss, Ss, Ss, Ss, Ss, Gs^Fp, Ss, Ss, Gs^Fp, Ss, Gs^Fp, Gs^Fp, Gs^Fp, Gs^Fp, Gll^Fp, Gll^Fp
Ds, Ww, Ww, Ww, Ww, Wo, Ww, Wo, Ww, Wo, Ww, Ww, Ww, Ww, Ww, Wo, Wo, Wwf, Ww, Ww, Ww, Ww, Ww^Xo, Wwf^Xo, Ce, Gs^Fp, Gs^Fp, Ds, Ds^Xo, Ww^Xo, Ww^Xo, Ww^Xo, Ww^Xo, Ww^Xo, Chr, Wwf^Xo, Ww^Xo, Ww^Xo, Chr, Ds, Gs^Fp, Gs^Fp, Gs^Fp, Hh, Hh^Xo, Gs^Fp, Gs^Fp, Gs^Fp, Ss, Ss, Gs^Fp, Gs^Fp, Gll^Fp, Ss, Gll^Fp, Gll^Fp, Gs^Fp, Gs^Fp, Ss, Ss, Gs^Fp, Gs^Fp, Ss^Vhs, Ss, Ss, Ss, Gll^Fp, Gll^Fp, Gs^Fp
Hh, Ds, Ds, Ds, Ds, Ww, Ds, Ww, Ds, Ww, Ds, Ds, Ds, Ds, Ds, Ww, Ww, Ww, Wwf^Xo, Wwf, Ww^Xo, Ww, Ww^Xo, Ket, Gs, Gs, Gg, Gs^Fp, Gg^Xo, Gs^Fp, Gs^Fp, Gs^Fp, Gs^Fp, Ds, Gs^Fp, Ds, Gs^Fp, Ds, Gs^Fp, Gll^Fp, Gll^Fp, Gs^Fp, Hh, Hh, Hh^Xo, Gs^Fp, Ss, Ss, Ss, Gs^Fp, Gs^Fp, Gll^Fp, Gll^Fp, Gll^Fp, Gll^Fp, Gll^Fp, Gs^Fp, Ss, Ce, Ce, Gs, Ss, Gg, Gs^Fp, Ce, Ss, Gs^Fp, Gll^Fp, Gs^Fp
Hh, Hh, Hh, Hh, Hh, Hh, Hh, Ds, Gs^Fp, Gs^Fp, Gs^Fp, Gll^Fp, Gll^Fp, Gs^Fp, Gs^Fp, Ds, Ds, Ww, Ce, Wwf^Xo, Rp, Wwf^Es, Gs, Ce, Gs, Gg^Vhr, Gg, Gd^Dr, Gs^Es, Gg^Xo, Gs^Fp, Gs^Fp, Gs^Fp, Gs^Fp, Gs^Fp, Gs^Fp, Gs^Fp, Gs^Fp, Gll^Fp, Gll^Fp, Gs^Fp, Hh, Gs^Fp, Hh, Gs^Es, Gs^Fp, Gs^Fp, Ss, Gs^Fp, Gs^Fp, Gs^Fp, Gll^Ettz, Gll, Gll^Ettz, Gll, Gs^Fp, Gg^Vhr, Gs^Fp, Ce, Gs, Gd^Es, Ch, Ch, Gs, Gs, Ce, Gs^Fp, Gs^Fp, Gs^Fp
Mm, Mm^Vhh, Mm, Mm, Mm, Mm, Hh, Gg^Vl, Hh^Fp, Gs^Fp, Gll^Fp, Gll^Fp, Gll^Fp, Gs^Fp, Gs^Fp, Gs^Fp, Gg, Ket, Gg^Xo, Gs^Xo, Rp^Xo, Rp, Gs^Es, Gs, Gs^Fp, Gs^Fp, Gg, Gs, Ce, Gg^Xo, Rp^Vhcr, Gs^Fp, Rp, Ce, Ce, Gs^Fp, Gs^Fp, Gs^Fp, Gs^Fp, Gs^Fp, Gs^Fp, Gs^Fp, Gs^Xo, Gg^Xo, Gs, Gg^Em, Gs^Fp, Gs^Fp, Gs^Fp, Gs^Fp, Rp, Gs^Fp, Rp, Gs^Fp, Rp, Gs^Fp, Gs^Fp, Gg, Gg, Gs^Dr, Rr, Ch, 3 Kh, Ch, Gg, Ce, Gs, Gg^Vl, Gs^Fp
Mm, Mm, Mm, Mm, Mm, Mm^Xm, Mm, Hh, Hh^Fp, Gll^Fp, Gll^Fp, Gll^Fp, Gs^Fp, Hh^Fp, Gs^Fp, Gg^Em, Ce, Ce, Gg^Xo, Gg^Es, Gg^Xo, Rr, Rr, Gs^Eff, Gs^Eff, Gs^Fp, Ce, Ket, Gs^Xo, Gs^Xo, Rp^Dr, Rp, Gs^Fdw, Rp, Rp, Ket, Ce, Gs, Gd^Dr, Gs, Gg, Gs^Xo, Gd^Dr, Gs^Vhr, Rp, Rp, Rp, Rp, Rp, Rp, Gll^Fp, Rp, Gs^Fp, Rp, Gs^Fp, Rp, Rp, Rp^Ettz, Rp, Rr, Rr, Ch, Ch, Ch, Gs, Ce, Gg, Gs^Fp, Gs^Fp
Mm, Mm, Mm, Mm^Xm, Mm, Mm, Mm, Hh, Hh^Fp, Gs^Fp, Gs^Fmw, Gs^Fmw, Hh^Fp, Hh^Fp, Gs^Fp, Gg^Efm, Gg^Xo, Gg^Xo, Gg, Gg^Vhr, Gs^Fp, Gg^Xo, Gg^Xo, Rr^Ettz, Gd^Dr, Gs, Ce^Xo, Gg^Xo, Rp, Re, Gs^Fetd, Gs, Gs, Gd^Fdw, Gs^Fdw, Rp, Rp, Gd^Ettz, Gs^Fetd, Gd^Dr, Rr, Rp^Xo, Rp, Rp, Gs^Es, Gs, Gs^Fp, Gs^Fp, Gs^Fp, Gll^Fp, Gll^Fp, Gll^Fp, Gs^Fp, Gs^Fp, Gs^Fp, Gg, Gg^Vhr, Rp, Rp, Rr^Dr, Gs^Ettz, Ch, Rr, Rr, Gs^Vhr, Gs, Gd^Vhcr, Gg, Gs
Mm, Mm^Xm, Mm, Mm, Mm, Mm, Mm, Hh, Hh, Hh^Fp, Gs^Fmw, Hh^Fdw, Hh^Fp, Hh, Hh, Gs^Xo, Gs^Fp, Gg, Gs^Fp, Gs^Fp, Gg, Gs^Fp, Gg, Rr^Xo, Rr^Xo, Gd^Dr, Gs^Xo, Gd^Dr, Rr, Rp^Vhcr, Chr, Chr, Ch, Gd, Rp, Gd^Fdw, Gd^Fdw, Rp^Ettz, Rp, Rr, Gg^Xo, Gs^Es, Gg, Gg^Es, Hh, Hh, Hh, Gs^Fp, Gll^Fp, Gll^Fp, Gll^Fp, Gll^Fp, Gs^Fp, Ss, Gs^Fp, Gg^Efm, Gg^Efm, Gg, Ce, Gs, Gd^Dr, Gs, Rp, Rp, Rr, Gs^Ettz, Rp, Rp, Rp
Mm, Mm, Mm, Mm, Mm, Mm, Mm, Hh, Hh, Hh, Hh, Hh^Fp, Hh, Hh, Hh, Hh^Xo, Gs^Fmw, Gs^Fp, Gs^Fp, Gg, Gg^Dr, Gg, Ce, Ce, Gs, Rr^Xo, Rr, Rr^Xo, Re^Xo, Rr, Ch, 4 Kh, Ch, Rp, Re^Vhcr, Re, Rr, Rp, Gs^Eff, Gg^Vhr, Gg^Eff, Gs^Fp, Hh^Fp, Gg, Hh^Fmw, Hh, Hh^Fmw, Gs^Fp, Gs^Fp, Gll^Fmw, Hh^Fp, Gs^Fp, Hh^Fp, Ss, Ss, Gs^Fp, Gs^Fp, Gg^Em, Gg, Ce, Gs, Gs^Etbz, Gs, Rp^Dr, Rp, Rp, Rp, Rp, Rp
Mm, Mm, Mm, Mm, Hh, Mm, Mm, Mm, Mm, Mm, Hh, Hh, Mm, Mm^Xm, Mm^Xo, Hh^Xo, Hh^Xo, Hh^Fmw, Gs^Fmw, Gs^Fp, Gs^Fp, Ce, Gg^Es, Gs, Gg^Fetd, Rp^Vhcr, Rr, Gd^Fdw, Gd^Fdw, Re^Xo, Rr^Xo, Chr, Gg, Rr, Gg^Dr, Gg^Fetd, Ce, Gs, Gd^Dr, Gs^Eff, Gs^Fp, Gs^Fp, Hh, Hh^Fp, Hh^Fp, Hh, Hh, Hh^Fmw, Hh, Hh^Fp, Hh^Fp, Hh^Fp, Gg^Vl, Gs^Fp, Ss, Gs^Fp, Ss, Gs^Fp, Gg^Vl, Gg, Gs^Fp, Ce, Ce, Gs^Etbz, Gs^Es, Rp, Gs^Vl, Gg^Ettz, Gg
Mm, Mm, Mm, Mm, Hh, Hh, Mm, Mm, Mm^Xo, Mm^Xo, Hh^Xo, Hh^Fp, Hh^Xo, Mm^Xo, Hh^Fp, Hh^Xo, Hh^Fp, Hh^Fmw, Gs^Fmw, Gs^Fmw, Gs^Fp, Gs^Fp, Gg, Gg, Rr, Rr, Rr, Gs^Fdw, Gd^Fdw, Gd^Fetd, Gs^Fdw, Rr^Xo, Rp^Xo, Rp, Gg, Gg, Ce, Gg, Gs^Es, Gg^Xo, Gg^Xo, Gs^Fp, Gs^Fmw, Hh, Hh, Hh, Hh, Hh, Hh, Hh, Gs^Fmw, Gs^Fmw, Gs^Fp, Hh^Fp, Hh^Fp, Ss, Ss, Gs^Fp, Gs^Fp, Gs^Fp, Ss, Gg^Efm, Gs, Ce, Gg, Gs^Es, Gs, Gg, Gs^Fp
Mm, Mm, Mm, Mm, Hh^Xo, Hh, Hh^Xo, Hh^Xo, Gs^Fp, Gs^Fp, Hh^Fp, Hh^Xo, Gs^Fmw, Hh^Fp, Hh^Fp, Hh^Fp, Gs^Fmw, Gs^Fmw, Gs^Fp, Gs^Fp, Gs^Fp, Gg^Vhr, Rp, Rp, Gd^Dr, Gg, Ce, Rr, Rr, Gd^Fdw, Rr, Rp^Vhcr, Gg^Fetd, Gg^Xo, Ce, Ket, Gg, Gs, Gg^Vhr, Gs^Eff, Gg^Eff, Gg^Xo, Gs^Fmw, Gs^Fp, Hh^Fmw, Hh^Fmw, Hh, Hh^Fp, Hh, Hh, Hh^Fmw, Hh^Fmw, Gs^Fp, Hh^Fp, Hh^Fp, Gs^Fp, Gs^Fp, Gs^Fp, Gs^Fmw, Gs^Fmw, Ss, Gs^Fp, Gs^Fp, Gs^Fp, Gs^Fp, Gs^Ettz, Gll^Fp, Gs^Fp, Hh
Mm, Hh, Hh^Xo, Hh^Xo, Mm, Hh^Xo, Hh^Fp, Hh^Fmw, Gs^Fp, Gs^Fp, Gll^Fp, Gs^Fmw, Gs^Fp, Gs^Fmw, Gs^Fp, Gs^Fmw, Gg, Gs^Fmw, Gg, Gg, Gs^Ettz, Gs, Rp, Gs, Gg, Gs, Gg, Ket, Ce, Rr, Gg, Gg^Efm, Gg, Gg^Xo, Gs, Gs^Ettz, Gs, Gg, Gs^Eff, Gs^Eff, Gs^Fp, Gs^Fp, Gs^Fp, Gs^Fp, Hh^Fp, Hh, Hh, Hh, Gs^Fp, Hh, Hh, Hh^Fp, Hh^Fp, Gs^Fp, Hh, Hh, Gs^Fp, Gs^Fmw, Gs^Fp, Ss, Gs^Fp, Gs^Fp, Gs^Fp, Hh^Fp, Hh^Fp, Gll^Fp, Hh, Gs^Fp, Hh^Fp
Hh, Hh^Xo, Gs^Fp, Gs^Fp, Hh^Fp, Hh^Fp, Hh^Fmw, Hh^Fmw, Hh^Fmw, Gll^Fp, Gs, Gs^Fp, Gg, Gg^Em, Gg, Gg, Gg, Gs, Re, Re, Re, Rp, Gs^Eff, Gg^Eff, Re, Re^Gvs, Re, Gs, Gs, Gg, Ce, Gg, Gg, Ce^Xo, Gs^Xo, Gd^Dr, Gg^Xo, Gs^Xo, Gs^Fmw, Gs^Fmw, Gs^Fp, Gs^Fmw, Hh^Fp, Hh^Fp, Hh^Fp, Hh, Hh^Fmw, Hh^Fp, Hh^Fmw, Hh^Fp, Hh, Hh, Hh^Fp, Hh^Fp, Hh^Fp, Hh, Hh^Fp, Hh, Hh^Fp, Gs^Fp, Gll^Fp, Hh^Fp, Hh^Fp, Hh^Fp, Hh^Fp, Gll^Fp, Hh, Hh, Hh
Gs^Fmw, Hh^Fp, Gs^Fp, Gs^Fp, Hh^Fmw, Hh^Fp, Gs^Fp, Gll^Fp, Gs, Gll^Fp, Gs, Gg, Gg^Vh, Gg, Gg, Gg^Wm, Gg^Dr, Gs, Re, Re^Gvs, Rp, Rp^Ettz, Gs, Re^Ettz, Re^Ettz, Re^Gvs, Gs^Vhr, Gs, Gg, Gg, Gg, Gg, Gg^Vhr, Gg^Xo, Gs^Fmw, Gg^Xo, Hh^Fdw, Gs^Fp, Gs^Fmw, Hh^Fmw, Gs^Fp, Hh, Hh^Fp, Hh, Hh, Hh, Hh^Fp, Hh^Fp, Gs^Fmw, Gs^Fmw, Gs^Fp, Hh, Hh, Hh, Hh, Hh, Hh, Hh^Fp, Hh^Fp, Hh, Gs^Fp, Gs^Fp, Hh^Fp, Hh^Fp, Hh^Fp, Hh, Hh, Hh^Fp, Mm
Gs^Fmw, Gs^Fp, Gs^Fmw, Gs^Fp, Gs^Fp, Gs^Fp, Gs^Fp, Gs^Fp, Gs^Ettz, Gs, Gs, Gg, Re^Ettz, Re, Re, Gs, Gs, Gg, Rp, Rp, Re, Re, Re^Gvs, Gs, Gd^Ettz, Gs, Gs^Ettz, Gs, Re^Gvs, Gg^Es, Gg, Gg, Gg^Xo, Gg^Xo, Gs^Fmw, Hh^Fdw, Hh^Fdw, Gs^Fp, Hh^Fmw, Hh^Fmw, Hh, Hh, Hh, Hh^Fp, Hh, Hh^Fp, Hh, Hh^Fmw, Hh^Fmw, Gs^Fp, Hh, Hh, Hh^Fp, Hh, Hh^Fp, Hh^Fp, Hh^Fp, Hh, Hh, Hh, Hh^Fp, Hh^Fp, Hh^Fp, Hh, Hh^Fp, Hh, Mm^Vhh, Mm, Mm
Gs, Gs, Gs, Gs^Fp, Gs, Gs^Es, Gs^Ettz, Gs, Gs, Gs, Gg^Eff, Re, Re, Re^Ettz, Gs^Eff, Gs^Eff, Rp, Rp, Gs^Eff, Re, Re, Re^Gvs, Re, Re^Gvs, Gs, Gd^Dr, Re, Re^Gvs, Re, Re, Gg^Xo, Gg^Xo, Gs^Fmw, Gs^Fp, Hh^Fmw, Hh^Fdw, Hh^Fdw, Hh^Fdw, Hh, Hh, Hh, Hh^Fp, Hh^Fp, Hh, Hh, Hh, Hh, Hh^Fmw, Hh, Gs^Fp, Hh, Hh, Hh, Hh^Fp, Hh, Hh^Fp, Hh, Hh, Mm, Hh, Hh, Hh, Hh, Hh, Hh^Fp, Hh, Mm, Mm, Mm
Gs, Gs, Rp, Gs, Rp, Gs, Gs^Dr, Gs^Es, Gg, Gg^Ettz, Gg, Gs^Eff, Gg, Gg^Eff, Rp, Rp, Gg, Gg, Gg^Vh, Gs^Eff, Gs^Eff, Re, Gs^Eff, Gs^Eff, Re, Gs, Gg, Re^Gvs, Gg^Efm, Gg^Xo, Gs^Fp, Gs^Fp, Gs^Fmw, Hh^Fmw, Hh^Fmw, Hh^Fdw, Hh^Fmw, Hh^Fmw, Hh^Fp, Hh, Hh, Hh^Fp, Hh, Hh, Mm, Mm, Mm, Hh, Hh, Hh, Hh, Hh, Hh, Hh^Fp, Hh, Hh, Hh, Mm, Mm, Mm^Vhh, Hh, Hh, Hh, Hh, Hh, Hh, Hh, Mm, Mm^Xm
Rp, Rp, Gs, 1 Rp, Gs, Rp, Rp, Gs, Rp, Rp, Rp, Rp, Rp, Rp, Gg, Gg, Gg, Gg, Gg, Gs, Gg, Gg^Eff, Gs, Re, Re^Gvs, Re^Gvs, Gg^Eff, Gg^Eff, Gg^Xo, Gg^Xo, Gs^Fp, Gs^Fp, Gs^Fmw, Hh^Fmw, Hh^Fmw, Hh^Fmw, Hh^Fmw, Hh^Fmw, Hh, Hh^Fmw, Hh, Hh, Hh, Hh^Fp, Hh, Mm, Mm, Mm^Xm, Mm^Xm, Mm, Mm, Mm^Xm, Mm, Hh, Mm, Mm, Mm, Mm, Mm, Mm, Mm^Xm, Mm, Mm, Mm^Xm, Mm, Mm, Mm^Xm, Mm^Xm, Mm^Xm
Gs^Fp, Gs, Gs^Es, Gs, Gs, Gs, Gs, Rp, Gg, Gg, Gs^Fp, Gg, Gg, Gg, Gg, Gg^Em, Gs^Fp, Gs^Fp, Gs^Fp, Gs^Fp, Gs^Fp, Gg, Gg, Gg, Gg^Em, Gg, Gg^Xo, Gg^Xo, Gs^Fp, Gs^Fp, Gs^Fp, Gs^Fp, Gs^Fp, Hh^Fmw, Gs^Fp, Hh^Fmw, Hh, Hh, Gs^Fp, Hh, Gs^Fp, Hh^Fp, Hh^Fp, Hh^Fp, Hh, Mm, Mm, Mm, Mm, Mm^Xm, Mm, Mm, Mm, Hh, Mm, Mm, Mm, Mm, Mm, Mm, Mm, Mm, Mm, Mm, Mm^Xm, Mm, Mm^Xm, Mm^Xm, Mm^Xm
Gs, Gs, Gs^Fp, Gs^Fp, Gs^Fp, Gs^Fp, Gs, Gs^Ettz, Gg, Gg, Gs^Fp, Gs^Fp, Gs^Fp, Gs^Fp, Gs^Fp, Gg, Gg, Gg, Gs^Fp, Gs^Fp, Gs^Fp, Gs^Fp, Gs^Fp, Gs^Fp, Gs^Fp, Gs^Fp, Gs^Fp, Gs^Fp, Gs^Fp, Gs^Fp, Gs^Fp, Gs^Fp, Gs^Fmw, Gs^Fp, Gs^Fp, Gs^Fp, Hh, Gs^Fp, Gs^Fp, Gs^Fp, Gs^Fp, Hh^Fp, Hh^Fp, Hh^Fp, Mm, Mm, Mm, Mm, Mm, Mm, Mm, Mm, Mm, Hh^Xo, Hh^Xo, Mm, Mm, Mm, Mm, Mm, Mm, Mm, Mm, Mm^Xm, Mm, Mm^Xm, Mm^Xm, Mm^Xm, Mm^Xm
