border_size=1
usage=map

Hd, Hd, Hd, Hd, Hd, Hd, Hd, Ds, Ds^Edp, Ds, Ds^Es, Ds^Es, Hd, Dd, Dd, Dd, Ds, Ds, Hd, Hd, Dd, Dd, Dd, Gs, Gs, Dd, Gs, Gs^Ftd, Gs^Ftd, Gs^Ftd, Gs^Ftd, Gs^Ftd, Gs^Ftd, Ds^Ftd, Gs^Ftd, Ds, Gs, Re, Gs^Fp, Gs^Fp, Re, Gs^Fp, Gs^Fds, Gs^Fp
Hd, Hd^Edp, Ds^Edp, Ds, Hd, Hd, Dd, Dd, Dd, Dd, Ds, Ds, Ds, Hd, Dd, Dd^Edp, Ds, Ds, Dd, Hd, Dd, Dd, Dd, Dd, Dd, Gs, Gs, Gs, Gs^Ftd, Gs^Ftd, Re^Vct, Gs, Gs^Ftd, Gs^Ftd, Gs^Ftd, Gs, Gs^Vht, Re, Gs^Fdf, Gs^Ftd, Re, Gs^Fp, Gs^Fp, Gs^Fp
Hd, Hd, Dd^Edpp, Ds, Hd, Dd, Dd^Edpp, Dd, Dd, Dd, Hd, Ds, Ds, Dd, Ds, Hd, Ds, Dd, Dd, Hd, Ds, Hd, Dd, Dd, Gs, Gs, Gs^Ftd, Gs^Ftd, Gs, Gs^Ftd, Re, Re, Ce, Gs, Gs, Gs^Ftd, Gs^Ftd, Re, Re, Re, Gs^Fmf, Gs^Vht, Gs^Fds, Gs^Fp
Dd, Ds, Dd, Ds, Ds, Ds, Dd, Dd, Gd, Ds, Ds, Ds, Ds^Es, Ds^Edp, Ds, Hd, Hd, Dd, Dd^Vda, Dd^Edpp, Ds, Hd, Hd, Dd, Dd, Ds, Gs^Ftd, Gs^Ftd, Re^Vct, Re, Re, Ce, 2 Ke, Ce, Re, Gs^Ftd, Re, Re, Gs^Fmf, Gs^Fmf, Gs^Fmf, Gs^Fp, Gs^Fp, Gs^Fp
Dd^Edp, Dd, Dd, Dd, Dd^Ftd, Ds, Dd, Dd^Edpp, Gd, Ds, Dd^Ftd, Gd, Gd, Ds, Ds, Hd, Ds, Dd, Ds^Edpp, Ds^Edpp, Hd, Hd, Dd, Dd^Es, Dd, Gs, Gs, Gd, Gd, Re, Re, Ce, Ce, Ce, Gs, Re, Gs^Ftd, Gs^Fmf, Gs^Ftd, Gs^Es, Gs, Gs^Fp, Gs^Ftd, Gs^Ftd
Dd, Dd^Edpp, Dd, Gs, Gd^Ftd, Dd^Ftd, Dd^Es, Gd, Gd, Dd, Dd^Ftd, Gs, Gd^Ftd, Gd, Ds, Ds, Ds, Ds, Dd, Ds^Edpp, Dd, Dd, Dd, Dd^Edpp, Gs, Gs, Dd, Gd^Ftd, Gd^Ftd, Re, Re, Gs, Gs, Re, Gs, Re, Gs, Gs^Fp, Gs^Fp, Gs^Es, Gs^Ftd, Gs^Ftd, Gs^Ftd, Gs^Ftd
Hd, Ds^Edpp, Dd, Gs^Ftd, Gd^Ftd, Gd, Dd, Dd, Dd^Ftd, Dd, Gs^Ftd, Gs^Ftd, Ds^Ftd, Gs^Ftd, Gs, Dd, Gs, Dd, Dd^Ftd, Dd, Gs, Gs^Ftd, Gs, Dd, Ds, Ds, Gs, Gs^Ftd, Gd, Re^Vct, Gd^Ftd, Gd^Ftd, Gs, Gs, Re, Re, Gs, Gs^Fmf, Gs^Ftd, Gs^Fp, Gs^Ftd, Gs^Ftd, Gs^Fp, Gs^Fp
Ds, Ds, Dd^Ftd, Gd^Ftd, Gd, Rd, Gs^Ftd, Gs^Ftd, Dd^Ftd, Dd, Dd^Ftd, Ds^Ftd, Ds^Ftd, Gs^Ftd, Gs^Ftd, Dd, Dd, Dd, Dd, Dd, Gs, Gs^Ftd, Gs^Ftd, Dd, Gs, Dd, Gs, Gs, Gs, Gd^Ftd, Gd, Gd, Gs, Re, Gs, Gs, Ds, Gs^Fp, Gs, Gs, Gs^Ftd, Gs^Fp, Gs^Fp, Gs^Fp
Ds, Ds, Ds, Dd^Ftd, Gs^Ftd, Gs, Gs^Ftd, Gs^Ftd, Re^Vct, Dd, Dd, Ds, Gs, Gs^Es, Gs, Dd, Chr, Gs, Gs, Hhd, Hhd, Gd, Gd^Ftd, Gs, Hhd, Hhd, Dd, Dd, Ds, Dd, Gs, Hhd, Hhd, Re, Gd, Chr, Ds, Gs, Gs, Gs^Fp, Gs^Fmf, Gs^Fp, Gs^Fmf, Gs^Fp
Dd, Rd, Rd, Gs^Ftd, Gs^Ftd, Gs, Gs, Re, Re, Rd, Rd, Rd, Gs^Ftd, Gs, Gs, Gs, Gs, Gs, Ds, Hhd, Hhd, Gd, Gd, Gs^Es, Hhd, Hhd, Gs, Ds^Edpp, Gs, Gs, Hhd, Hhd, Hhd, Gd, Gd, Ds, Ds, Gd, Gs^Fdf, Gs^Fmf, Gs^Fdf, Gs^Fmf, Gs^Fmf, Gs^Fp
Rd, Rd, Gs^Ftd, Gs^Ftd, Gs, Gs, Ce, Ce, Ce, Rd, Rd^Vct, Rd, Gs, Gs, Gs^Ftd, Gs^Ftd, Gs, Gs, Gs, Gd, Gs, Hhd, Gs, Hhd, Dd, Dd, Gs, Gs, Gs, Hhd, Hhd, Hhd, Hhd, Gd, Re, Gd, Hhd, Gd, Gd, Gg, Gs^Vh, Gg^Ftd, Gs^Fmf, Gs^Fp
Ww, Rd, Gs, Gs, Gs, Re, Ce, 3 Ke, Ce, Re, Re, Rd^Es, Gs, Gs, Gs, Hhd, Ds, Dd, Gs, Gs^Ftd, Gs, Gd, Gs^Ftd, Gs, Gs^Ftd, Gs, Gd^Ftd, Gd, Gs, Hhd, Hhd, Gs, Gs, Hhd, Gs, Re, Gd, Gd, Gs^Fdf, Gs^Fp, Re, Gs^Ftd, Gs^Ftd, Gs^Fp
Gs, Wwf, Ww, Gs, Re^Vct, Re, Gs, Ce, Re, Re, Rd, Re, Gs, Gs, Re, Gs, Ds, Ds^Edpp, Gs, Gs, Hhd, Gs^Ftd, Gs, Gs^Ftd, Gs^Ftd, Gs^Ftd, Gs^Ftd, Gs, Gs, Gs, Gd, Gs, Gs, Gs, Re, Re, Gs, Gs, Gs, Gs, Re, Gs^Fp, Gs^Ftd, Gs^Fp
Gs, Gs, Wwf, Gs, Gs, Gs, Gs^Ftd, Gs, Gs, Re^Vct, Rd, Rd, Rd^Edp, Re, Gs, Re, Rd, Dd, Gs, Hhd, Hhd, Gs, Gs^Ftd, Gs^Vht, Gs, Gs^Ftd, Gs, Gs, Gs, Gd, Gd^Ftd, Chr, Gs^Es, Re, Gs^Vht, Gs^Fdf, Gs^Fdf, Gs, Gs^Fmf, Gs^Es, Gs, Re, Re, Re
Gs, Dd^Edp, Dd, Wwf, Wwf, Gs^Ftd, Dd, Gs^Ftd, Dd, Dd, Rd, Rd, Dd^Edp, Rd, Gs^Ftd, Gs, Hhd, Gs, Gs^Ftd, Hhd, Hhd, Gs, Gs, Rd, Dd, Gs^Ftd, Gs, Dd, Gd, Gd, Gd, Gs^Ftd, Gs, Re, Gg, Gs^Fdf, Gg, Gs^Fdf, Gs^Fmf, Gs^Fdf, Gs, Gs, Gs^Ftd, Gs^Ftd
Dd, Dd, Dd, Gs, Ww, Gs, Gs, Dd, Dd^Edp, Rd, Rd, Dd, Dd, Rd, Gs^Ftd, Gs^Ftd, Hhd, Hhd, Gs, Gs, Dd, Gs, Gs, Rd, Rd, Dd, Dd, Dd, Gd, Gd, Ds, Gs, Re, Re, Gg, Gg, Gg, Gg, Gs^Fmf, Gs^Fmf, Gs^Fp, Gs^Fp, Gs^Fp, Gs^Ftd
Dd, Dd, Gs^Ftd, Gs, Gs^Ftd, Wwt, Ww, Dd, Ds, Rd, Gd, Dd, Rd, Rd, Gs^Vht, Gs^Ftd, Gs, Gs^Ftd, Rd, Rd, Ds, Gs, Hhd, Gs, Gs, Dd, Dd, Re, Re, Gd, Ds, Ds, Re, Gs, Gs^Fdf, Gg, Gs^Fdf, Gg, Gs^Fmf, Gs^Fmf, Gs^Fp, Gs^Ftd, Gs^Ftd, Gs^Ftd
Ds, Dd^Es, Gs^Ftd, Gs^Ftd, Re^Vct, Gs^Ftd, Gs^Ftd, Wwf, Wwf, Gd, Chr, Gd^Dr, Gd, Re, Gs, Gs, Dd, Gs, Dd, Dd, Dd, Gs, Hhd, Gs, Gs, Gs, Gs, Gs, Ds, Rd, Rd, Gs, Re, Gs, Gs^Fdf, Gs^Fmf, Gs^Ftd, Gs^Ftd, Gs^Fp, Gs^Fmf, Gs^Fmf, Gs^Ftd, Gs^Fp, Gs^Ftd
Ds, Dd, Gs, Gs^Ftd, Re, Gs^Ftd, Gs, Gs, Gs, Ww, Ww, Gd, Re, Re, Gs^Es, Dd, Gs, Gs, Gs, Dd, Gs^Ftd, Hhd, Hhd, Hhd, Hhd, Gs^Vht, Gs, Gs, Gs, Ds, Ds, Re, Re, Gs, Gs, Gs, Gs^Ftd, Gs^Ftd, Gs^Vh, Gs^Fp, Gs^Fp, Gs^Fp, Gs^Fp, Gs^Fmf
Gs^Ftd, Gs, Re^Vct, Re, Re, Re, Ce, Re, Re, Gs^Ftd, Wwf, Re, Gs, Gs, Gs, Gs, Hhd, Dd, Gs^Ftd, Gs, Gs, Hhd, Gs, Hhd, Gs, Gs, Ds, Gs, Gs, Ds^Ftd, Ds^Ftd, Gs^Vh, Re, Gs, Gs, Gs, Gs, Gs, Gs^Es, Gs, Gs, Gs, Gs^Fmf, Gs^Fmf
Gs^Ftd, Gs^Es, Rd, Re, Ce, Ce, Ce, Re, Gs, Wwf, Ww, Gs, Gs, Gs^Ftd, Gs^Ftd, Hhd, Hhd, Gs^Ftd, Gs, Gs^Ftd, Hhd, Hhd, Gs^Ftd, Hhd, Gs^Es, Gs, Ds, Gs, Gs, Gs^Ftd, Gs, Gs, Gs, Re, Re, Ce, Ce, Gs, Gs, Gs, Gs, Gs, Gs^Fp, Gs^Fp
Gs, Rd^Es, Rd, Ce, Re, 4 Ke, Ce, Re, Gs^Ftd, Wwt, Wot, Gs^Ftd, Wwf, Wwf, Gs^Ftd, Hhd, Gs, Gs^Ftd, Gs^Ftd, Gs, Gs^Ftd, Gs, Dd^Ftd, Gs, Dd^Ftd, Ds, Ds, Ds, Gs, Gs, Gs, Gs, Gs, Gs, Gs, Ce, 1 Ke, Ce, Re, Gs, Gs, Gs^Vh, Gs, Gs^Fp
Rd, Rd, Re^Vct, Re, Re, Ce, Gs, Gs, Ww, Wwt, Wwt, Wwt, Chr, Gs, Gs, Gs^Ftd, Gs, Gs^Ftd, Hhd, Gs^Ftd, Gs, Gs, Gs, Ds^Ftd, Ds^Edpp, Ds, Gs, Gs^Ftd, Gs^Ftd, Gs, Gs^Ftd, Gs^Fp, Gs^Fp, Gs, Gs, Ce, Gs, Ce, Gs, Re, Rp, Gs, Rp, Rp
Gs^Ftd, Rd, Gs, Gs^Ftd, Gs, Gs, Gs^Ftd, Ww, Wwt, Wwt, Wwt, Ww, Wwf, Chr, Gs, Gs, Hhd, Hhd, Hhd, Gs^Ftd, Gs^Ftd, Gs, Gs, Gs, Dd, Gs, Ds, Gs, Ds^Ftd, Ds^Ftd, Ds^Ftd, Gs^Ftd, Gs^Ftd, Gs^Fmf, Gs, Gs, Gs, Gs, Gs, Gs, Gs, Rp, Gs, Rp
Gs^Ftd, Gs, Gs, Gs^Ftd, Gs^Ftd, Gs^Ftd, Wwf, Ww, Ww, Wwt, Gs, Ww, Gs, Ww, Ww, Gs, Gs, Hhd, Hhd, Gs, Gs^Ftd, Gs^Ftd, Gs, Dd, Gs, Gs^Es, Dd, Ds^Ftd, Gs^Ftd, Ds^Ftd, Gs^Ftd, Gs^Fmf, Gs^Fmf, Gs^Fmf, Gs^Fmf, Gg^Vh, Gs^Fp, Gg, Gs^Fp, Gs, Gs^Fmf, Gs, Gs^Ftd, Gs^Ftd
Gs^Ftd, Gs^Ftd, Gs^Ftd, Gs^Ftd, Gs^Ftd, Gs, Ww, Ww, Gs, Gs, Gs, Gs, Gs, Gs, Wwf, Wwf, Ww, Gs, Gs, Gs, Dd^Ftd, Gs^Ftd, Gs^Ftd, Gs, Gs, Dd, Dd^Ftd, Ds^Ftd, Ds, Gs, Gs, Gs^Ftd, Gs^Fp, Gs^Fmf, Gs^Fmf, Gs^Fp, Gg, Gs^Ftd, Gs^Fp, Gs^Fmf, Gs^Fmf, Gs^Fp, Gs^Fp, Gs^Fp
