Hd, Hd, Hd, Hd, Hd, Hd, Hd, Ds, Ds^Edp, Ds, Ds^Es, Ds^Es, Hd, Dd^Qhu, Dd^Qhu, Dd^Qhu, Ds^Qhu, Ds^Qhu, Hd^Qhu, Hd, Dd, Dd, Dd, Gs^Qhh, Gs^Qhh, Dd, Gs, Gs^Ftd, Gs^Ftd, Gs^Ftd, Gs^Ftd, Gs^Ftd, Gs^Ft, Ds^Ft, Gs^Ftd, Ds, Gs, Re, Gs^Fp, Gs^Fp, Re, Gs^Fp, Gs^Fds, Gs^Fp
Hd, Hd^Edp, Ds^Edp, Ds, Hd, Hd, Dd, Dd, Dd, Dd, Ds, Ds, Ds, Hd, Dd^Qhu, Dd^Edp, Ds, Ds^_ml, Dd, Hd^Qhu, Dd, Dd, Dd, Dd, Dd, Gs^Qhh, Gs, Gs^Ft, Gs^Ft, Gs^Ftd, Re^Vct, Gs^Ft, Gs^Ftd, Gs^Ftd, Gs^Ft, Gs^Ft, Gs^Vht, Re, Gs^Fdf, Gs^Ftd, Re, Gs^Fp, Gs^Fp, Gs^Fp
Hd, Hd, Dd^Edpp, Ds, Hd, Dd, Dd^Edpp, Dd, Dd, Dd, Hd, Ds^Esd, Ds, Dd, Ds, Hd^Qhu, Ds^Qhu, Dd^Qhu, Dd^Qhu, Hd^Qhu, Ds, Hd, Dd, Dd, Gs^Qhh, Gs^Qhh, Gs^Ftd, Gs^Ftd, Gs, Gs^Ftd, Re^Edb, Re^Edt, Cer, Gs^Ft, Gs, Gs^Ftd, Gs^Ftd, Re, Re, Re, Gs^Fmf, Gd^Vhr, Gs^Fds, Gs^Fp
Dd, Ds, Dd, Ds, Ds, Ds, Dd^Esd, Dd, Gd, Ds, Ds, Ds, Ds^Es, Ds^Edp, Ds, Hd^Qhu, Hd, Dd, Dd^Vdr, Dd^Edpp, Ds, Hd, Hd, Dd, Dd^Qhh, Ds, Gs^Ftd, Gs^Ftd, Re^Vhcr, Re^Edb, Re^Edb, Cer^Edb, 2 Ker, Cer, Re, Gs^Ftd, Re, Re, Gs^Fmf, Gs^Fmf, Gs^Fmf, Gs^Fp, Gs^Fp, Gs^Fp
Dd^Edp, Dd, Dd, Dd, Dd^Ftd, Ds^Esd, Dd, Dd^Edpp, Gd, Ds, Dd^Ftd, Gd, Gd, Ds, Ds, Hd, Ds, Dd, Ds^Edpp, Ds^Edpp, Hd, Hd, Dd, Dd^Es, Dd, Gs^Qhh, Gs, Gd, Gd^Edt, Re, Re^Edb, Cer, Cer, Cer^Edt, Gs^Edb, Re, Gs^Ftd, Gs^Fmf, Gs^Ftd, Gs^Es, Gs, Gs^Fp, Gs^Ftd, Gs^Ftd
Dd, Dd^Edpp, Dd, Gs, Gd^Ft, Dd^Ftd, Dd^Es, Gd, Gd, Dd, Dd^Ftd, Gs^Ft, Gd^Ft, Gd, Ds, Ds, Ds, Ds, Dd, Ds^Edpp, Dd, Dd, Dd, Dd^Edpp, Gs^Qhh, Gs^Qhh, Dd, Gd^Ftd, Gd^Ft, Re, Re, Gs, Gs, Re^Edb, Gs^Edb, Re^Edb, Gs, Gs^Fp, Gs^Fp, Gs^Es, Gs^Ftd, Gs^Ftd, Gs^Ftd, Gs^Ftd
Hd, Ds^Edpp, Dd, Gs^Ftd, Gd^Ftd, Gd, Dd, Dd, Dd^Ftd, Dd, Gs^Ftd, Gs^Ftd, Ds^Ft, Gs^Ftd, Gs, Dd, Gs, Dd, Dd^Ftd, Dd, Gs, Gs^Ftd, Gs, Dd, Ds^Qhh, Ds, Gs, Gs^Ftd, Gd^Edt, Re^Vct, Gd^Ftd, Gd^Ftd, Gs, Gs, Re^Edb, Re^Edb, Gs^_mh, Gs^Fmf, Gs^Ftd, Gs^Fp, Gs^Ftd, Gs^Ftd, Gs^Fp, Gs^Fp
Ds, Ds, Dd^Ftd, Gd^Ftd, Gd, Rd, Gs^Ftd, Gs^Ft, Dd^Ftd, Dd, Dd^Ftd, Ds^Ftd, Ds^Ftd, Gs^Ftd, Gs^Ftd, Dd, Dd, Dd, Dd, Dd, Gs, Gs^Ftd, Gs^Ftd, Dd, Gs, Dd^Qhh, Gs, Gs, Gs, Gd^Ftd, Gd, Gd, Gs, Re, Gs, Gs, Ds, Gs^Fp, Gs, Gs, Gs^Ftd, Gs^Fp, Gs^Fp, Gs^Fp
Ds^Qhu, Ds, Ds, Dd^Ftd, Gs^Ftd, Gs, Gs^Ft, Gs^Ftd, Re^Vct, Dd, Dd, Ds, Gs, Gs^Es, Gs, Dd, Chr, Gs, Gs, Hhd, Hhd, Gd^Ft, Gd^Ftd, Gs, Hhd^Qhh, Hhd^Qhh, Dd, Dd, Ds, Dd, Gs, Hhd, Hhd, Re, Gd^Edb, Chr, Ds, Gs, Gs, Gs^Fp, Gs^Fmf, Gs^Fp, Gs^Fmf, Gs^Fp
Dd, Rd^Qhu, Rd, Gs^Ft, Gs^Ftd, Gs, Gs, Re, Re, Rd, Rd, Rd, Gs^Ftd, Gs, Gs, Gs, Gs, Gs, Ds, Hhd, Hhd, Gd, Gd, Gs^Es, Hhd^Qhh, Hhd, Gs^Qhh, Ds^Edpp, Gs^Qhh, Gs, Hhd, Hhd, Hhd, Gd^Edb, Gd^Edb, Ds, Ds, Gd, Gs^Fdf, Gs^Fmf, Gs^Fdf, Gs^Fmf, Gs^Fmf, Gs^Fp
Rd, Rd^Qhu, Gs^Ftd, Gs^Ftd, Gs, Gs, Cer, Cer^Edt, Cer, Rd^Edt, Rd^Vdr, Rd, Gs^Edb, Gs, Gs^Ftd, Gs^Ftd, Gs, Gs, Gs, Gd, Gs, Hhd, Gs, Hhd^Qhh, Dd, Dd^Qhh, Gs, Gs^Qhh, Gs, Hhd^Qhh, Hhd^Qhh, Hhd^Qhh, Hhd^Qhh, Gd, Re^Qhh, Gd^Qhh, Hhd^Qhh, Gd, Gd, Gg, Rp^Vhcr, Gg^Ftd, Gs^Fmf, Gs^Fp
Ww, Rd^Qhu, Gs^Qhu, Gs, Gs, Re, Cer^Edt, 3 Ker, Cer^Edb, Re^Edb, Re, Rd^Es, Gs^Edb, Gs^Edb, Gs, Hhd, Ds, Dd, Gs, Gs^Ftd, Gs, Gd, Gs^Ftd, Gs^Ft, Gs^Ftd, Gs, Gd^Ftd, Gd, Gs, Hhd^Qhh, Hhd^Qhh, Gs, Gs, Hhd^Qhh, Gs, Re, Gd, Gd^Qhh, Gs^Fdf, Gs^Fp, Re, Gs^Ftd, Gs^Ftd, Gs^Fp
Gs, Wwf, Ww^Ewf, Gs^Qhu, Re^Vdr, Re^Edt, Gs, Cer, Re, Re^Edb, Rd^Edb, Re, Gs, Gs^Edb, Re, Gs, Ds, Ds^Edpp, Gs, Gs, Hhd, Gs^Ftd, Gs, Gs^Ftd, Gs^Ft, Gs^Ft, Gs^Ftd, Gs, Gs^Edt, Gs, Gd, Gs, Gs^Edt, Gs, Re^Edt, Re, Gs, Gs^Qhh, Gs^Qhh, Gs, Re, Gs^Fp, Gs^Ftd, Gs^Fp
Gs, Gs, Wwf^Ewl, Gs^Qhu, Gs^Qhu, Gs, Gs^Ftd, Gs, Gs, Re^Vdr, Rd^Edb, Rd, Rd^Edp, Re^Edt, Gs, Re, Rd, Dd, Gs, Hhd, Hhd, Gs, Gs^Ftd, Gs^Vht, Gs, Gs^Ftd, Gs, Gs, Gs^Edt, Gd, Gd^Ftd, Chr, Gs^Es, Re^Edt, Gs^Vht, Gs^Fdf, Gs^Fdf, Gs, Gs^Qhhf, Gs^Es, Gs, Re, Re, Re
Gs, Dd^Edp, Dd, Wwf, Wwf^Ewl, Gs^Qhuf, Gs^Ft, Gs^Ftd, Dd, Dd^Edb, Rd^Qhu, Rd, Dd^Edp, Rd, Gs^Ftd, Gs, Hhd, Gs, Gs^Ftd, Hhd, Hhd, Gs, Gs, Rd, Dd, Gs^Ftd, Gs^Edt, Dd, Gd, Gd, Gd, Gs^Ftd, Gs, Re^Edt, Gg, Gs^Fdf, Gg, Gs^Fdf, Gs^Qhhf, Gs^Fdf, Gs, Gs, Gs^Ftd, Gs^Ftd
Dd, Dd^Esd, Dd, Gs, Ww, Gs^Qhu, Gs^Qhu, Dd, Dd^Edp, Rd, Rd^Qhu, Dd^Esd, Dd, Rd, Gs^Ftd, Gs^Ftd, Hhd, Hhd, Gs, Gs, Dd, Gs, Gs, Rd^Edt, Rd, Dd^Esd, Dd, Dd, Gd, Gd, Ds, Gs^Qhu, Re, Re, Gg, Gg, Gg, Gg, Gs^Fmf, Gs^Qhhf, Gs^Qhhf, Gs^Fp, Gs^Fp, Gs^Ftd
Dd, Dd, Gs^Ftd, Gs, Gs^Ftd, Wwt, Ww, Dd^Qhu, Ds^Qhu, Rd^Qhu, Gd, Dd, Rd^Edt, Rd, Rd^Vdr, Gs^Ftd, Gs^Edb, Gs^Ftd, Rd, Rd, Ds, Gs, Hhd, Gs, Gs^Edt, Dd^Qhu, Dd^Qhu, Re, Re, Gd, Ds^Qhu, Ds^Qhu, Re^Qhu, Gs, Gs^Fdf, Gg, Gs^Fdf, Gg, Gs^Fmf, Gs^Fmf, Gs^Qhhf, Gs^Ftd, Gs^Qhhf, Gs^Ftd
Ds, Dd^Es, Gs^Ft, Gs^Ftd, Re^Vdr, Gs^Ft, Gs^Ftd, Wwf^Ewl, Wwf^Ewf, Gd^Qhu, Chr^Qhu, Gd^Dr, Gd^Edt, Re, Gs, Gs^Edb, Dd^Edb, Gs, Dd, Dd, Dd, Gs, Hhd, Gs, Gs^Edt, Gs, Gs, Gs^Qhu, Ds^Qhu, Rd, Rd, Gs, Re, Gs^Qhu, Gs^Fdf, Gs^Fmf, Gs^Ftd, Gs^Ftd, Gs^Fp, Gs^Fmf, Gs^Fmf, Gs^Qhhf, Gs^Fp, Gs^Qhhf
Ds, Dd, Gs, Gs^Ftd, Re^Edb, Gs^Ftd, Gs, Gs, Gs, Ww, Ww, Gd, Re^Edt, Re, Gs^Es, Dd, Gs, Gs, Gs, Dd, Gs^Ftd, Hhd, Hhd, Hhd, Hhd, Gs^Vht, Gs^Edt, Gs, Gs^Qhu, Ds, Ds, Re, Re, Gs^Qhu, Gs^Qhu, Gs, Gs^Ftd, Gs^Ftd, Gd^Vhr, Gs^Fp, Gs^Fp, Gs^Fp, Gs^Fp, Gs^Fmf
Gs^Ftd, Gs, Re^Vct, Re^Edt, Re^Edt, Re, Cer^Edb, Re, Re, Gs^Ftd, Wwf^Ewl, Re^Edt, Gs, Gs, Gs, Gs, Hhd, Dd, Gs^Ftd, Gs, Gs, Hhd, Gs, Hhd, Gs, Gs, Ds^Qhu, Gs^Qhu, Gs^Ft, Ds^Ftd, Ds^Ftd, Gd^Edt, Re^Edt, Gs, Gs, Gs, Gs, Gs, Gs^Es, Gs^Edt, Gs^Edt, Gs, Gs^Fmf, Gs^Fmf
Gs^Ftd, Gs^Es, Rd, Re^Edt, Cer^Edb, Cer^Edb, Cer^Edb, Re^Edb, Gs, Wwf, Ww, Gs, Gs, Gs^Ftd, Gs^Ftd, Hhd, Hhd, Gs^Ftd, Gs, Gs^Ftd, Hhd, Hhd, Gs^Ftd, Hhd, Gs^Es, Gs^Edt, Ds^Qhu, Gs, Gs, Gs^Ftd, Gd^Vhr, Gs^Edt, Gs^Edt, Re, Re, Ce, Ce, Gs, Gs, Gs, Gs, Gs, Gs^Fp, Gs^Fp
Gs, Rd^Es, Rd, Cer, Re^Edb, 4 Ker^Edb, Cer^Edb, Re^Edb, Gs^Ftd, Wwt, Wot, Gs^Ftd, Wwf, Wwf, Gs^Ft, Hhd, Gs, Gs^Ft, Gs^Ftd, Gs, Gs^Ftd, Gs, Dd^Ftd, Gs, Dd^Ftd, Ds^Qhu, Ds^Edt, Ds, Gs, Gs, Gs, Gs^Edt, Gs, Gs, Gs, Ce, 1 Ke, Ce, Re, Gs, Gs, Gd^Vhr, Gs, Gs^Fp
Rd, Rd, Re^Vdr, Re, Re, Cer^Edb, Gs, Gs, Wwrt, Wwt, Wwrt, Wwrt, Chr, Sm, Sm, Gs^Ftd, Gs, Gs^Ftd, Hhd, Gs^Ft, Gs, Gs, Gs, Ds^Ftd, Ds^Edpp, Ds^Qhu, Gs^Qhu, Gs^Ftd, Gs^Ft, Gs, Gs^Ftd, Gs^Fp, Gs^Fp, Gs, Gs, Ce, Gs, Ce, Gs, Re, Rp, Gs, Rp, Rp
Gs^Ftd, Rd, Gs, Gs^Ftd, Gs, Gs, Gs^Ftd, Sm, Wwt, Wwt, Ww^Ewl, Ww, Wwf, Chr, Sm, Sm, Hhd, Hhd, Hhd, Gs^Ftd, Gs^Ftd, Gs, Gs, Gs, Dd, Gs, Ds^Qhu, Gs, Ds^Ftd, Ds^Ftd, Ds^Ftd, Gs^Ftd, Gs^Ftd, Gs^Fmf, Gs, Gs^Edt, Gs, Gs, Gs, Gs^Edt, Gs, Rp, Gs, Rp
Gs^Ftd, Gs^_ml, Gs, Gs^Ftd, Gs^Ftd, Gs^Ftd, Wwf, Ww, Ww, Wwrt, Sm, Ww^Ewl, Gs^Ftd, Ww, Ww, Sm, Gs, Hhd, Hhd, Gs, Gs^Ft, Gs^Ft, Gs, Dd, Gs, Gs^Es, Dd^Qhu, Ds^Ftd, Gs^Ftd, Ds^Ftd, Gs^Ftd, Gs^Fmf, Gs^Fmf, Gs^Fmf, Gs^Fmf, Gd^Vhr, Gs^Fp, Gg, Gs^Fp, Gs^Edt, Gs^Fmf, Gs, Gs^Ftd, Gs^Ftd
Gs^Ftd, Gs^Ftd, Gs^Ftd, Gs^Ftd, Gs^Ftd, Gs, Ww, Ww, Sm, Sm, Gd, Gs^Ftd, Gs^Ftd, Gd^Edt, Wwf, Wwf, Ww, Gs, Gs, Gs, Dd^Ftd, Gs^Ftd, Gs^Ftd, Gs, Gs, Dd^Qhu, Dd^Ftd, Ds^Ftd, Ds, Gs, Gs, Gs^Ftd, Gs^Fp, Gs^Fmf, Gs^Fmf, Gs^Fp, Gg, Gs^Ftd, Gs^Fp, Gs^Fmf, Gs^Fmf, Gs^Fp, Gs^Fp, Gs^Fp
