border_size=1
usage=map

Wwt, Wwt, Ds, Rr, Rr, Rr, Rp, Gs^Fp, Gs^Fp, Gs^Fp, Gs^Fp, Rp, Rp, Gs^Fp, Gs^Fp, Gs^Fmw, Gs^Fmw, Gs^Fp, Gs^Fp, Gs^Fp, Gs^Fmw, Gs^Fp, Gs^Fp, Gs^Fp, Gs^Fmw, Gs^Fp, Gs^Fp, Gg, Rp, Gg, Gs^Fp, Gs^Fp, Gs^Fms, Gs^Fmw, Gs^Fp, Gs^Fp, Gs^Fp, Gs^Fds, Gs^Fmw, Gs^Fds, Gs^Fp, Gs^Fp
Wwt, Wwt, Ds, Rr, Rr, Rp^Vhc, Rp, Rp, Rp, Gs^Fp, Gs^Fp, Rp, Rp, Gs^Fp, Gs^Fp, Gs^Fmw, Gs^Fmw, Gs^Fmw, Gs^Fp, Gs^Fmw, Gs^Fp, Gs^Fmw, Gs^Fp, Gs^Fp, Gs^Fp, Gs^Fp, Ch, Gg, Rp, Gg^Efm, Gg^Em, Gs^Fmw, Gs^Fmw, Gs^Fmw, Gs^Fp, Hh^Fp, Hh^Fp, Gs^Fmw, Gs^Fp, Hh^Fp, Gs^Fp, Gs^Fp
Wwt, Wwt^Bw/, Wwt, Ds, Ds, Rr, Gg, Rr, Rr, Rr, Rr, Rr, Rr, Gs^Fp, Gg, Gs^Fp, Gs^Fp, Gs^Fmw, Gs^Fmw, Gs^Fp, Gs^Fp, Gs^Fmw, Gs^Fp, Gs^Fp, Gs^Fp, Ch, Ch, Gg^Em, Gg, Rp, Gg, Gs^Fmw, Gs^Fp, Gs^Fmw, Hh^Fmw, Hh^Fp, Gs^Fp, Hh^Fp, Hh^Fmw, Hh^Fmw, Hh^Fmw, Gs^Fp
Wwt, Wwt, Wwt, Wwt^Bw/, Ds, Ds, Gg, Gg^Es, Ch, Rr, Rp, Rp^Vhc, Rp, Gg, Gg, Gg^Es, Gg, Gs^Fp, Gs^Fmw, Gs^Fp, Gs^Fmw, Gs^Fp, Gs^Fp, Gs^Fp, Gg, Gg, Gg^Efm, Gg, Gg^Vh, Rr, Gg^Fet, Gg, Gg, Gs^Fp, Hh^Fmw, Gs^Fp, Gs^Fp, Hh^Fmw, Hh^Fmw, Hh^Fmw, Hh^Fp, Gs^Fp
Wwt, Wwt, Wwt, Wwt, Ds, Gg, Ch, Ch, Rrc, Rr, Ch, Rp, Rr, Rp, Rr, Gg, Gg, Gs^Fp, Gs^Fp, Gs^Fmw, Gs^Fp, Gs^Fp, Gs^Fp, Gg^Em, Gg, Gg^Fet, Gg^Vh, Gg^Efm, Rr, Rr, Gg^Es, Gg^Vh, Gg, Gg, Ch, Ch, Gg, Hh^Fmw, Gs^Fmw, Gs^Fp, Gs^Fp, Hh^Fp
Wwt, Wwt, Wwt, Wwt, Ch, Ch, Rrc, Rrc, Ch, Rrc, Rrc, Ch, Ch, Rr, Rp^Vhc, Rr, Rr, Gg, Gg, Gs^Fp, Gs^Fp, Gs^Fp, Gs^Fp, Ch, Gg^Es, Gg, Gg, Gg, Rr, Gg^Efm, Gg, Gg, Gg^Vh, Gg^Efm, Ch, Gg, Gg, Hh^Fdw, Gg, Gs^Fmw, Gg, Gg^Em
Wwt, Wwt, Ch, Ch, Rrc, Rrc, Ch, Ch, 2 Kh, Ch, Ch, Rrc, Rrc, Rr, Rr, Rr, Gg, Rr, Rr, Gg, Gs^Fp, Gs^Fp, Gg, Ch, Gg^Efm, Gg, Gg^Vh, Gg, Rr, Rr, Rr, Gg, Gg^Fet, Gg, Gg, Gg, Gg, Gg, Gg, Gs^Fmw, Gg, Gg
Wwt, Ch, Rrc, Rrc, Rrc^Vhc, Rrc, Ch, Ww, Ch, Ch, Rrc, Rrc, Ch, Ch, Ds, Ds, Ds, Gg, Gg, Rr, Rr, Gg, Gg, Gg, Gg, Gg^Fet, Rr, Rr, Gg^Vh, Gg, Gg^Vh, Rr, Rp, Gg, Rp, Gg, Rp, Gg, Rp, Gg^Em, Gg, Gg
Wwt, Ch, Ch, Rrc, Rrc, Rrc, Ds, Ch, Rrc, Rrc, Rrc^Vhc, Ds, Wwt, Ww, Wwt, Ww, Ch, Ds, Ds, Gg, Gg, Rp, Rp, Gg, Rp, Rp, Gg, Gg, Gg, Gg, Gg, Gg, Ch, Rp, Gg^Wm, Rp, Gg, Rp, Gg^Efm, Rp, Rp, Gg
Wwt, Wwt, Wwt, Ch, Ch, Ds, Wwt, Ds, Rrc, Rrc, Rrc, Ds, Ds, Wwt, Wwt, Wwt, Wwt, Ch, Ww, Ds^Es, Ds, Gg, Gg, Rr, Rr, Gg, Gg, Ch, Ch, Gg, Ch, Gg, Re^Gvs, Re^Gvs, Re^Gvs, Gg, Gg, Gg, Re^Gvs, Gg, Gg, Rp
Wot, Wwt, Ds, Wwt, Wwt, Wwt, Wwt, Wwt^Bw/, Wwt, Rrc, Rrc, Rrc^Vhc, Rrc, Ds, Wwt, Wwt, Wwt, Wwt, Ds^Es, Ww, Ds, Gg, Gg, Gg^Es, Gg, Rp, Gg, Gg, Gg, Ch, Gg, Gg, Gg, Re^Gvs, Gg, Gg^Vh, Re^Gvs, Re^Gvs, Re^Gvs, Re^Gvs, Re^Gvs, Gg
Wot, Wwt, Wwt, Wwt, Wwt, Wwt, Wwt, Wwt, Wwt, Wwt^Bw/, Wwt, Rrc, Wwt, Wwt^Bw\, Wwt, Wwt, Wwt, Wwt, Ww, Ww, Ch, Ds, Gg, Gg, Gg, Rp, Gg, Gg, Gg, Gg, Gg^Vh, Re^Gvs, Gg, Gg, Re^Gvs, Gg, Gg^Efm, Re^Gvs, Re^Gvs, Re^Gvs, Gg, Gg
Wot, Wot, Wot, Wwt, Wwt, Wwt, Wwt, Wwt, Wwt, Wwt, Wwt, Wwt^Bw|, Wwt, Wwt, Wwt, Wwt, Wwrt, Wwt, Ww, Ch, Ww, Ds^Es, Wwt, Gg, Ww, Rp, Gg, Gg, Re^Gvs, Re^Gvs, Re^Gvs, Gg, Re^Gvs, Re^Gvs, Gg, Gg^Efm, Gg^Efm, Gg, Gg^Es, Gg, Gs^Fmw, Gs^Fp
Wot, Wot, Wot, Wwt, Wot, Wwt, Wwt, Wwt, Wwt, Wwt, Wwt, Wwt, Wot, Wwt, Wwt, Wwt, Wwt, Wwt, Ww, Ww, Ch, Wwt, Ds^Es, Ww, Gg, Ww^Bsb|, Ww, Gg^Wm, Gg, Re^Gvs, Gg, Gg, Gg, Gg, Re^Gvs, Re^Gvs, Re^Gvs, Gg^Wm, Gg, Gg, Gs^Fms, Gs^Fmw
Wot, Wot, Wot, Wot, Wot, Wot, Wot, Wot, Wwt, Wwt, Wwt, Wot, Wwt, Wwt, Wwt, Wwt, Wwt, Ww, Ww, Ch, Ds, Ds^Es, Gg, Gg, Ch, Rp, Gg, Ww, Ww, Gg, Ch, Gg, Re^Gvs, Re^Gvs, Re^Gvs, Re^Gvs, Re^Gvs, Re^Gvs, Gg, Gg, Gs^Fmw, Gs^Fms
Wot, Wot, Wot, Wot, Wot, Wot, Wot, Wot, Wwt, Wwt, Wwt, Wwt, Wot, Wwt, Wwt, Wwt, Wwt, Wwr, Ww, Ww, Chr, Ds^Es, Gg, Gg, Gg, Rp, Rp, Gg, Gg, Ww, Ww, Gg, Gg, Re^Gvs, Re^Gvs, Re^Gvs, Gg, Gg^Vh, Re^Gvs, Gg, Gg, Gs^Fds
Wot, Wot, Wot, Wot, Wot, Wot, Wot, Wot, Wot, Wot, Wot, Wot, Wot, Wwt, Wwrt, Ds, Wwt, Wwt, Ww, Chw, Ds^Es, Ds, Gg, Gg, Gg, Gg, Rp, Ch, Gg, Gg, Gg, Ww, Ww, Gg, Gg, Gg, Re^Gvs, Re^Gvs, Re^Gvs, Re^Gvs, Re^Gvs, Gg
Wot, Wot, Wot, Wot, Wot, Wot, Wot, Wot, Wot, Wot, Wot, Wot, Wwt, Wwt, Wwt, Ds, Ds^Es, Ds, Ww, Ww, Ds, Gg, Re^Gvs, Re^Gvs, Gg, Gg, Rr, Gg, Gg, Gg^Es, Re^Gvs, Gg, Gg, Ww, Ww, Gg, Gg, Re^Gvs, Re^Gvs, Re^Gvs, Re^Gvs, Re^Gvs
Wot, Wot, Wot, Wot, Wot, Wot, Wot, Wot, Wot, Wot, Wot, Wwt, Wwt, Wwt, Wwrt, Wwt, Ds, Wwr, Chr, Chr, Ds, Gg^Es, Re^Gvs, Re^Gvs, Gg, Gg, Rr, Gg, Gg^Efm, Re^Gvs, Re^Gvs, Re^Gvs, Re^Gvs, Gg, Gg, Ww, Ww, Gg, Gg, Re^Gvs, Gg, Gg
Wwrt, Wwrt, Wwrt, Wot, Wot, Wot, Wot, Wot, Wot, Wot, Wot, Wwt, Wwt, Wwt, Wwrt, Wwt, Wwt, Wwt, Ww, Ww, Ds, Gg^Edt, Gg, Gg, Gg^Vhr, Gg, Rp, Gg, Gg, Re^Gvs, Re^Gvs, Re^Gvs, Re^Gvs, Gg, Gg, Gg, Gg, Ww, Ww, Gg, Gg, Re^Gvs
Wwt, Wwrt, Wwrt, Wot, Wwt, Wot, Wot, Wot, Wot, Wot, Wwt, Wwt, Wwrt, Wwrt, Wwt, Wwt, Wwt, Wwt, Wwf, Ds, Chr, Chr, Gg^Edt, Gg^Edt, Rp, Rp, Re^Gvs, Re^Gvs, Re^Gvs, Gg, Gg, Re^Gvs, Gg, Gg^Efm, Re^Gvs, Re^Gvs, Re^Gvs, Gg, Gg, Ww, Ww, Gg
Wwt, Wwt, Wwt, Wwrt, Wwt, Wot, Wot, Wot, Wot, Wot, Wwt, Wwt, Wwt, Wwrt, Wwt, Wwt, Wwrt, Wwf, Ds^Es, Ds, Chr, 3 Khr, Chr, Rp, Gg^Edt, Re^Gvs, Re^Gvs, Re^Gvs, Gg, Gg, Gg, Gg, Gg, Gg, Gg, Re^Gvs, Re^Gvs, Re^Gvs, Gg, Gg, Ch, Ww
Wwt, Wwt, Wwt, Wwt, Wwr, Wwt, Ds, Wot, Wot, Wot, Wot, Wwt, Wwt, Wwt, Wwrt, Wwt, Wwf, Ww, Ds, Chr, Gg^Edt, Chr, Chr, Rp, Gg^Vhr, Gg, Gg, Gg, Gg, Gg, Gg, Gg^Es, Gg^Efm, Hh, Gs^Fp, Gg, Gs^Fp, Gg, Hh, Gg, Gs^Fp, Gg
Ds, Wwt, Wwf, Wwt, Ww, Wwt, Wwt, Wwt, Wot, Wot, Wot, Ds, Wwt, Wwrt, Wwt, Wwf, Ds, Ww, Ww, Ds, Gg^Edt, Gg, Gg, Rp, Gg, Gg^Edt, Gg, Hh^Fdw, Gg, Hh^Fdw, Hh, Gg, Gg, Gs, Gs^Fp, Hh^Fp, Hh, Hh^Vhh, Mm, Hh^Fp, Mm, Hh^Fp
Wwf, Ds, Wwr, Ds, Ww, Ww, Wwr, Wwt, Wwrt, Wot, Wwrt, Wwt, Wwt, Wwt, Wwf, Ds^Es, Wwrt, Ww, Ds^Es, Ds, Gg^Vhr, Gg^Edt, Re, Rp, Gg, Gg, Hh, Gg, Hh, Mm, Mm, Mm, Gs, Hh, Gs, Hh, Gs, Mm, Hh, Mm, Mm, Mm
Wwr, Wwr, Wwr, Ww, Ww, Ww, Wwt, Wwt, Wwt, Wwrt, Wwt, Wwrt, Wwt, Wwt, Wwt, Ds, Wwrt, Ds^Es, Ds, Gg, Gg, Rp, Gg^Edt, Gg^Es, Gg, Hh, Hh^Vhh, Hh^Fp, Hh, Mm, Hh^Fmw, Hh, Mm, Gs, Gs, Gs, 1 Gs, Gs, Hh, Mm, Hh, Hh
Wwt, Wwt, Wwt, Ww, Wwt, Ww^Vm, Wwt, Wwrt, Wwt, Wwt, Wwt, Wwt, Wwt, Wwr, Wwt, Wwrt, Ds, Ds^Es, Gg, Gg, Gg, Rp, Gg, Gg, Gg, Hh, Gg, Hh, Hh^Fmw, Hh, Gg, Hh, Hh, Hh, Gs, Gs, Gs, Gs, Gs, Hh, Gg, Gg
Ww, Wwt, Wwf, Ds, Ds, Ww, Wwr, Wwr, Ww, Ww^Vm, Ww, Wwt, Ds, Ww, Wwt, Wwt, Ds, Ds, Gg, Gg^Edt, Gg, Rp, Re, Hh, Hh, Hh^Fdw, Hh, Hh^Fp, Gg, Gg, Gs, Gs, Hh^Fdw, Gs, Gs^Vht, Gs, Gs, Gs, Gs^Vht, Gs, Gs, Gg
Ww, Wwr, Wwf, Ds, Wwr, Ww, Ww, Ds, Wwr, Ww, Wwr, Wwt, Wwt, Ww, Ds, Ds^Es, Gg, Gg, Gg, Gg, Ss, Gg, Gg, Re, Re, Gg, Gg, Gg, Rp, Gg, Re, Rp, Gs, Rp, Rp, Gs, Re, Gs, Rp, Rp, Rp, Rp
Ds, Wwr, Ww, Wwr, Ds, Ww, Ss, Ds, Ds, Ww, Ds, Wwt, Ww, Ww, Ss, Ss, Gs^Fp, Gs^Fp, Gs^Fmw, Gs^Fp, Ss, Gg, Gg, Re, Gg, Re, Re, Rp, Gs^Fp, Rp, Gs, Gs, Gs^Fp, Gs, Gg, Re, Gs, Re, Hh^Fp, Gs, Hh^Fp, Gs
Ds, Ww, Ds, Ds, Ds, Ds, Ss, Ss, Ss, Ss^Vhs, Ds, Ww, Ss, Ss, Ss, Gg, Gg^Es, Gg, Gg, Gs^Fp, Ss, Ss, Gs, Gs, Gs, Gg, Gg, Gg, Gg, Gg, Gs^Fp, Gs^Fp, Gs^Fp, Gs^Fp, Gg, Gs^Es, Mm^Vhh, Hh, Hh^Fmw, Hh^Fp, Hh^Fmw, Hh^Fp
Gg, Ds, Ds, Ss, Ss, Ds, Chs, Ss, Ss, Ss, Ds, Ds, Ss, Ss, Gg, Gg, Gg, Gg, Ss, Ss, Gs^Fp, Ss, Ss^Bw|r, Gs, Ss, Gg^Es, Gg, Hh, Gg, Hh, Gs^Fp, Gg, Gs^Fp, Gs^Fp, Gs^Fp, Hh, Mm, Mm, Mm, Mm, Mm, Mm
Gs^Fp, Gs^Fp, Ss, Ss, Ss, Chs, Chs, Chs, Chs, Chs, Ss, Ds, Chs, Chs, Gg, Gg, Gs^Fp, Ss, Ss^Vhs, Gs^Fp, Gs^Fp, Gs, Re, Ss, Gs, Ss, Hh, Hh^Fdw, Gg, Hh, Hh, Gg, Hh^Fp, Hh^Fdw, Gg, Hh, Hh, Mm, Mm, Mm, Mm^Xm, Mm
Gs^Fp, Ss, Gg, Ss^Vhs, Ss, Ss, Ss, Chs, 4 Khs, Chs, Chs, Ss, Chs, Chs, Gg, Gs^Fmw, Gs^Fp, Ss, Gs^Fp, Gs^Fmw, Gs, Gs, Re, Gs, Gg, Ss, Ss, Gg, Hh, Hh, Hh^Fdw, Gg, Hh, Hh, Gg, Hh, Hh^Fp, Hh^Fmw, Mm, Mm, Mm^Xm, Mm^Xm
Gg, Gg, Gg, Gs^Fp, Gs^Fp, Ss, Gs, Chs, Chs, Chs, Ss, Ss, Gg, Gg, Gg, Gs^Fp, Ss, Ss, Ss, Gs^Fmw, Gs^Fp, Gs, Re, Re, Gg, Ss, Gg, Hh, Gs^Fp, Hh^Fmw, Hh^Fp, Hh, Hh, Hh^Fmw, Gg, Hh, Hh, Hh, Mm, Mm^Xm, Mm, Mm^Xm
Gg, Gg, Gg, Gs^Fp, Ss, Ss, Ss^Vhs, Gs, Chs, Chs, Gs, Ss, Ss, Ss, Ss, Ss, Ss^Vhs, Ss, Gs^Fp, Gs^Fmw, Gs, Re, Gs, Gg, Ss, Ss, Gs^Fp, Hh, Hh^Fp, Hh^Fdw, Hh, Hh^Vhh, Hh, Hh, Gs, Gg, Gg, Hh, Mm^Xm, Mm, Mm^Xm, Mm
Gs^Fp, Gs^Fp, Gg, Gs^Fp, Ss, Ss, Gs^Fp, Gs^Fp, Gs, Gs, Gs, Gs^Fp, Ss, Gs^Fp, Gs, Ss, Gg, Ss, Gs^Fp, Gs, Re, Gs, Ss, Ss, Gs^Fmw, Gs^Fdw, Gs^Fmw, Gs, Hh, Hh^Fp, Hh, Gs^Fp, Hh^Fmw, Hh^Fp, Hh^Fp, Gs, Hh^Fp, Mm, Mm, Mm, Mm^Xm, Mm^Xm
Gg, Gs^Fp, Gg, Gg, Ss, Ss, Ss, Gs^Fp, Gs^Fp, Gs, Gs^Fp, Gs^Fp, Ss, Gs, Gs^Es, Gg, Re, Ss, Ss, Re, Gs^Fp, Gs^Fdw, Ss, Ss, Ss, Gs^Fdw, Gs^Fmw, Gs, Hh, Hh, Gs^Fdw, Gs^Fp, Gs^Fdw, Hh, Hh^Fmw, Hh, Hh, Hh, Hh, Mm, Mm, Mm^Xm
Gg, Gg^Es, Gs^Fp, Ss, Gg, Gg, Gg, Gg, Gs, Gs, Gg, Ss, Gg, Gs, Re, Gs, Gg, Gg, Ss, Gs^Fdw, Gs^Fp, Gs^Fp, Ss, Gs^Fmw, Ss, Gs^Fp, Gs, Hh, Gs^Fp, Gs^Fmw, Gs^Fmw, Gs^Fmw, Hh^Fp, Hh, Hh, Hh^Fdw, Mm, Mm^Xm, Mm, Mm, Mm, Mm^Xm
Gg, Gs^Fp, Gs^Fp, Gg, Gs^Fp, Gg, Gg, Gs, Gg, Re, Re, Gg, Gs, Re, Gs, Gs, Gs^Fdw, Gs, Ss, Gs^Fmw, Gs^Fp, Ss, Gs^Fdw, Gs^Fmw, Ss, Gs^Fp, Gs, Gs, Ss, Gs^Fdw, Hh^Fmw, Hh, Hh, Mm, Mm, Mm, Mm, Mm, Hh^Fdw, Hh, Hh^Fdw, Mm
Gs^Fp, Gs^Fmw, Gs^Fmw, Gs^Fmw, Gs^Fp, Gg, Gs^Fp, Gs^Fp, Gs^Fp, Gg, Re, Gs, Re, Re, Gs, Gs^Fdw, Gs^Fdw, Ss, Ss, Ss, Ss, Ss, Gs^Fp, Gs^Fmw, Gs, Ss, Ss, Ss, Ss, Gs^Fp, Gs^Fdw, Hh, Hh^Fmw, Mm, Hh, Mm, Hh^Fdw, Hh, Hh^Fp, Hh^Fmw, Hh^Fp, Hh
Gs^Fp, Gs^Fp, Gg, Gs^Fp, Gs^Fmw, Gs^Fmw, Gg, Gg, Gg, Gg, Re, Re, Gg, Gs, Gs^Fp, Gs^Fmw, Gs^Fp, Ss, Ss, Ss, Gs, Gs^Fp, Gs^Fmw, Gs^Fmw, Gs^Fp, Gs^Fp, Gs^Fp, Ss, Gs^Fp, Gs^Fp, Gs^Fp, Gs^Fp, Gs^Fp, Gs^Fp, Hh, Hh, Gs^Fp, Hh^Fmw, Hh^Fmw, Hh^Fmw, Hh, Hh^Fp
