border_size=1
usage=map

Hh          , Hh          , Gs^Ft       , Hh          , Hh          , Hh          , Hh          , Hh          , Gs^Ft       , Gs^Ft       , Gs^Ft       , Gs^Ft       , Gs^Ft       , Hh          , Hh          , Re          , Hh          , Hh          , Hh          , Gs^Ft       , Gs^Ft       , Gs^Ft       , Gs^Ft       , Gs^Ft       , Gg^Ft       , Gg^Ft       , Gs^Ft       , Gs^Ft       , Gs^Ft       , Gs^Ft       , Re          , Re          , Gg^Ft       , Gs^Ft       , Gs^Ft       , Gs          , Gs^Ft       , Gs^Ft       , Gs^Ft       , Gs^Ft       , Gs^Ft       , Gs^Ft       
Hh          , Gs^Ft       , Gs^Ft       , Gs          , Gs          , Hh          , Gs^Ft       , Gs          , Gs^Ft       , Gs^Ft       , Gg^Ft       , Gs^Ft       , Gs^Ft       , Hh          , Gs^Ft       , Re          , Rd          , Hh          , Gs^Ft       , Gs^Ft       , Gs          , Gs          , Gg^Ft       , Gg^Ft       , Gg^Ft       , Gg^Ft       , Rd          , Re          , Re          , Re          , Gs^Ft       , Gs^Ft       , Gg^Ft       , Gs^Ft       , Gs^Ft       , Gs^Ft       , Gs^Ft       , Gg^Ft       , Gg^Ft       , Gs^Ft       , Gs^Ft       , Gs^Ft       
Gs          , Gs^Ft       , Gs^Ft       , Hh          , Gs^Ft       , Gg^Ft       , Gg^Ft       , Gs^Ft       , Gs^Ft       , Gs^Ft       , Gs^Ft       , Gs^Ft       , Hh          , Hh          , Gs^Ft       , Gs^Ft       , Gs          , Rd          , Rd          , Gs          , Gs^Ft       , Gg          , Gg^Ft       , Gs^Ft       , Rd          , Rd          , Gs^Ft       , Gs^Ft       , Gs^Ft       , Gs^Ft       , Gs^Ft       , Gs^Ft       , Gs^Ft       , Gs^Ft       , Hh          , Gs^Ft       , Gs^Ft       , Gg^Ft       , Gg^Ft       , Gg^Ft       , Gs^Ft       , Gs^Ft       
Gs^Ft       , Gs^Ft       , Hh          , Gs^Ft       , Gs^Ft       , Gg^Ft       , Gs^Ft       , Gs^Ft       , Hh          , Gg^Ft       , Hh          , Hh          , Gs^Ft       , Gs^Ft       , Gs^Ft       , Gg          , Gs^Ft       , Gs          , Rd          , Re          , Gs^Ft       , Gs^Ft       , Gs^Ft       , Re          , Gs^Ft       , Gs^Ft       , Gs^Ft       , Gs^Ft       , Gg^Ft       , Gs^Ft       , Gg^Ft       , Hh          , Gg^Ft       , Gg^Ft       , Hh          , Hh          , Gg^Ft       , Gg^Ft       , Gg^Ft       , Gg^Ft       , Gg^Ft       , Gs^Ft       
Gs^Ft       , Gs^Ft       , Gs^Ft       , Gs^Ft       , Gg^Ft       , Gs^Ft       , Gs^Ft       , Wwt         , Hh          , Hh          , Hh          , Hh          , Gs^Ft       , Gg^Ft       , Gg^Ft       , Gg          , Gs^Ft       , Gs^Ft       , Re          , Re          , Re          , Re          , Gs^Ft       , Re          , Gs          , Gs^Es       , Gs          , Gs^Ft       , Gg^Ft       , Gs^Ft       , Hh          , Gs^Ft       , Gs^Ft       , Gg^Ft       , Gg^Ft       , Hh          , Gg^Ft       , Gs^Ft       , Gs^Ft       , Gg^Ft       , Gs^Ft       , Gs^Ft       
Gs^Ft       , Gs^Ft       , Hh          , Gg^Ft       , Gs^Ft       , Hh          , Hh          , Hh          , Hh          , Hh          , Hh          , Gs^Ft       , Gs^Ft       , Gg^Ft       , Gg^Ft       , Gg^Ft       , Gs^Ft       , Gs^Ft       , Re          , Gs^Ft       , Gs^Ft       , Re          , Re          , Re          , Gs          , Gs          , Gs^Ft       , Gs^Ft       , Gs^Ft       , Gs^Ft       , Hh          , Hh          , Gs^Ft       , Hh          , Gs^Ft       , Gs^Ft       , Hh          , Hh          , Hh          , Gg^Ft       , Gg^Ft       , Gs^Ft       
Gs^Ft       , Gs^Ft       , Hh          , Gs^Ft       , Gs^Ft       , Gs^Ft       , Hh          , Gs^Ft       , Hh          , Hh          , Hh          , Gs^Ft       , Gs          , Gg          , Gs^Ft       , Gg^Ft       , Gg^Ft       , Re          , Gs^Ft       , Gg^Ft       , Gs^Ft       , Re          , Re          , Gs          , Gg          , Gs^Ft       , Gs^Ft       , Gs^Ft       , Gs          , Hh          , Hh          , Gs^Ft       , Hh          , Hh          , Hh          , Gs^Ft       , Gg^Ft       , Gg^Ft       , Gs^Ft       , Gs^Ft       , Gg^Ft       , Gs^Ft       
Gs          , Gs          , Hh          , Gs^Ft       , Gs^Ft       , Gs^Ft       , Gs^Ft       , Gs^Ft       , Gs^Ft       , Hh          , Hh          , Gs          , Gs          , Gg^Ft       , Gg^Ft       , Gg^Ft       , Gg^Ft       , Gg^Ft       , Gs^Ft       , Gg^Ft       , Re          , Re          , Gs          , Gs          , Gg          , Gs          , Gs^Ft       , Gs^Ft       , Hh          , Hh          , Hh          , Gs^Ft       , Hh          , Hh          , Gs^Ft       , Gs^Ft       , Gs^Es       , Gg^Ft       , Gs^Ft       , Gs^Ft       , Gs          , Gs^Ft       
Gs^Ft       , Gs^Ft       , Gs^Ft       , Gs^Ft       , Gs^Ft       , Gs^Ft       , Gs^Ft       , Gs^Ft       , Hh          , Hh          , Hh          , Gs^Es       , Gg          , Gg          , Gs^Ft       , Gs^Ft       , Gs          , Gs^Ft       , Rd          , Re          , Gs^Ft       , Gs^Ft       , Gs^Ft       , Gg          , Gg          , Gs          , Gs          , Gs          , Gs          , Hh          , Gs          , Gs          , Gs          , Gs^Ft       , Gs          , Gs^Ft       , Gs          , Gs^Ft       , Gs^Ft       , Gs^Ft       , Gs          , Gs          
Gs^Ft       , Gs^Ft       , Gg^Ft       , Gg^Ft       , Gg^Ft       , Gs          , Gs          , Gs^Ft       , Hh          , Hh          , Hh          , Gs^Ft       , Gs^Ft       , Gs          , Gs^Ft       , Gs^Ft       , Gs^Ft       , Rd          , Gs^Ft       , Gs^Ft       , Gg^Ft       , Gs^Ft       , Gs          , Gg          , Gs          , Gs          , Gs^Ft       , Gs^Dr       , Gs          , Hh          , Gs^Ft       , Gs^Dr       , Gs          , Gs          , Gs          , Gs^Ft       , Gs          , Gs          , Gs          , Gs          , Ds          , Ds          
Gg^Ft       , Gg^Ft       , Gs^Ft       , Gg^Ft       , Gs^Ft       , Gs^Ft       , Gs          , Hh          , Hh          , Hh          , Gs^Ft       , Gs^Ft       , Gs^Ft       , Gs          , Gs          , Gs^Ft       , Re          , Rd          , Gs^Ft       , Gs^Ft       , Gg^Ft       , Gs          , Gs^Ft       , Gs          , Gg^Ft       , Gg^Ft       , Gs          , Gs          , Chr         , Chr         , Gs          , Gs          , Gs          , Gs          , Ds          , Gs          , Ds          , Gs          , Ds          , Ds^Es       , Ds          , Ds          
Gg^Ft       , Gg^Ft       , Gs^Es       , Gs          , Gg^Ft       , Gs^Es       , Gs          , Hh          , Hh          , Hh          , Gs          , Gs^Ft       , Gg          , Gs          , Gs          , Gs^Ft       , Re          , Re          , Gs^Ft       , Gg          , Gg          , Gg          , Gs^Ft       , Gs          , Gg^Ft       , Gg^Ft       , Gs          , Gs          , Chr         , Gs          , Ds^Dr       , Ds          , Ds          , Ds          , Ds          , Ds          , Ds          , Ds          , Ds          , Ds          , Chr         , Chr         
Gs^Ft       , Gg^Ft       , Gs          , Gs          , Gg          , Gg          , Gs^Ft       , Hh          , Gs          , Gs          , Gs          , Gs          , Gg^Ft       , Gg^Ft       , Gs^Ft       , Gs^Ft       , Re          , Re          , Gs          , Gs          , Gg^Ft       , Gg          , Gs          , Gg          , Gs          , Gs          , Gs          , Chr         , Ds          , Ds          , Wwt^Bw\r    , Ds          , Wwf         , Ds^Es       , Ds          , Chr         , Ds          , Ds          , Ds^Es       , Ds          , Ds          , Ds          
Gs^Ft       , Gs^Ft       , Chr         , Gs^Ft       , Gs^Ft       , Hh          , Gs^Ft       , Gs          , Gs          , Hh          , Hh          , Hh          , Gs          , Gg^Ft       , Gs^Ft       , Gs^Ft       , Rd          , Re          , Re          , Gs          , Gs^Ft       , Gg^Ft       , Gs          , Gg          , Ds          , Gs          , Gs^Dr       , Gs          , Ds          , Wwf         , Wwf         , Wwt         , Wwt         , Ds          , Wwrt        , Chw         , Wwt         , Wwf         , Ds          , Wwt         , Wwf         , Wwf         
Gs^Ft       , Gs^Ft       , Gs^Ft       , Gs^Ft       , Gs^Ft       , Hh          , Gg          , Gg          , Hh          , Hh          , Hh          , Hh          , Gs          , Gg^Ft       , Gs          , Gs          , Gs          , Re          , Re          , Gs          , Gs          , Gs          , Gs          , Gs          , Ds          , Ds          , Chr         , Ds          , Ds          , Chw         , Ds^Es       , Wwt         , Wwt         , Wwt         , Wwrt        , Wwrt        , Wwrt        , Wwt         , Wwt         , Wwt         , Wwt         , Wwt         
Hh          , Hh          , Hh          , Hh          , Hh          , Hh          , Gg          , Gs          , Gs          , Hh          , Gs          , Hh          , Gs          , Gs          , Gs          , Gs          , Gs          , Re          , Rb          , Gs          , Ds          , Chr         , Ds          , Ds^Es       , Ds          , Chw         , Wwt         , Ds          , Wwf         , Ds          , Wwt         , Wwt         , Wwt         , Wwrt        , Wwt         , Wwt         , Wwt         , Wwt         , Wwt         , Wwt         , Wwrt        , Wwrt        
Gs^Ft       , Gs^Ft       , Gs^Ft       , Gs^Ft       , Hh          , Hh          , Gs^Es       , Gs          , Hh          , Hh          , Gs          , Gs          , Gs          , Gs          , Gs          , Chr         , Ds          , Re          , Rb          , Ds          , Ds          , Ds          , Wwf         , Wwf         , Wwt         , Wwt         , Wwrt        , Wwt         , Wwt         , Wwt         , Wwt         , Wwt         , Wwt         , Wwt         , Wwt         , Wwt         , Wwrt        , Wwt         , Wwrt        , Wwrt        , Wwrt        , Wwrt        
Gs^Ft       , Gs^Ft       , Hh          , Hh          , Hh          , Hh          , Gs          , Gs          , Gs          , Gs          , Gs          , Gs          , Ds          , Gs          , Chr         , Chr         , Ds          , Rb          , Rb          , Ds          , Ds          , Ds          , Wwt         , Wwt         , Wwrt        , Wwrt        , Wwrt        , Wwrt        , Wwt         , Wwt         , Wwt         , Wwrt        , Wwt         , Wwt         , Wwt         , Wwt         , Wwrt        , Wwrt        , Wwt         , Wwt         , Wwrt        , Wwt         
Gs^Ft       , Gs^Ft       , Gs^Ft       , Gs^Ft       , Gs          , Gs          , Gs          , Gs          , Gs^Ft       , Gs^Ft       , Gs          , Gs          , Ds          , Ds          , Ds          , Ds          , Ds          , Ds^Es       , Ds          , Rb          , Ds^Es       , Wwf         , Wwf         , Wwt         , Wwt         , Wwt         , Wwt         , Wwt         , Wot         , Wot         , Wot         , Wot         , Wwt         , Wwt         , Wot         , Wwt         , Wwt         , Wwt         , Wot         , Wwt         , Wwt         , Wwt         
Gs^Ft       , Gs^Ft       , Wwt         , Wwt         , Gs          , Hh          , Hh          , Gs          , Gs          , Gs          , Ds          , Ds          , Wwf         , Wwt         , Wwt         , Wwf         , Wwrt        , Ds          , Ds^Es       , Rb          , Ds          , Wwf         , Wwt         , Wwt         , Wwt         , Wwt         , Wwrt        , Wwrt        , Wot         , Wot         , Wot         , Wot         , Wot         , Wot         , Wot         , Wwt         , Wwt         , Wwt         , Wot         , Wot         , Wwt         , Wwt         
Gs^Ft       , Wwt         , Wwt         , Wwt         , Hh          , Hh          , Gs          , Gs          , Gs          , Gs          , Ds          , Wwrt        , Wwrt        , Wwt         , Wwt         , Wwrt        , Wwt         , Ds          , Wwrt        , Ds^Es       , Ds          , Wwt         , Wwt         , Wwt         , Wwt         , Wwrt        , Wot         , Wot         , Wot         , Wot         , Wot         , Wot         , Wot         , Wot         , Wot         , Wwt         , Wwt         , Wwt         , Wot         , Wwt         , Wot         , Wot         
Gs^Ft       , Wwt         , Wwt         , Hh          , Hh          , Gs^Ft       , Hh          , Hh          , Gs          , Ds^Es       , Ds          , Wwrt        , Wwt         , Wwt         , Wwf         , Wwt         , Wwt         , Wwt         , Wwt         , Ds          , Wwt         , Wwt         , Wwt         , Wwt         , Wwt         , Wot         , Wot         , Wot         , Wwt         , Wot         , Wot         , Wot         , Wot         , Wot         , Wot         , Wot         , Wot         , Wot         , Wot         , Wot         , Wot         , Wot         
Gs^Ft       , Gs^Ft       , Wwt         , Hh          , Gs^Ft       , Gs^Ft       , Hh          , Hh          , Gs^Dr       , Ds          , Ds          , Ds          , Ds          , Wwt         , Wwt         , Wwt         , Wwt         , Wwt         , Wwt         , Wwt         , Wwt         , Wwt         , Wwt         , Wwt         , Wot         , Wot         , Wot         , Wwt         , Wwt         , Wwt         , Wot         , Wot         , Wot         , Wot         , Wot         , Wot         , Wot         , Wot         , Wot         , Wot         , Wot         , Wot         
Gs^Ft       , Gs^Ft       , Gs^Es       , Gs^Ft       , Gs          , Gs^Ft       , Gs          , Gs          , Ds          , Ds          , Ds^Es       , Ds^Dr       , Wwrt        , Wwt         , Wwt         , Wot         , Wot         , Wwt         , Wot         , Wwt         , Wwt         , Wwt         , Wwt         , Wwt         , Wwt         , Wot         , Wwt         , Wwt         , Wwt         , Wwt         , Wot         , Wot         , Wot         , Wot         , Wot         , Wot         , Wot         , Wot         , Wot         , Wot         , Wot         , Wot         
Gs          , Gs          , Gs          , Gs          , Gs^Ft       , Gs          , Chr         , Ds          , Chw         , Ds          , Wwt         , Wwrt        , Wwt         , Wwt         , Wwt         , Wot         , Wot         , Wot         , Wot         , Wot         , Wot         , Wot         , Wot         , Wwt         , Wwt         , Wwt         , Wwt         , Wwt         , Wot         , Wot         , Wot         , Wot         , Wot         , Wot         , Wot         , Wot         , Wot         , Wot         , Wot         , Wot         , Wot         , Wot         
Gs          , Gs          , Gs          , Gs^Ft       , Gs          , Gs^Dr       , Ds^Es       , Ds          , Chw         , Wwf         , Wwt         , Wwt         , Wwt         , Wwt         , Wwt         , Wwt         , Wwt         , Wwt         , Wwt         , Wot         , Wot         , Wot         , Wot         , Wot         , Wot         , Wot         , Wwt         , Wwt         , Wot         , Wot         , Wot         , Wot         , Wot         , Wot         , Wot         , Wot         , Wot         , Wot         , Wot         , Wot         , Wot         , Wot         
Gs          , Gs          , Gs^Ft       , Gs^Ft       , Gs          , Gs          , Ds          , Ds          , Wwf         , Wwf         , Wwt         , Wwt         , Wwt         , Wwt         , Wwt         , Wwt         , Wwt         , Wwt         , Wwt         , Wot         , Wot         , Wot         , Wot         , Wot         , Wot         , Wwt         , Wot         , Wot         , Wot         , Wot         , Wot         , Wot         , Wot         , Wot         , Wot         , Wot         , Wot         , Wot         , Wot         , Wot         , Wot         , Wot         
Gs^Ft       , Gs          , Gs          , Gs^Dr       , Gs          , Ds          , Wwrt        , Wwt         , Wwt         , Wwt         , Wwt         , Wwt         , Wot         , Wwt         , Wwrt        , Wwt         , Wwt         , Wwt         , Wot         , Wot         , Wot         , Wot         , Wot         , Wot         , Wwt         , Wwt         , Wot         , Wot         , Wot         , Wot         , Wot         , Wot         , Wot         , Wot         , Wot         , Wot         , Wot         , Wot         , Wot         , Wot         , Wot         , Wot         
Gs^Ft       , Gs          , Gs          , Gs          , Wwt         , Ds          , Wwf         , Wwt         , Wwt         , Wwf         , Wwt         , Wwt         , Wwt         , Wot         , Wwrt        , Wwt         , Wot         , Wot         , Wot         , Wot         , Wot         , Wot         , Wot         , Wot         , Wot         , Wot         , Wot         , Wot         , Wot         , Wot         , Wot         , Wot         , Wot         , Wot         , Wot         , Wot         , Wot         , Wot         , Wot         , Wot         , Wot         , Wot         
Gs          , Gs          , Gs^Vht      , Wwt         , Wwt         , Ds          , Ds          , Wwt^Bw/r    , Wwt         , Wwt         , Wwt         , Wwt         , Wwt         , Wot         , Wot         , Wot         , Wot         , Wot         , Wot         , Wot         , Wot         , Wot         , Wot         , Wot         , Wot         , Wot         , Wot         , Wot         , Wot         , Wot         , Wot         , Wot         , Wot         , Wot         , Wot         , Wot         , Wot         , Wot         , Wot         , Wot         , Wot         , Wot         
Gs          , Gs          , Gs          , Gs          , Ds^Es       , Ds          , Wwf         , Wwt         , Wwt         , Wwt         , Wwt         , Wwt         , Wwrt        , Wot         , Wot         , Wot         , Wot         , Wot         , Wot         , Wot         , Wot         , Wot         , Wot         , Wot         , Wot         , Wot         , Wot         , Wot         , Wot         , Wot         , Wot         , Wot         , Wot         , Wot         , Wot         , Wot         , Wot         , Wot         , Wot         , Wot         , Wot         , Wot         
Gs          , Gs          , Gs          , Ds          , Ds^Es       , Ds          , Wwrt        , Wwrt        , Wwrt        , Wwrt        , Wwt         , Wwrt        , Wwt         , Wot         , Wot         , Wot         , Wot         , Wot         , Wot         , Wot         , Wot         , Wot         , Wot         , Wot         , Wot         , Wot         , Wot         , Wot         , Wot         , Wot         , Wot         , Wot         , Wot         , Wot         , Wot         , Wot         , Wot         , Wot         , Wot         , Wot         , Wot         , Wot         
Ds          , Ds^Es       , Ds          , Ds          , Ds          , Wwf         , Wwrt        , Wwt         , Wwt         , Wwt         , Wwrt        , Wwt         , Wwt         , Wot         , Wwt         , Wot         , Wot         , Wot         , Wot         , Wot         , Wot         , Wot         , Wot         , Wot         , Wot         , Wot         , Wot         , Wot         , Wot         , Wot         , Wot         , Wot         , Wot         , Wot         , Wot         , Wot         , Wot         , Wot         , Wot         , Wot         , Wot         , Wot         
Wwf         , Wwf         , Wwf         , Ds          , Wwrt        , Wwrt        , Wwrt        , Wwt         , Wwrt        , Wwrt        , Wwt         , Wwt         , Wwt         , Wwrt        , Wwt         , Wot         , Wot         , Wot         , Wot         , Wot         , Wot         , Wot         , Wot         , Wot         , Wot         , Wot         , Wot         , Wot         , Wot         , Wot         , Wot         , Wot         , Wot         , Wot         , Wot         , Wot         , Wot         , Wot         , Wot         , Wot         , Wot         , Wot         
Wwt         , Wwt         , Wwt         , Wwt         , Wwrt        , Wwt         , Wwt         , Wwt         , Wwt         , Wwt         , Wwrt        , Wwrt        , Wot         , Wwt         , Wot         , Wot         , Wot         , Wot         , Wot         , Wot         , Wot         , Wot         , Wot         , Wot         , Wot         , Wot         , Wot         , Wot         , Wot         , Wot         , Wot         , Wot         , Wot         , Wot         , Wot         , Wot         , Wot         , Wot         , Wot         , Wot         , Wot         , Wot         
Wwt         , Wwt         , Wot         , Wwt         , Wwt         , Wwt         , Wwt         , Wot         , Wot         , Wot         , Wwrt        , Wwrt        , Wot         , Wot         , Wot         , Wot         , Wot         , Wot         , Wot         , Wot         , Wot         , Wot         , Wot         , Wot         , Wot         , Wot         , Wot         , Wot         , Wot         , Wot         , Wot         , Wot         , Wot         , Wot         , Wot         , Wot         , Wot         , Wot         , Wot         , Wot         , Wot         , Wot         
Wot         , Wot         , Wot         , Wwrt        , Wwrt        , Wwrt        , Wwrt        , Wwrt        , Wwrt        , Wot         , Wot         , Wot         , Wot         , Wot         , Wot         , Wot         , Wot         , Wot         , Wot         , Wot         , Wot         , Wot         , Wot         , Wot         , Wot         , Wot         , Wot         , Wot         , Wot         , Wot         , Wot         , Wot         , Wot         , Wot         , Wot         , Wot         , Wot         , Wot         , Wot         , Wot         , Wot         , Wot         
Wot         , Wot         , Wot         , Wot         , Wot         , Wwt         , Wot         , Wot         , Wot         , Wot         , Wot         , Wot         , Wot         , Wot         , Wot         , Wot         , Wot         , Wot         , Wot         , Wot         , Wot         , Wot         , Wot         , Wot         , Wot         , Wot         , Wot         , Wot         , Wot         , Wot         , Wot         , Wot         , Wot         , Wot         , Wot         , Wot         , Wot         , Wot         , Wot         , Wot         , Wot         , Wot         
Wot         , Wot         , Wot         , Wot         , Wot         , Wot         , Wot         , Wot         , Wot         , Wot         , Wot         , Wot         , Wot         , Wot         , Wot         , Wot         , Wot         , Wot         , Wot         , Wot         , Wot         , Wot         , Wot         , Wot         , Wot         , Wot         , Wot         , Wot         , Wot         , Wot         , Wot         , Wot         , Wot         , Wot         , Wot         , Wot         , Wot         , Wot         , Wot         , Wot         , Wot         , Wot         
Wot         , Wot         , Wot         , Wot         , Wot         , Wot         , Wot         , Wot         , Wot         , Wot         , Wot         , Wot         , Wot         , Wot         , Wot         , Wot         , Wot         , Wot         , Wot         , Wot         , Wot         , Wot         , Wot         , Wot         , Wot         , Wot         , Wot         , Wot         , Wot         , Wot         , Wot         , Wot         , Wot         , Wot         , Wot         , Wot         , Wot         , Wot         , Wot         , Wot         , Wot         , Wot         
Wot         , Wot         , Wot         , Wot         , Wot         , Wot         , Wot         , Wot         , Wot         , Wot         , Wot         , Wot         , Wot         , Wot         , Wot         , Wot         , Wot         , Wot         , Wot         , Wot         , Wot         , Wot         , Wot         , Wot         , Wot         , Wot         , Wot         , Wot         , Wot         , Wot         , Wot         , Wot         , Wot         , Wot         , Wot         , Wot         , Wot         , Wot         , Wot         , Wot         , 1 Wot       , Wot         
Wot         , Wot         , Wot         , Wot         , Wot         , Wot         , Wot         , Wot         , Wot         , Wot         , Wot         , Wot         , Wot         , Wot         , Wot         , Wot         , Wot         , Wot         , Wot         , Wot         , Wot         , Wot         , Wot         , Wot         , Wot         , Wot         , Wot         , Wot         , Wot         , Wot         , Wot         , Wot         , Wot         , Wot         , Wot         , Wot         , Wot         , Wot         , Wot         , Wot         , Wot         , Wot         
