border_size=1
usage=map

Mm          , Mm          , Mm          , Mm          , Mm          , Mm          , Mm          , Hh          , Hh          , Hh          , Hh          , Rp          , Rp          , Gs          , Ww          , Ww          , Hh          , Hh          , Hh          , Hh          , Hh          , Mm          
Mm          , Mm          , Hh          , Mm          , Hh          , Mm          , Hh          , Hh          , Gs^Fms      , Ch          , Gs^Fms      , Hh          , Rp          , Ww          , Hh^Fms      , Hh^Fms      , Gs^Fms      , Hh^Fms      , Ch          , Hh^Fms      , Hh^Fms      , Hh          
Mm          , Hh          , Hh^Fms      , Hh^Fms      , Hh          , Hh          , Hh          , Hh          , Gs^Fms      , Gs^Fms      , Gg^Fet      , Gs^Fms      , Rp          , Ww^Bw\      , Rp          , Gg^Fet      , Rp          , Gs^Fms      , Gs^Fms      , Gs^Fds      , Gg^Fet      , Hh          
Mm          , Hh          , Hh^Fms      , Hh          , Hh^Fms      , Mm          , Hh          , Hh^Fms      , Ch          , Gs^Fms      , Rp          , Rp          , Ww          , Ww          , Ww          , Rp          , Gs^Fms      , Rp          , Rp          , Gs^Fds      , Gs^Fms      , Hh          
Mm          , Mm          , Hh          , Hh          , Ch          , Ch          , Hh          , Hh^Fds      , Hh          , Gg^Efm      , Rp          , Ww          , Wo          , Wo          , Ww          , Gs^Fms      , Gg^Fet      , Gs^Fms      , Rp          , Gg^Efm      , Ch          , Hh          
Mm          , Hh          , Hh^Fms      , Hh          , Ch          , 5 Kh        , Ch          , Hh          , Rr          , Rr          , Hh          , Ww          , Ww          , Ww          , Gg^Es       , Gs^Fms      , Gs^Fms      , Gs^Fms      , Gg^Efm      , Rp          , Rp          , Hh          
Mm          , Mm          , Hh^Fms      , Mm          , Hh          , Ch          , Rp          , Hh          , Rp          , Hh          , Ch          , Hh^Fds      , Ww          , Hh^Fp       , Hh^Fms      , Ch          , Hh          , Hh^Fms      , Hh^Fp       , Hh^Fms      , Hh          , Rp          
Hh          , Hh          , Hh^Fms      , Hh^Fms      , Hh          , Hh          , Rr          , Rp          , Mm          , Mm          , Mm          , Hh^Fms      , Ww          , Hh          , Ch          , Hh          , Ch          , Hh          , Hh          , Hh          , Hh          , Hh^Fp       
Rp          , Hh          , Rr          , Rr          , Rr          , Rr          , Rr          , Hh          , Mm          , Mm          , Mm          , Mm          , Ww          , Hh          , Ch          , 6 Kh        , Ch          , Hh          , Mm          , Hh          , Mm          , Mm          
Mm          , Rp          , Hh          , Hh          , Mm          , Mm          , Hh          , Rp          , Rp          , Mm          , Ww          , Ww          , Mm          , Hh^Fp       , Hh^Fms      , Ch          , Hh          , Mm          , Mm          , Mm          , Mm          , Mm          
Mm          , Hh          , Mm          , Hh          , Mm          , Mm          , Mm          , Hh          , Hh          , Ww^Bw\      , Rp          , Rp          , Rp          , Hh          , Hh          , Rr          , Hh          , Hh          , Mm          , Mm          , Mm          , Mm          
Mm          , Mm          , Mm          , Mm          , Hh          , Hh          , Hh          , Hh^Fms      , Hh          , Ww          , Hh          , Hh          , Gg^Fet      , Rp          , Rr          , Rr          , Hh^Fds      , Mm          , Mm          , Mm          , Mm          , Mm          
Mm          , Mm          , Mm          , Mm          , Hh^Fms      , Hh^Fms      , Hh          , Hh          , Ch          , Ww          , Ch          , Ch          , Gg^Fet      , Rr          , Rr          , Hh          , Hh          , Mm          , Mm          , Mm          , Mm          , Mm          
Mm          , Mm          , Mm          , Hh          , Hh^Fms      , Hh          , 2 Kh        , Ch          , Gg          , Ww          , Gg^Efm      , Gg          , Rp          , Rr          , Ch          , Hh          , Hh          , Hh          , Mm          , Mm          , Hh          , Mm          
Mm          , Mm          , Hh          , Hh          , Ch          , Ch          , Gg^Efm      , Gg^Efm      , Gg          , Ww          , Gg^Fet      , Gg^Efm      , Rp          , Rp          , Gg^Efm      , 4 Kh        , Ch          , Hh          , Hh          , Mm          , Hh^Fds      , Mm          
Mm          , Hh          , Hh          , Hh          , Ch          , Gg          , Gg          , Gg^Efm      , Ww          , Ww          , Ww          , Gg^Fet      , Rp          , Rp          , Gg^Es       , Gg          , Gg^Efm      , Ch          , Ch          , Hh          , Hh^Fds      , Hh^Fms      
Hh^Fms      , Hh          , Ch          , Ch          , Ww          , Ww          , Ww          , Ww          , Ww          , Ww          , Gg          , Gg          , Rp          , Rp          , Gg          , Gg          , Gg^Fet      , Gg^Efm      , Ch          , Mm          , Hh^Fms      , Hh^Fms      
Hh          , Ch          , Ww          , Ww          , Gg^Efm      , Gg^Fet      , Gg^Fet      , Ww          , Gg          , Gg^Efm      , Rp          , 1 Rp        , Rp          , Rp          , Gg^Fet      , Gg^Efm      , Gg          , Ch          , Hh          , Mm          , Hh          , Hh^Fds      
Ww          , Ww          , Hh          , Ch          , Ch          , Gg          , Gg^Efm      , Gg          , Gg^Efm      , Rp          , Rp          , Rp          , Gg^Fet      , Rp          , Rp          , Gg          , Gg^Fet      , Ch          , Gg^Efm      , Hh          , Hh          , Hh^Fms      
Mm          , Hh          , Hh          , Hh          , Hh          , 3 Kh        , Ch          , Gg          , Gg^Es       , Gg^Efm      , Gg^Fet      , Gg          , Gg^Efm      , Gg^Efm      , Gg^Fet      , Rp          , Rp          , Gg          , Gg^Fet      , Gg^Efm      , Hh          , Hh^Fds      
Mm          , Mm          , Mm          , Mm          , Hh          , Hh          , Hh          , Ch          , Ch          , Gg          , Ch          , Ch          , Ch          , Ch          , Hh          , Gg^Efm      , Gg^Fet      , Rp          , Rp          , Gg^Efm      , Gg^Fet      , Hh          
Mm          , Mm          , Mm          , Mm          , Mm          , Hh^Fms      , Hh          , Hh          , Hh          , Ch          , Hh          , Hh          , Hh          , Hh          , Hh          , Hh          , Gg          , Gg^Efm      , Gg^Fet      , Rp          , Rp          , Gg          
