Mm, Mm, Mm, Mm^Xm, Mm^Xm, Mm^Xm, Hh, Mm, Mm, Mm, Mm, Mm, Mm, Mm, Mm, Mm, Mm, Hh, Hh, Hh, Hh, Rp, Rp, Gs, Wwt, Wwt, Hh, Hh, Hh, Hh, Hh, Hh, Hh^Fds, Hh^Fds, Gs^Fds, Gg^Ft, Gs^Ft, Gs^Ft, Rp, Rp, Gs^Ft, Gg^Ft
Mm, Mm, Mm, Mm^Xm, Mm^Xm, Mm, Mm, Mm, Hh, Mm, Mm, Mm, Hh, Mm, Hh, Mm, Hh, Hh, Gs^Fms, Ch, Gs^Fms, Hh, Rp, Wwt, Hh^Fms, Hh^Fms, Gs^Fms, Hh^Fms, Ch, Hh^Fms, Hh^Fms, Hh, Hh, Hh^Fds, Gs^Fds, Gd^Ft, Rp, Rp, Gs^Ftd, Gs^Ftd, Gg^Ft, Gg^Ft
Mm, Mm, Mm^Xm, Mm, Mm, Mm, Mm, Mm, Mm, Mm, Mm, Hh, Hh^Fms, Hh^Fms, Hh, Hh, Hh, Hh, Gs^Fms, Gs^Fms, Gg^Fet, Gs^Fms, Rp, Wwt^Bsb\, Rp, Gg^Fet, Rp, Gs^Fms, Gs^Fms, Gs^Fds, Gg^Fet, Hh, Gs^Fds, Gs^Fds, Gs^Fds, Gs^Ftd, Rp, Rp, Gg^Ft, Gs^Vc, Gs^Ft, Gs^Ft
Hh, Mm, Mm^Xm, Mm, Hh, Mm, Hh, Mm, Mm, Mm, Mm, Hh, Hh^Fms, Hh, Hh^Fms, Mm, Hh, Hh^Fms, Ch, Gs^Fms, Rp, Rp, Wwt, Wwt, Wwt, Rp, Gs^Fms, Rp, Rp, Gs^Fds, Gs^Fms, Hh, Gs, Gg, Gg^Efm, Rp, Gg, Gs^Ftd, Gs^Ft, Gs^Ftd, Gs^Ft, Hh
Hh, Mm, Mm, Mm, Hh, Hh^Fds, Gll^Fds, Hh^Fms, Hh, Mm, Mm, Mm, Hh, Hh, Ch, Ch, Hh, Hh^Fds, Hh, Gg^Efm, Rp, Wwt, Wot, Wot, Wwt, Gs^Fms, Gg^Fet, Gs^Fms, Rp, Gg^Efm, Ch, Hh, Gg, Re, Rp, Rp, Gs, Gs^Ftd, Gg, Hh^Ft, Hh^Fds, Hh^Fds
Gs, Hh^Fp, Mm, Mm^Xm, Hh^Fds, Hh^Fds, Gll^Fds, Gs^Fp, Gs^Fds, Mm, Mm, Hh, Hh^Fms, Hh, Ch, 5 Kh, Ch, Hh, Rr, Rr, Hh, Wwt, Wwt, Wwt, Gg^Es, Gs^Fms, Gs^Fms, Gs^Fms, Gg^Efm, Rp, Rp, Hh, Rp, Rp, Rp, Re, Gg, Gs^Efm, Gs, Gg, Gs^Fds, Hh^Fms
Rp, Hh, Hh, Hh, Hh, Gll^Fds, Gll^Fds, Gs^Fds, Hh^Fms, Mm, Mm, Mm, Hh^Fms, Mm, Hh, Ch, Rp, Hh, Rp, Hh, Ch, Hh^Fds, Wwt, Hh^Fp, Hh^Fms, Ch, Hh, Hh^Fms, Hh^Fp, Hh^Fds, Hh, Rp, Gg^Es, Rp, Gg, Rp, Re, Gg, Gs^Fds, Gs^Fds, Gs^Fp, Gs^Fds
Gs, Rp, Rr, Gs, Rr, Gs^Fds, Ch, Gs^Fds, Gs^Vh, Hh, Hh, Hh, Hh^Fms, Hh^Fms, Hh, Hh, Rr, Rp, Mm, Mm, Mm, Hh^Fms, Wwt, Hh, Ch, Hh, Ch, Hh, Hh, Hh, Hh, Hh^Fp, Hh, Gg, Gs^Fds, Gs^Fds, Re, Re, Gs, Gs^Vc, Gs^Fms, Gs^Fds
Hh, Gs, Gs, Rp, Gs^Fds, Rp, Rp, Rp, Rr, Rp, Rp, Hh, Rp, Rp, Rr, Rr, Rr, Hh, Mm, Mm, Mm, Mm, Wwt, Hh, Ch, 6 Kh, Ch, Hh, Mm, Hh, Mm, Mm, Hh, Hh, Gs^Fms, Gg, Gg^Efm, Re, Re, Gg, Gs^Fds, Hh
Hh^Fp, Hh, Hh, Gs^Fds, Gs^Fds, Gs^Vh, Gg^Fet, Gs^Vh, Gs^Efm, Gs^Efm, Mm, Rp, Hh, Hh, Mm, Mm, Hh, Rp, Rp, Mm, Wwt, Wwt, Mm, Hh^Fp, Hh^Fms, Ch, Hh, Mm, Mm, Mm, Mm, Mm, Mm, Hh, Hh, Hh^Fds, Gs^Fds, Gs, Re, Gs^Fds, Gs^Fds, Gs^Fds
Mm, Mm, Hh, Gg, Gg^Fp, Hh^Fds, Hh, Hh^Fp, Mm, Mm, Mm, Hh, Mm, Hh, Mm, Mm, Mm, Hh, Hh, Wwt^Bsb\, Rp, Rp, Rp, Hh, Hh, Rr, Hh, Hh, Mm, Mm, Mm, Mm, Mm, Mm, Mm, Hh^Fms, Gs^Fds, Gs^Fds, Gs^Ftd, Re, Re, Gs
Mm, Mm, Hh, Mm, Hh, Hh^Fds, Hh, Hh, Hh, Mm, Mm, Mm, Mm, Mm, Hh^Fp, Hh, Hh, Hh^Fms, Hh, Wwt, Hh, Hh, Gg^Fet, Rp, Rr, Rr, Hh^Fds, Mm, Mm, Mm, Mm, Mm, Mm, Mm, Mm, Hh, Hh, Gs^Fds, Gs^Fms, Gs^Ftd, Gs^Ft, Re
Mm, Mm, Mm, Hh, Mm, Mm, Mm, Mm, Hh, Mm, Mm, Mm, Mm, Mm, Hh^Fms, Hh^Fms, Hh, Hh, Ch, Wwt, Ch, Ch, Gg^Fet, Rr, Rr, Hh, Hh, Mm, Mm, Mm, Mm, Mm, Hh, Mm, Hh^Fds, Hh^Fds, Hh, Hh, Hh, Hh^Fds, Gs^Ft, Gs
Mm, Mm, Mm, Mm, Mm, Mm^Xm, Mm^Xm, Hh, Mm, Mm, Mm, Mm, Mm, Hh, Hh^Fms, Hh, 2 Kh, Ch, Gg, Wwt, Gg^Efm, Gg, Rp, Rr, Ch, Hh, Hh, Hh, Mm, Mm, Hh, Mm, Hh, Mm, Hh, Hh^Fms, Hh, Mm, Hh, Hh^Fds, Hh, Gs^Ft
Mm, Mm, Mm, Mm, Mm^Xm, Mm^Xm, Mm^Xm, Mm, Mm, Mm, Mm, Mm, Hh, Hh, Ch, Ch, Gg^Efm, Gg^Efm, Gg, Wwt^Ewf, Gg^Fet, Gg^Efm, Rp, Rp, Gg^Efm, 4 Kh, Ch, Hh, Hh, Mm, Hh^Fds, Mm, Hh, Hh, Hh^Fds, Hh, Mm, Mm, Hh^Fds, Hh, Hh, Hh
Mm, Mm, Mm, Mm^Xm, Mm^Xm, Mm^Xm, Mm, Mm, Hh^Fp, Hh, Mm, Hh, Hh, Hh, Ch, Gg, Gg, Gg^Efm, Wwrt^Ewf, Wwrt, Wwrt^Ewl, Gg^Fet, Rp, Rp, Gg^Es, Gg, Gg^Efm, Ch, Ch, Hh, Hh^Fp, Hh^Fms, Hh, Hh, Hh, Hh, Mm, Hh, Mm, Mm, Hh, Hh
Mm, Mm, Mm^Xm, Mm^Xm, Mm, Mm, Hh, Hh, Hh^Fds, Hh, Hh^Fms, Hh, Ch, Ch, Wwt, Wwt, Wwt, Wwt^Ewl, Wwt^Ewf, Wwt, Gg, Gg, Rp, Rp, Gg, Gg, Gg^Fet, Gg^Efm, Ch, Mm, Hh^Fms, Hh^Fms, Hh, Hh^Fds, Hh, Mm, Mm, Hh^Fds, Hh^Fds, Hh, Mm, Hh
Mm, Mm, Mm, Mm^Xm, Mm, Mm, Hh, Hh, Gs^Fds, Hh^Fds, Hh, Ch, Wwt, Wwt^Ewl, Gg^Efm, Gg^Fet, Gg^Fet, Wwrt^Ewl, Gg, Gg^Efm, Rp, 1 Rp, Rp, Rp, Gg^Fet, Gg^Efm, Gg, Ch, Hh, Mm, Hh, Hh^Fds, Gg, Gg, Hh, Mm, Hh, Hh^Fds, Gs^Fds, Mm, Mm, Mm
Mm, Mm, Mm, Mm^Xm, Mm^Xm, Hh, Hh, Gs^Fds, Gs^Fds, Gs^Fds, Wwt, Wwt, Hh, Ch, Ch, Gg, Gg^Efm, Gg, Gg^Efm, Rp, Rp, Rp, Gg^Fet, Rp, Rp, Gg, Gg^Fet, Ch, Gg^Efm, Hh, Hh, Hh^Fp, Gg, Gs, Gg, Hh, Gg, Gs^Fds, Hh, Mm, Mm, Mm
Hh, Mm, Hh, Mm, Mm, Mm, Gg, Hh^Fds, Gs^Fds, Gg^Efm, Wwrt, Hh, Hh, Hh, Hh, 3 Kh, Ch, Gg, Gg^Es, Gg^Efm, Gg^Fet, Gg, Gg^Efm, Gg^Efm, Gg^Fet, Rp, Rp, Gg, Gg^Fet, Gg^Efm, Hh, Hh^Fds, Gs, Gs, Rp, Re^Vhc, Gg, Hh, Mm, Mm, Hh, Hh^Fms
Md, Mm, Hh, Md, Hh, Hh, Gg, Gg^Efm, Gg, Gg, Wwrt, Mm, Mm, Mm, Hh, Hh, Hh, Ch, Ch, Gg, Ch, Ch, Ch, Ch, Hh, Gg^Efm, Gg^Fet, Rp, Rp, Gg^Efm, Gg^Fet, Hh, Gg^Efm, Gg^Efm, Rp, Gg^Em, Gs^Fds, Gs^Fds, Hh, Hh, Hh, Hh
Ch, Md, Md, Hh, Gd, Gg^Fet, Gd, Gs^Fds, Wwt^Ewl, Wwrt^Ewl, Wot, Wwt, Mm, Mm, Mm, Hh^Fms, Hh, Hh, Hh, Ch, Hh, Hh, Hh, Hh, Hh, Hh, Gg, Gg^Efm, Gg^Fet, Rp, Rp, Gg, Gg^Efm, Rp, Rp, Gs^Fds, Gs^Fds, Hh^Fms, Hh^Fds, Hh, Ch, Hh
Mm, Re, Re, Re, Ce, Gd, Re^Vwm, Gs, Wwt^Bw/, Wot, Wot, Wwt, Wwrt, Mm, Mm, Hh^Fds, Hh^Fp, Hh, Hh, Hh, Hh, Gg, Gg, Gg, Gg, Gg, Gs^Fms, Gg, Gg, Gg, Gg, Rp, Rp, Rp, Gg^Efm, Gs^Fds, Gs^Fp, Gs^Fds, Hh, Hh, Hh, Hh^Fp
Re, Re, Re^Eff, Re, Re, Re, Re, Rr^Vh, Ch, Kh, Wot, Wot, Wwrt^Ewl, Mm, Mm, Hh, Hh, Mm, Mm, Hh, Gs, Gg^Em, Gs, Gs^Fms, Gs^Fds, Gs^Fds, Gs^Fds, Gs^Em, Gs^Fds, Gs^Fds, Gs, Gg^Es, Rp, Rp, Gg, Gs^Fds, Hh, Hh^Fms, Hh, Mm, Hh^Fds, Hh
Re, Re, Re, Re^Eff, Re, Re^Es, Re, Re, Re, Gd, Gs, Wwt, Gs, Gs, Gg^Fet, Mm, Mm, Mm, Hh, Hh, Hh, Gs, Gs, Hh^Fds, Gs^Fds, Gs^Fms, Gs^Fp, Gs^Fds, Gs^Fds, Gs^Fds, Gg^Es, Rp, Rp, Rp, Gs^Fds, Gg, Hh, Hh^Fds, Mm, Mm, Hh^Fds, Hh^Fms
Re^Es, Re, Re, Re, Re^Es, Re, Re^Eff, Re^Es, Re, Gs, Re, Gd^Vwm, Re^Es, Gd, Gs, Mm, Mm, Mm, Mm, Hh, Hh, Hh, Gg, Hh^Fds, Hh^Fp, Hh^Fds, Hh^Fms, Gs, Gg, Gg, Rp, Rp, Rp, Gg, Gs^Fds, Hh^Fms, Hh^Vhh, Hh, Mm, Mm, Mm, Hh
Re, Re, Re, Re^Es, Re, Re, Re, Re^Eff, Re, Re, Re^Es, Re, Re^Vwm, Ce, Ce, Gs, Hh, Hh, Hh, Hh, Gs, Gs, Gs^Fds, Hh^Fp, Hh, Hh, Hh, Hh, Gs^Ft, Rr^Vhc, Gg, Gg^Efm, Gg, Gg, Hh, Hh, Hh^Fds, Hh, Hh, Hh, Hh^Fds, Hh^Fp
Re^Es, Re, Re, Re^Es, Re^Es, Re, Re, Re^Es, Re, Re, Re^Eff, Re, Re^Es, Re, Ce, Re, Gs, Hh, Hh, Gs, Gg, Gs, Hh, Hh, Mm, Mm, Hh, Hh^Fds, Gs^Ft, Gg^Efm, Gs^Fet, Gg, Re, Gg, Gs^Ft, Hh, Gs^Fds, Gs^Fds, Gs^Fds, Hh^Fds, Gg^Ft, Gs^Fds
Re, Re, Re^Es, Re, Re, Re, Re, Re, Re, Re^Es, Re, Re^Eff, Re, Re^Es, Re, Gd, Gs, Gg^Fet, Ch, Gs^Fds, Hh, Gs, Hh, Mm, Mm, Mm, Hh, Gs^Fds, Gs^Fds, Gs^Ft, Gs^Ft, Gg, Ch, Re, Re, Gs^Ft, Gs^Ft, Gs^Ft, Gll^Ftr, Gs^Ft, Gll^Ftr, Gs^Ft
Re, Re, Re, Re^Es, Re, Re, Re, Re, Re, Re, Re^Es, Re, Re, Re^Es, Re, Re, Gd, Gd, Gd, Hh, Hh, Hh, Hh, Mm, Mm, Mm, Mm, Hh, Hh, Gll^Ftr, Gll^Ftr, Gs^Ft, Gs^Ft, Gs^Ft, Re, Re, Gg, Gll^Ftr, Gll^Ftr, Gll^Ftr, Gll^Ftr, Gll^Ftr
