Hh, Hh, Gs^Ft, Hh, Hh^Ftr, Hh^Ftr, Hh^Ftr, Hh, Gs^Ft, Gs^Ft, Gll^Ftr, Gs^Ft, Gs^Ft, Hh, Hh, Re, Hh, Hh^Ftd, Hh^Ftd, Gs^Ft, Gs^Ft, Gll^Ft, Gll^Ft, Gs^Ft, Gll^Ftr, Gll^Ftr, Gll^Ft, Gll^Ft, Gll^Ft, Gll^Ft, Re, Re, Gll^Ft, Gs^Ft, Gs^Ft, Gs, Gs^Ft, Gs^Ft, Gll^Ftr, Gs^Ft, Gs^Ft, Gs^Ft
Hh, Gll^Ftr, Gll^Ftr, Gll^Ftr, Gll^Ftr, Hh^Ftr, Gs^Ft, Gll^Ftr, Gs^Ft, Gs^Ft, Gll^Ftr, Gll^Ftr, Gs^Ft, Hh, Gs^Ft, Re, Rd, Hh^Ftd, Gs^Ft, Gll^Fts, Gd^Fts, Gd^Ftd, Gg^Ft, Gll^Ftr, Gll^Ft, Gll^Ft, Rd, Re, Re, Re, Gll^Ft, Gll^Ft, Gll^Ftr, Gll^Ftr, Gs^Ft, Gs^Ft, Gll^Ftr, Gll^Ftr, Gll^Ftr, Gll^Ftr, Gs^Ft, Gs^Ft
Gs, Gll^Ftr, Gs^Ft, Hh^Ftd, Gs^Ft, Gll^Ftr, Gll^Ftr, Gs^Ft, Gs^Ft, Gll^Ftr, Gs^Ft, Gs^Ftr, Hh^Ftr, Hh^Ftd, Gll^Ft, Gll^Ft, Gs, Rd, Rd, Gs, Gs^Ft, Gs^Ftp, Gll^Ftr, Gll^Ftr, Rd, Rd, Gs^Ftp, Gll^Ft, Gll^Ftr, Gll^Ft, Gll^Ftr, Gs^Ft, Gs^Ft, Gll^Ftr, Hh^Ftd, Gs^Ft, Gs^Ft, Gg^Ft, Gll^Ftr, Gll^Ftr, Gll^Ftr, Gll^Ftr
Gll^Ftr, Gs^Ft, Hh^Ftd, Gll^Ftr, Gll^Ftr, Gll^Ftr, Gs^Ft, Gs^Ftp, Hh, Gg^Ft, Hh^Ftp, Hh^Ftr, Gll^Ftr, Gll^Ftr, Gs^Ft, Gll^Ftd, Gll^Ft, Gs^Ftd, Rd, Re, Gs^Fts, Gs^Ft, Gs^Ft, Re, Gs^Ft, Gs^Ftp, Gll^Fts, Gll^Ftr, Gg^Ft, Gll^Ftr, Gg^Ft, Hh, Gll^Ftr, Gll^Ftr, Hh^Ftd, Hh^Ftd, Gg^Ft, Gll^Ftr, Gg^Ft, Gg^Ft, Gll^Ftr, Gll^Ftr
Gll^Ftr, Gll^Ftr, Gll^Ftr, Gs^Ft, Gll^Ftr, Gs^Ft, Gs^Ft, Wwt, Hh, Hh, Hh^Ftd, Hh^Ftp, Gs^Ft, Gll^Ftr, Gg^Ft, Gg^Ftd, Gs^Ft, Gll^Ft, Re, Re, Re, Re, Gs^Ft, Re, Gs, Gs^Es, Gs, Gll^Ft, Gll^Ftr, Gll^Ftr, Hh, Gll^Ftr, Gs^Ft, Gg^Ft, Gg^Ft, Hh, Gg^Ft, Gll^Ftr, Gs^Ft, Gll^Ftr, Gs^Ft, Gll^Ftr
Gll^Ftr, Gs^Ft, Hh^Ftd, Gll^Ftr, Gs^Ft, Hh, Hh, Hh, Hh^Ftd, Hh, Hh^Ftd, Gs^Ft, Gll^Ftr, Gll^Ftr, Gll^Ftr, Gll^Ftr, Gll^Ft, Gs^Ft, Re, Gs^Ftd, Gs^Ftd, Re, Re, Re, Gs, Gs, Gll^Ftp, Gll^Ftr, Gs^Ft, Gs^Ft, Hh^Ftd, Hh, Gs^Ft, Hh, Gll^Ftr, Gs^Ft, Hh^Ftd, Hh, Hh, Gll^Ftr, Gll^Ftr, Gll^Ftr
Gs^Ft, Gll^Ftr, Hh^Ftr, Gll^Ftr, Gll^Ftr, Gs^Ft, Hh, Gs^Ft, Hh, Hh, Hh^Ftd, Gs^Ft, Gs^Ftp, Gll^Ftr, Gll^Ftr, Gll^Ftr, Gll^Ftr, Re, Gll^Ftr, Gg^Ft, Gs^Ftd, Re, Re, Gs, Gg, Gll^Fts, Gll^Fts, Gs^Ftp, Gs, Hh, Hh^Ftd, Gs^Ft, Hh^Ftd, Hh^Ftd, Hh, Gll^Ftr, Gll^Ft, Gg^Ft, Gll^Ftr, Gll^Ftr, Gll^Ft, Gs^Ft
Gll^Ftr, Gll^Ftr, Hh^Ftr, Gll^Ftr, Gll^Ftr, Gs^Ft, Gs^Ft, Gs^Ft, Gs^Ft, Hh^Ftd, Hh, Gs, Gs^Ftp, Gll^Ftr, Gg^Ft, Gll^Ftr, Gll^Ft, Gll^Ftr, Gll^Ftd, Gll^Ftd, Re, Re, Gs, Gs, Gs, Gs^Ftd, Gs^Fts, Gll^Ftd, Hh, Hh^Ftd, Hh, Gs^Ftd, Hh, Hh, Gll^Ft, Gll^Ft, Gs^Es, Gll^Ft, Gs^Ft, Gll^Ftd, Gs, Gll^Ft
Gll^Ftr, Gs^Ft, Gll^Ftr, Gll^Ftr, Gll^Ftr, Gs^Ft, Gll^Ftd, Gll^Ftr, Hh, Hh^Ftd, Hh, Gs^Es, Gll^Ftd, Gs^Ftp, Gll^Ft, Gll^Ftr, Gs, Gll^Ft, Rd, Re, Gs^Ft, Gs^Fts, Gll^Fts, Gd, Gd, Gs^Ftd, Gs, Gs, Gs, Hh, Gs, Gs, Gs, Gll^Ftd, Gs, Gll^Ft, Gs, Gll^Fts, Gs^Ftd, Gs^Ftd, Gs, Gs
Gll^Ftr, Gll^Ftr, Gll^Ftr, Gll^Ftr, Gll^Ftr, Gs, Gs, Gll^Ft, Hh^Ftd, Hh, Hh, Gs^Ft, Gs^Ft, Gs, Gll^Ft, Gs^Ft, Gs^Ft, Rd, Gs^Ftd, Gs^Ft, Gll^Ftr, Gs^Ft, Gll^Ft, Gg, Gs, Gs, Gs^Ftd, Gs^Dr, Gs, Hh^Ftd, Gs^Ft, Gs^Dr, Gs, Gs, Gs, Gll^Fts, Gs, Gs, Gs, Gs, Ds, Ds
Gll^Ftr, Gll^Ftr, Gs^Ft, Gg^Ft, Gs^Ftp, Gll^Ftd, Gs, Hh, Hh, Hh, Gs^Ft, Gll^Ftr, Gll^Fts, Gs, Gll, Gll^Ftr, Re, Rd, Gs^Ftd, Gs^Ftd, Gg^Ftd, Gll^Ftr, Gs^Ft, Gs^Ftd, Gg^Ft, Gll^Ftd, Gs, Gs, Chr, Chr, Gs, Gs, Gs^Esd, Gs, Ds, Gs, Ds^Esd, Gs, Ds^Esd, Ds^Es, Ds, Ds
Gll^Ftr, Gll^Ftr, Gs^Es, Gll, Gll^Fts, Gs^Es, Gs, Hh, Hh, Hh^Ftd, Gs, Gll^Ft, Gll, Gs^Ftd, Gs^Ftd, Gll^Ftp, Re, Re, Gs^Fts, Gll, Gd, Gll, Gs^Ft, Gs^Ftd, Gd^Fts, Gd^Fts, Gs, Gs, Chr, Gs, Ds^Dr, Ds^Es, Ds, Ds^Esd, Ds, Ds, Ds, Ds, Ds, Ds, Chr, Chr
Gs^Ft, Gll^Fts, Gs, Gs, Gg, Gg, Gll^Ft, Hh, Gs, Gs, Gs, Gs, Gll^Ft, Gg^Ft, Gs^Ftd, Gll^Ftp, Re, Re, Gs, Gs, Gg^Ft, Gg, Gd, Gg, Gs, Gs, Gs, Chr, Ds, Ds, Wwt^Bw\r, Ds, Wwf, Ds^Es, Ds, Chr, Ds, Ds, Ds^Es, Ds, Ds, Ds
Gs^Ft, Gs^Ft, Chr, Gs^Ft, Gs^Ftp, Hh, Gs^Fts, Gs, Gs, Hh, Hh^Ftd, Hh, Gs, Gll^Ftp, Gll^Ftp, Gs^Ftd, Rd, Re, Re, Gs, Gs^Fts, Gg^Ftp, Gs, Gg, Ds, Gs^Esd, Gs^Dr, Gs^Esd, Ds, Wwf, Wwf, Wwt, Wwt, Ds, Wwrt, Chw, Wwt, Wwf, Ds, Wwrt, Wwf, Wwf
Gs^Ft, Gs^Ft, Gs^Ft, Gs^Ft, Gs^Ft, Hh, Gs, Gd, Hh, Hh, Hh, Hh, Gs, Gg^Ft, Gs, Gd, Gs, Re, Re, Gs, Gs, Gd, Gs, Gs^Esd, Ds, Ds, Chr, Ds^Es, Ds, Chw, Ds^Es, Wwt, Wwt, Wwt, Wwrt, Wwrt, Wwrt, Wwt, Wwt, Wwt, Wwt, Wwt
Hh, Hh, Hh, Hh, Hh^Ftd, Hh, Gg, Gs, Gs, Hh, Gs, Hh^Ftd, Gs, Gs, Gs, Gs, Gs, Re, Rb, Gs, Ds, Chr, Ds, Ds^Es, Ds, Chw, Wwt, Ds, Wwf, Ds, Wwrt, Wwt, Wwt, Wwrt, Wwt, Wwt, Wwt, Wwt, Wwt, Wwt, Wwrt, Wwrt
Gll^Ftr, Gs^Ft, Gs^Ft, Gs^Ft, Hh, Gs, Gs^Es, Gs, Hh, Hh^Ftd, Gs, Gs, Gd^Es, Gd, Gs, Chr, Ds^Esd, Re, Rb, Ds^Esd, Ds, Ds^Es, Wwf, Wwf, Wwt, Wwt, Wwrt, Wwt, Wwt, Wwt, Wwt, Wwt, Wwt, Wwt, Wwt, Wwt, Wwrt, Wwt, Wwrt, Wwrt, Wwrt, Wwrt
Gll^Ftr, Gll^Ftr, Hh^Fts, Hh^Ftd, Hh, Hh^Ftd, Gs, Gs, Gs, Gs, Gs, Gs, Ds^Esd, Gs, Chr, Chr, Ds^Es, Rb^Esd, Rb^Esd, Ds, Ds, Ds, Wwt, Wwt, Wwrt, Wwrt, Wwrt, Wwrt, Wwt, Wwt, Wwt, Wwrt, Wwt, Wwt, Wwt, Wwt, Wwrt, Wwrt, Wwt, Wwt, Wwrt, Wwt
Gs^Ft, Gs^Ft, Gs^Fts, Gs^Fts, Gs, Gs, Gs, Gd, Gs^Fts, Gll^Ft, Gs, Gs^Esd, Ds, Ds, Ds, Ds, Ds, Ds^Es, Ds^Esd, Rb^Esd, Ds^Es, Wwf, Wwf, Wwt, Wwt, Wwt, Wwt, Wwt, Wot, Wot, Wot, Wot, Wwt, Wwt, Wot, Wwt, Wwt, Wwt, Wot, Wwt, Wwt, Wwt
Gs^Ft, Gs^Ft, Wwt^Ewl, Wwt, Gs, Hh, Hh, Gd, Gs, Gs, Ds, Ds, Wwf, Wwt, Wwt, Wwf, Wwrt, Ds, Ds^Es, Rb^Esd, Ds, Wwf, Wwt, Wwt, Wwt, Wwt, Wwrt, Wwrt, Wot, Wot, Wot, Wot, Wot, Wot, Wot, Wwt, Wwt, Wwt, Wot, Wot, Wwt, Wwt
Gs^Ft, Wwt, Wwt, Wwt, Hh, Hh^Ftd, Gs, Gs, Gs, Gs^Esd, Ds, Wwrt, Wwrt, Wwt, Wwt, Wwrt, Wwt, Ds, Wwrt, Ds^Es, Ds, Wwt, Wwt, Wwt, Wwt, Wwrt, Wot, Wot, Wot, Wot, Wot, Wot, Wot, Wot, Wot, Wwt, Wwt, Wwt, Wot, Wwt, Wot, Wot
Gll^Ft, Wwt^Ewl, Wwt^Ewl, Hh, Hh^Fts, Gs^Ft, Hh^Fts, Hh, Gs, Ds^Es, Ds, Wwrt, Wwrt, Wwt, Wwf, Wwt, Wwt, Wwt, Wwt, Ds, Wwt, Wwt, Wwt, Wwt, Wwt, Wot, Wot, Wot, Wwrt, Wwrt, Wot, Wot, Wot, Wot, Wot, Wot, Wot, Wot, Wot, Wot, Wot, Wot
Gll^Ft, Gll^Ft, Wwt^Ewl, Hh, Gs^Ft, Gll^Ft, Hh^Fts, Hh^Ftd, Gs^Dr, Ds^Esd, Ds, Ds, Ds, Wwt, Wwt, Wwt, Wwt, Wwt, Wwt, Wwt, Wwt, Wwt, Wwt, Wwt, Wot, Wot, Wot, Wwt, Wwt, Wwrt, Wot, Wot, Wot, Wot, Wot, Wot, Wot, Wot, Wot, Wot, Wot, Wot
Gs^Ft, Gs^Ft, Gs^Es, Gs^Ft, Gll, Gll^Ft, Gs, Gs, Ds^Esd, Ds, Ds^Es, Ds^Dr, Wwrt, Wwt, Wwt, Wot, Wot, Wwt, Wot, Wwt, Wwrt, Wwt, Wwt, Wwt, Wwt, Wot, Wwt, Wwt, Wwt, Wwt, Wot, Wot, Wot, Wot, Wot, Wot, Wot, Wot, Wot, Wot, Wot, Wot
Gs, Gs, Gs, Gd, Gll^Fts, Gs, Chr, Ds, Chw, Ds, Wwt, Wwrt, Wwt, Wwt, Wwt, Wot, Wwrt, Wot, Wot, Wot, Wot, Wwrt, Wot, Wwt, Wwt, Wwt, Wwt, Wwt, Wot, Wot, Wot, Wot, Wot, Wot, Wot, Wot, Wot, Wot, Wot, Wot, Wot, Wot
Gs, Gd, Gll, Gll^Ft, Gs, Gs^Dr, Ds^Es, Ds, Chw, Wwf, Wwrt, Wwt, Wwt, Wwt, Wwt, Wwt, Wwt, Wwt, Wwt, Wot, Wot, Wot, Wot, Wot, Wot, Wot, Wwt, Wwt, Wot, Wot, Wot, Wot, Wot, Wot, Wot, Wot, Wot, Wot, Wot, Wot, Wot, Wot
Gd, Gs, Gs^Ft, Gll^Fts, Gs, Gs^Esd, Ds, Ds, Wwf, Wwf, Wwt, Wwt, Wwt, Wwt, Wwt, Wwt, Wwt, Wwt, Wwt, Wot, Wot, Wot, Wot, Wot, Wot, Wwt, Wwrt, Wwrt, Wot, Wot, Wot, Wot, Wot, Wot, Wot, Wot, Wot, Wot, Wot, Wot, Wot, Wot
Gs^Ft, Gs, Gd, Gs^Dr, Gs^Esd, Ds, Wwrt, Wwt, Wwt, Wwrt, Wwt, Wwt, Wot, Wwt, Wwrt, Wwt, Wwt, Wwt, Wwrt, Wwrt, Wot, Wot, Wot, Wot, Wwt, Wwt, Wot, Wot, Wot, Wot, Wot, Wot, Wot, Wot, Wot, Wot, Wot, Wot, Wot, Wot, Wot, Wot
Gs^Fts, Gs, Gd, Gs, Wwt, Ds, Wwf, Wwt, Wwt, Wwf, Wwt, Wwt, Wwt, Wot, Wwrt, Wwt, Wwrt, Wwrt, Wwrt, Wot, Wot, Wot, Wot, Wot, Wwrt, Wwrt, Wot, Wot, Wot, Wot, Wot, Wot, Wot, Wot, Wot, Wot, Wot, Wot, Wot, Wot, Wot, Wot
Gs, Gs, Gs^Vht, Wwt, Ww^Ewl, Ds^Esd, Ds, Wwt^Bw/r, Wwt, Wwt, Wwt, Wwt, Wwt, Wot, Wot, Wot, Wwrt, Wwrt, Wot, Wot, Wot, Wot, Wot, Wot, Wot, Wot, Wot, Wot, Wot, Wot, Wot, Wot, Wot, Wot, Wot, Wot, Wot, Wot, Wot, Wot, Wot, Wot
Gd, Gs, Gs^Esd, Gs, Ds^Es, Ds, Wwf, Wwt, Wwt, Wwt, Wwt, Wwt, Wwrt, Wot, Wot, Wot, Wot, Wot, Wot, Wot, Wot, Wot, Wot, Wot, Wot, Wot, Wot, Wot, Wot, Wot, Wot, Wot, Wot, Wot, Wot, Wot, Wot, Wot, Wot, Wot, Wot, Wot
Gs, Gs, Gs, Ds, Ds^Es, Ds, Wwrt, Wwrt, Wwrt, Wwrt, Wwt, Wwrt, Wwt, Wot, Wot, Wot, Wot, Wot, Wot, Wot, Wot, Wot, Wot, Wot, Wot, Wot, Wot, Wot, Wot, Wot, Wot, Wot, Wot, Wot, Wot, Wot, Wot, Wot, Wot, Wot, Wot, Wot
Ds, Ds^Es, Ds, Ds^Esd, Ds, Wwf, Wwrt, Wwt, Wwt, Wwt, Wwrt, Wwt, Wwt, Wot, Wwt, Wot, Wot, Wot, Wot, Wot, Wot, Wot, Wot, Wot, Wot, Wot, Wot, Wot, Wot, Wot, Wot, Wot, Wot, Wot, Wot, Wot, Wot, Wot, Wot, Wot, Wot, Wot
Wwf, Wwf, Wwf, Ds, Wwrt, Wwrt, Wwrt, Wwt, Wwrt, Wwrt, Wwt, Wwt, Wwt, Wwrt, Wwt, Wwrt, Wot, Wot, Wot, Wot, Wot, Wot, Wot, Wot, Wot, Wot, Wot, Wot, Wot, Wot, Wot, Wot, Wot, Wot, Wot, Wot, Wot, Wot, Wot, Wot, Wot, Wot
Wwt, Wwrt, Wwt, Wwt, Wwrt, Wwt, Wwt, Wwt, Wwt, Wwt, Wwrt, Wwrt, Wot, Wwt, Wwrt, Wwrt, Wot, Wot, Wot, Wot, Wot, Wot, Wot, Wot, Wot, Wot, Wot, Wot, Wot, Wot, Wot, Wot, Wot, Wot, Wot, Wot, Wot, Wot, Wot, Wot, Wot, Wot
Wwt, Wwt, Wot, Wwt, Wwt, Wwt, Wwt, Wot, Wot, Wot, Wwrt, Wwrt, Wot, Wot, Wot, Wot, Wot, Wot, Wot, Wot, Wot, Wot, Wot, Wot, Wot, Wot, Wot, Wot, Wot, Wot, Wot, Wot, Wot, Wot, Wot, Wot, Wot, Wot, Wot, Wot, Wot, Wot
Wot, Wot, Wot, Wwrt, Wwrt, Wwrt, Wwrt, Wwrt, Wwrt, Wot, Wot, Wot, Wot, Wot, Wot, Wot, Wot, Wot, Wot, Wot, Wot, Wot, Wot, Wot, Wot, Wot, Wot, Wot, Wot, Wot, Wot, Wot, Wot, Wot, Wot, Wot, Wot, Wot, Wot, Wot, Wot, Wot
Wot, Wot, Wot, Wot, Wot, Wwt, Wot, Wot, Wot, Wot, Wot, Wot, Wot, Wot, Wot, Wot, Wot, Wot, Wot, Wot, Wot, Wot, Wot, Wot, Wot, Wot, Wot, Wot, Wot, Wot, Wot, Wot, Wot, Wot, Wot, Wot, Wot, Wot, Wot, Wot, Wot, Wot
Wot, Wot, Wot, Wot, Wot, Wot, Wot, Wot, Wot, Wot, Wot, Wot, Wot, Wot, Wot, Wot, Wot, Wot, Wot, Wot, Wot, Wot, Wot, Wot, Wot, Wot, Wot, Wot, Wot, Wot, Wot, Wot, Wot, Wot, Wot, Wot, Wot, Wot, Wot, Wot, Wot, Wot
Wot, Wot, Wot, Wot, Wot, Wot, Wot, Wot, Wot, Wot, Wot, Wot, Wot, Wot, Wot, Wot, Wot, Wot, Wot, Wot, Wot, Wot, Wot, Wot, Wot, Wot, Wot, Wot, Wot, Wot, Wot, Wot, Wot, Wot, Wot, Wot, Wot, Wot, Wot, Wot, Wot, Wot
Wot, Wot, Wot, Wot, Wot, Wot, Wot, Wot, Wot, Wot, Wot, Wot, Wot, Wot, Wot, Wot, Wot, Wot, Wot, Wot, Wot, Wot, Wot, Wot, Wot, Wot, Wot, Wot, Wot, Wot, Wot, Wot, Wot, Wot, Wot, Wot, Wot, Wot, Wot, Wot, 1 Wot, Wot
Wot, Wot, Wot, Wot, Wot, Wot, Wot, Wot, Wot, Wot, Wot, Wot, Wot, Wot, Wot, Wot, Wot, Wot, Wot, Wot, Wot, Wot, Wot, Wot, Wot, Wot, Wot, Wot, Wot, Wot, Wot, Wot, Wot, Wot, Wot, Wot, Wot, Wot, Wot, Wot, Wot, Wot
