Xu, Xu, Xu, Xu, Xu, Xu, Xu, Xu, Xu, Xu, Xuc, Xuc, Xu, Xu, Xu, Xu, Xu, Xu, Qxu, Qxu, Xu, Xu, Qxu, Qxu, Qxu, Qxu, Qxu, Qxu, Qxu, Xu, Xu, Xu, Xu, Xu, Xu, Xu, Xu, Xu, Xu, Xu, Xu, Xu, Xu, Xu, Xu, Xu, Xu, Xu, Xu, Xu, Xu, Xu
Xu, Xu, Xu, Xu, Xu, Xu, Xu, Xu, Xu, Xu, Uh, Xu, Xu, Xu, Xu, Xu, Uh, Tb^Tf, Qxu, Qxu, Xu, Xu, Cud, Qxu, Qxu, Qxu, Uu, Qxu, Uu^Em, Qxu, Uu^Es, Xu, Xu, Xu, Xu, Xu, Xu, Xu, Xu, Xu, Xu, Xu, Xu, Xu, Xu, Xu, Xu, Xu, Xu, Xu, Xu, Xu
Xu, Xu, Xu, Xu, Xu, Xu, Uu, Xu, Xuc, Uu^Tf, Rb^Edt, Uh, Xu, Xu, Xu, Xu, Qxu, Qxu, Qxu, Qxu, Uh, Xu, 3 Kud, Cud, Qxu, Uu^Em, Ur^Em, Uh, Ur^Edt, Uu^Em, Ur^Es, Uu^Es, Tb^Tf, Xu, Xu, Xu, Xuc, Xu, Xu, Xu, Xu, Xu, Xu, Xu, Xu, Xu, Xu, Xu, Xu, Xu, Xu, Xu
Wog, Xu, Wwrg, Wog, Wwg, Wwf, Wwg, Uh, Tb^Tf, Rb^Edt, Uu^Tf, Xu, Xu, Xu, Xom, Xuc, Ur, Qxu, Xu, Qxu, Qxu, Cud, Cud, Cud, Uu^Ii, Ur^Em, Ur, Uu^Edt, Ur, Ur^Es, Uu^Em, Ur^Em, goal2 Ur^&A, Xu, Xu, Xu, Xuc, Xu, Xu, Xu, Xu, Xu, Xu, Xu, Xu, Xu, Xu, Xu, Xu, Xu, Xu, Xu
Wog, Wog^Xo, Wwrg, Wog, Xu, Wwg, Wwf^Es, Uu^Emf, Uu^Tf, Tb^Tf, goal1 Ur^&A, Xur^&B, Xur^&B, Xom, Uu^Edt, Uu^Em, Uu^Tf, Qxu, Xu, Xu, Qxu, Xu, Tb^Tf, Uu, Ur^Ii, Ur^Ii, Ur^Es, Ur, Uh, Rb^Edt, Uu^Em, Uh, Xur^&B, Xur^&B, Xur^&B, Xu, Uu^Ii, Xuc, Xuc, Xu, Xu, Xu, Xu, Xu, Xu, Xu, Xu, Xu, Xu, Xu, Xu, Xu
Wog, Wog^Xo, Wog, Xu, Xu, Uu, Uu, Xuc, Ur, Tb^Tf, Uu^Em, Xur^&B, Xur^&B, Uu^Tf, Rb, Uu, Xom, Xom, Xu, Xu, Xu, Uh, Uu, Ur, Rb^Edt, Ur, Xu, Uh, Ur^Em, Ur^Em, Rb^Edt, Xu, Xu, Xur^&B, Uu^Em, Ur^Edt, Ur^Edt, Uh, Tb^Tf, Uh^Qspd, Uh, Xu, Xu, Xu, Xu, Xu, Xu, Xu, Xu, Xu, Xu, Xu
Xu, Wog^Xo, Wog, Xu, Wwg, Wwf^Es, Xu, Xu, Rb^Es, Rb^Em, Xuc, Xu, Xu, Ur, Rb, Xom, Xuc, Xu, Xu, Xu, Xuc, Xuc, Uh, Ur^Edt, Uu^Tf, Xu, Xu, Xu, Uu^Es, Uu^Tf, Uu^Es, Tb^Tf, Tb^Tf, Xuc, Xuc, Uu^Edt, Rb^Tf, Uu^Vu, Uu^Ii, Tb^Tf, Uh, Xu, Xu, Xu, Xu, Xu, Xu, Xu, Xu, Xu, Xu, Xu
Xu, Xu, Wog, Wwrg, Xu, Uu, Uu, Uh, Rb^Es, Rb^Edt, Ur^Edt, Xuc, Xu, Uh, Uu, Rb, Uu, Tb^Tfi, Rb^Em, Xu, Uu^Em, Xuc, Rb^Edt, Uu, Xuc, Xu, Qxu, Qxu, Qxu, Uu^Es, Xu, Uu^Qspd, Xu, Xuc, Uu^Edt, Ur, Uu^Vu, Ur^Emf, Cud, Uu^Ii, Uu^Qspd, Xu, Xu, Xu, Xu, Xu, Xu, Xu, Xu, Xu, Xu, Xu
Xu, Xu, Xu, Wog, Xu, Uh, Uu, Uu^Emf, Tb^Tf, Rb^Edt, Ur, Xu, Xu, Xu, Xu, Uu^Tf, Uu^Tf, Uu^Em, Uh, Rb^Em, Uu, Uu, Uu^Edt, Uu^Edt, Xuc, Xu, Qxu, Qxu, Xu, Xu, Xu, Xu, Xu, Xuc, Rb^Edt, Uu, Uh, Uu, 4 Kud, Uu, Xuc, Xuc, Xuc, Xuc, Xuc, Xuc, Xuc, Xuc, Xuc, Xuc, Xuc, Xuc
Xu, Xu, Xu, Xu, Xu, Xu, Xu, Uu, Xu, Wwg, Wwg, Ur, Uh, Xu, Xu, Xu, Xu, Xu, Xu, Uh, Tb^Tf, Uu^Em, Tb^Tf, Tb^Tf, Xu, Xu, Qxu, Qxu, Xu, Xu, Qxu, Xu, Uu^Vu, Rb, Uh, Uh, Uh, Cud, Cud, Uu, Uh, Xuc, Xuc, Xuc, Xuc, Xuc, Xuc, Xuc, Xuc, Xuc, Xuc, Xuc
Xu, Xu, Wog, Xu, Wog, Wwrg, Wwrg, Uu^Tfi, Uu^Tfi, Wwrg, Wwf, Ur, Ur, Xu, Xu, Xu, Xu, Xu, Xu, Xu, Tb^Tf, Tb^Tf, Tb^Tf, Tb^Qspd, Xu, Xu, Xu, Qxu, Xu, Xu, Qxu, Qxu, Uu^Em, Rb, Uh, Xu, Xu, Xu, Xu, Uh, Xuc, Xuc, Xuc, Xuc, Xuc, Xuc, Xuc, Xuc, Xuc, Xuc, Xuc, Xuc
Xu, Xu, Xu, Wog^Xo, Xu, Wwg, Uh, Uh, Xuc, Uu^Em, Uu^Em, Uu^Em, Uu^Em, Wwrg, Uu^Tf, Xu, Xu, Xu, Xu, Xu, Xu, Xu, Uh, Xu, Xu, Xu, Xu, Qxu^Xo, Xu, Xu, Qxu, Qxu, Qxu, Uu^Es, Qxu, Qxu, Qxu, Xu, Xu, Xu, Xu, Xu, Xu, Xuc, Xu, Xuc, Xuc, Xu, Xuc, Xu, Xuc, Xuc
Xu, Xu, Xu, Xu, Xu, Wwg, Wwf, Uh, Ur^Em, Xuc, Uu^Em, Uu^Tf, Ur^Em, Tb^Tf, Uh, Wwf, Wwrg, Wwg, Wog, Xu, Xu, Xu, Xu, Xu, Xu, Xu, Xu, Qxu, Qxu, Qxu^Xo, Xu, Xu, Qxu, Qxu^Bcx|, Qxu, Qxu, Qxu, Qxu, Xu, Xu, Xu, Qxu, Qxu, Xuc, Xuc, Xuc, Xuc, Xuc, Xuc, Xuc, Xuc, Xuc
Xu, Xu, Xu, Xu, Xu, Xu, Xu, Xu, Uh, Xuc, Uh, Ur, Ur, Uu^Em, Uh, Ur, Wwg, Wog, Xu, Wog^Xo, Wog, Xu, Xu, Xu, Xu, Xu, Xu, Xu, Xu, Xu, Xu, Xu, Uu^Tf, Ur^Edt, Ur^Edt, Uu^Em, Xu, Qxu, Xu, Xu, Qxu, Qxu, Qxu, Xuc, Xuc, Xuc, Xuc, Xuc, Xuc, Xuc, Xuc, Xuc
Xu, Xu, Xu, Xu, Xu, Xu, Xu, Xu, Xuc, Uh, Uh, Uu^Ii, Ur, Uh, Uh, Wwf, Wwrg, Xuc, Xuc, Xu, Xu, Xu, Xu, Xu, Xu, Xu, Xu, Xu, Xu, Xu, Xoa, Xu, Uu, Ur, Uu, Uu^Es, Uu, Uu^Es, Uu, Uh, Uu^Tf, Qxu, Qxu, Qxu, Xuc, Xuc, Xu, Xu, Xu, Xuc, Xuc, Xuc
Xuc, Xuc, Xuc, Xu, Xuc, Xu, Xu, Xu, Xu, Xuc, Xuc, Uu^Ii, Uu^Tf, Ur, Uu^Ii, Uh, Xuc, Xuc, Xu, Xu, Xu, Xu, Xu, Xu, Xu, Xu, Xu, Xu, Xoa, Xoa, Uu^Em, Xoa, Uh, Uu^Edt, Ur^Edt, Uu, Xuc, Uh, Xuc, Tb^Tf, Xu, Xu, Uh, Xu, Xuc, Xu, Wog^Xo, Wog, Xu, Xu, Xu, Xuc
Uu^Tf, Uh, Uh, Xuc, Uu^Tf, Xuc, Uh, Xu, Xu, Xu, Xuc, Tb^Tf, Tb^Tf, Ur, Uu^Edt, Uh, Uu^Em, Xuc, Xuc, Xu, Wog, Wog, Xu, Xu, Xu, Xu, Xu, Xu, Xoa, Uh, Uh, Uu, Rb^Edt, Rb^Edt, Ur, Rb^Em, Rb^Tf, Xuc, Uu^Tf, Xom, Xuc, Xu, Tb^Tf, Tb^Tf, Wwg, Wog, Xu, Xu, Xu, Xu, Xu, Xuc
Xuc, Uu^Tf, Uu^Tf, Uu^Em, Xu, Uu^Tf, Uu^Em, Uu^Tf, Uu^Em, Xuc, Xuc, Uh, Xu, Xu, Uu, Ur^Edt, Uh, Xuc, Xuc, Xu, Wog^Xo, Wog^Xo, Xu, Xu, Xu, Xu, Xu, Xu, Xoa, Tb^Tf, Uu^Es, Uu^Es, Uh, Uh, Tb^Tf, Uu^Tf, Xuc, Ur, Tb^Tf, Uu^Tf, Ur, Xu, Xu, Uh, Wwf, Uu, Uu^Ii, Uh^Qspd, Xuc, Xu, Xu, Xu
Ur, Ur^Em, Ur, Uu^Em, Uu^Em, Uu^Vct, Uu^Edt, Uu^Edt, Wwf^Edt, Uu^Edt, Ur^Edt, Uu^Tf, Uu^Es, Uu^Edt, Ur^Edt, Uu, Xuc, Xuc, Xu, Xu, Xu, Wog^Es, Wog^Es, Xuc, Wwrg, Xu, Xu, Xu, Xoa^&C, Uh^&C, deadend_trigger Uh^&C, Rb^Tf, Rb^Tf, Tb^Tf, Uu^Tf, Xuc, Xuc, Tb^Tf, Tb^Tf, Uu^Tf, Uh, Xu, Xu, Xu, Wog, Uu^Vu, Ur, Uu, Tb^Tf, Xu, Xu, Xu
Uh, Wwf, Xu, Ur, Ur^Edt, Uu^Tf, Ce, Ce, Ce, Ur^Edt, Uu, Ur, Ur^Edt, Ur, Wwf, Wwrg, Xu, Xu, Xu, Xos, Xu, Wog^Es, Wwrg, Wog^Es, Wwg, Wwf, Xu, Xu, Xoa, Xoa^&C, Xoa^&C, Rb^&C, Xoa, Uu^Em, Xoa, Xoa, Xu, Xuc, Xuc^&F, Xuc, Xuc, Xu, Wog, Wog^Xo, Xu, Xu, Uh, Uh, Uu^Emf, Xu, Xu, Xu
Xu, Xu, Xuc, Uu^Edt, Uu^Em, Ur, Ce, 1 Ke, Ce, Uu^Edt, Xuc, Rb^Edt, Rb^Edt, Uu, Uh, Uu, Xu, Xu, Xu, Xom, Uu^Tf, Uh, Uh, Uh, Wwg^Es, Wwg, Wog, Xoa, Xoa, Rb, Xoa, Xoa, Xoa, Xoa, Xu, Xu, Xuc, Xuc, Xuc^&F, Xuc, Xuc, Xu, Wog^Xo, Xu, Xu, Xu, Xu, Xu, Xu, Xu, Xu, Xu
Uh, Xu, Uu^Em, Uu^Em, Xuc, Uu^Em, Uu, Ce, Wwf, Wwf, Tb^Tf, Rb^Edt, Xuc, Uh, Uh, Xu, Xu, Xu, Xu^&E, Xom, Tb^Tf, Tb^Tf, Uu^Tf, Uh, Xuc, Wwrg, Wwrg, Wwf^Es, Wwg, Rb^Em, Xoa, Xoa, Wog, Xoa, Xur^&B, Xuc, Xuc, Uh, Ur, Uu^Tf, Xuc, Xu, Wog, Xu, Xu, Xu, Xu, Xu, Xu, Xu, Xu, Xu
Wwf, Wwf, Uh, Xu, Wwf, Uu^Em, Uu^Em, Uu, Uu^Vct, Uu^Tf, Uh, Xuc, Xu, Uh, Xu, Xu, Xom^&E, Xom^&E, Xom, Xom^&E, Xom^&E, Tb^Tf, Uh, Xuc, Uu^Vu, Uh, Wwrg^Es, Wwg, Wwrg, Wwf^Es, Wwrg, Wog^Xo, Xur^&B, Xur^&B, Xur^&B, goal3 Wwf^&A, Uh, Uu^Es, Ur, Uu^Em, Uh, Wwrg, Wog, Tb^Tf, Xuc, Xuc, Xuc, Xuc, Xuc, Xuc, Xuc, Xuc
Uh, Wwf, Uu^Em, Uu^Edt, Xuc, Uh, Xu, Uu^Em, Uu^Em, Xuc, Xu, Xu, Xu^&E, Xu, Xu^&E, Xu^&E, Xom, Xom, Uu^Tf, Xom, Re^Em, Uh^&E, Rb^&E, Rb, Uu^Em, Wwf^Es, Uu^Em, Wwf^Es, Ur, Wwg, Wwg, Wwf^Es, Xur^&B, Xur^&B, Xu, Wwrg, Uu^Tf, Uh, barrier_glyph Uh^Ii, Uu^Tf, Tb^Tf, Wwf, Xu, Wog, Xu, Xuc, Xuc, Xuc, Xuc, Xuc, Xuc, Xuc
Xuc, Uu^Es, Uu, Uu^Edt, Uu^Em, Xuc, Uu, Uu^Emf, Xuc, Xu, Xu^&E, Xu^&E, Uh, Xu^&E, Xom, Xu, Uu, Uu^Em, Re^Em, Re^Edt, Re^Tf, Uu, Uh^&E, Rb^Em, Uh, Rb^Em, Xuc, Ur, Uh, Wwrg, Wwrg, Wwf^Es, Wog, Xuc, Xuc, Xuc, Uu^Tf, Uh, Uu^Em, Tb^Tf, Uh, Xuc, Uh, Wog, Wog, Xuc, Xuc, Xuc, Xuc, Xuc, Xuc, Xuc
Uh, Xuc, Uu, Xuc, Uh, Uu, Xuc, Uu, Xuc, Xu^&E, Uh, Xu, Uh, Xu, Uu^Es, Xuc, Uh, Uu, Uh, Tb^Tf, Uh, Xu, Xu^&E, Xu, Xu, Uh, Xu, Xu, Xu, Wwf^Es, Wwf, Wog^Es, Wog, Wog, Xu, Xuc, Xuc, Uh, Tb^Tf, Uu^Tf, Wwrg, Uh, Wwrg, Wwrg, Uh^Qspd, Xuc, Xuc, Xuc, Xuc, Xuc, Xuc, Xuc
Xuc, Uu^Emf, Xuc, Uh, Xuc, Xuc, Uh, Uh, Xu, Xom^&E, Xom, Uh, Uh, Ur^Es, Isa^Edt, Uu^Es, Rb, Wwf, Xom, Xu, Xu, Xu, Xu, Xu^&E, Xu^&E, Xu^&E, Xu^&E, Xu, Xu, Xu, Xu, Xu, Wog^Xo, Wog^Xo, Xu, Xu, Uh, Wog, Wog, Wog, Wog, Wog, Xu, Uh, Xu, Xu, Xu, Xu, Xu, Xu, Xu, Xu
Xu, Xuc, Xu, Xuc, Xu, Xu, Xu, Xu, Xu, Xu^&E, Xu, Wwrg, Wwrg, Uu^Edt, Uu^Edt, Isa, Rb^Em, Uu^Edt, Uu^Edt, Xom, Wwrg, Xu, Xu, Xu, Xu^Qhu, Xu^Qhu, Wog^Qhu, Xu^&E, Xu^&E, Xu, Xu, Wog, Wog, Xu, Xu, Xu, Wog, Wog, Xu, Wog, Wog, Xu, Xu, Xu, Xu, Xu, Xu, Xu, Xu, Xu, Xu, Xu
Xu^&E, Xu^&E, Xu^&E, Xu^&E, Xu^&E, Xu^&E, Xu^&E, Xu^&E, Xu^&E, Xu^&E, Xu, Xu, Xom, Xom, Xom, Uu, Uu, Isa^Edt, Uu^Edt, Uu, Uu^Edt, Xom, Xom^Qhu, Xuc^Qhu, Wog, Wog^Xo, Wog^Xo, Wog^Qhu, Wog^Qhu, Xu^&E, Xu, Wog, Xu, Xu, Wog, Wog^Xo, Xu, Xu, Xu, Wog, Xu, Xu, Xu, Xu, Xu, Xu, Xu, Xu, Xu, Xu, Xu, Xu
Xu, Xu, Xu, Xu, Xu, Xu, Xu, Xu, Xu, Xu, Xu, Xu, Xu, Xom, Xu, Xom, Xom, Wwf^Es, Wwrg, Isa, Isa, Uu^Edt, Tb^Tf, Wog^Qhu, Wog^Qhu, Wog^_ml, Wog, Wog^Xo, Xu^Qhu, Xu^&E, Xu, Xu, Xu, Xu, Xu, Xu, Xu, Xu, Xu, Wog^Xo, Xu, Xu, Xu, Xu, Xu, Xu, Xu, Xu, Xu, Xu, Xu, Xu
Xu, Xu, Xu, Xu, Xu, Xu, Xu, Xu, Xu, Xu, Xu, Xu, Xu, Xu, Xu, Xu, Xu, Xuc, Uh, Uu, Tb^Tf, Isa^Edt, Ur, Tb^Tf, Uh, Wog^Qhu, Xuc^Qhu, Xu^Qhu, Xuc, Xu^&E, Xu^&E, Xu, Xu, Xu, Xu, Xu, Xu, Xu, Xu, Wog, Xu, Xu, Xu, Xu, Xu, Xu, Xu, Xu, Xu, Xu, Xu, Xu
Xu, Xu, Xu, Xu, Xu, Xu, Xu, Xu, Xu, Xu, Xu, Xu, Xu, Xu, Xu, Xu, Xu, Xu, Xu^Qhu, Uh, Wog^Qhu, Uh, Uh, Ur, Isa, Uh, Uu^Tf, Xuc, Tb^Tf, Xuc, Xos, Xu^&E, Xu^&E, Xu^&E, Xu^&E, Xu^&E, Xu^&E, Xu^&E, Xu^&E, Xu^&E, Xu^&E, Xu^&E, Xu^&E, Xu^&E, Xu^&E, Xu^&E, Xu^&E, Xu^&E, Xu^&E, Xu^&E, Xu^&E, Xu^&E
Xu, Xu, Xu, Xu, Xu, Xu, Xu, Xu, Xu, Xu, Xu, Xu, Xu, Xu, Xu, Xu, Xu^Qhu, Xu^Qhu, Wog^Xo, Wog^Qhu, Wog^_ml, Wog^Qhu, Wog^Qhu, Tb^Tf, Uu, Isa, Isa, Uu^Es, Uu^Es, Xur, Xos, Xuc, Xu, Xu, Xu, Xu, Xu, Xu, Xu, Xu, Xu, Xu, Xu, Xu, Xu, Xu, Xu, Xu, Xu, Xu, Xu, Xu
Xu, Xu, Xu, Xu, Xu, Xu, Xu, Xu, Xu, Xu, Xu, Xu, Xu, Xu, Xu, Xu, Xu^Qhu, Wog, Wog, Wog^Xo, Wog^Xo, Wog, Xuc^Qhu, Xuc, Xuc, Uu^Em, Uu^Es, Isa^Es, Uu^Edt, Exos, Xur, Xuc, Xu, Xu, Xu, Xu, Xor, Xor, Xu, Xu, Xu, Xu, Xu, Xu, Xu, Xu, Xu, Xu, Xu, Xu, Xu, Xu
Xu, Xu, Xu, Xu, Xu, Xu, Xu, Xu, Xom^Efs, Xom, Xom, Xos, Xos, Xu, Xu, Xu, Xu, Xu^Qhu, Xu^Qhu, Wog, Xuc^Qhu, Xuc^Qhu, Xuc, Xos, Xos, Xos, Uu^Em, Isa, Uu^Edt, Exos, Xuc, Xuc, Xu, Xu, Xu, Xu, Isa, Uu, Uu^Ii, Xor, Xor, Xu, Xu, Xu, Xu, Xu, Xu, Xu, Xu, Xu, Xu, Xu
Xu, Xu, Xu, Xu, Xos, Xos, Xom, Xos^Efs, Cud, Cud, Cud, Xot, Xos, Xos, Xos, Xu, Xu, Xu, Xu, Xuc^Qhu, Xuc, Xos, Xos, Xuc, Cud, Xos, Isa^Es, Isa^Es, Uu, Exos, Xos, Xuc, Xuc^Gov, Xu^Gov, Xu^Gov, Xu^Gov, Uu^Emf, Isa, Uu^Tf, Tb^Tf, Xuc, Xor, Xu, Xu, Xu, Xu, Xu, Xu, Xu, Xu, Xu, Xu
Xu, Xu, Xos, Xos, Xom^Efs, Xom^Efs, Cud, Cud, Cud, library_glyph1 Uu^Ii, Cud, Cud, Xos^Efs, Xos, Xos, Xos, Xor, Xor, Xos, Xos, Xor, Xuc, Cud, Xos, Isa^Edt, Isa, Isa, Isa^Em, Xos, Xur, Xos^Gov, Xos, Xuc^Gov, Xu, Xu, Xuc, Isa^Em, Isa, Isa^Edt, Uu^Edt, Tb^Tf, Xuc, Qxu, Xu, Xu, Xu, Xu, Xu, Xu, Xu, Xu, Xu
Xu, Xos, Xos, Xos, Xos, Cud, Cud, library_glyph2 Uu^Ii, Qxu, Cud, Xor, Cud, Cud, Xor, Xor, Xos, Xos, Cud, Xos, Cud, Xor, Xor, main_gate1 Isa^Pr\, Isa, Isa, Isa, Xos, Cud, Xuc, Xos, Xos^Gov, Xos, Xuc^Gov, Xuc, Tb^Tf, Uh^Emf, Isa^Em, Isa, Uu^Tf, Uu^Edt, Uu, Xu, Tb^Tf, Qxu, Xu, Xu, Xu, Xu, Xu, Xu, Xu, Xu
Xu, Xu, Xu, Xos, Xos, Xor, Xor, Qxu, Qxu, Xor, Xos, Xos, Xos, Cud^Pr/o, Cud, Xos, Isa^Es, Isa, Isa^Edb, Isa^Edb, Isa^Edb, Isa, Isa, main_gate2 Isa^Pr\, Xos, Cud, Tb^Tf, Xuc, Xuc, Xuc, Xuc, Xuc^Gov, Xu, Xuc, Uu^Emf, Tb^Tf, Uu, Isa, Re^Es, Uu^Ii, Xu, Uu^Emf, Tb^Tf, Qxu, Qxu, Xu, Xu, Xu, Xu, Xu, Xu, Xu
Xu, Xu, Xu, Xu, Xu, Xos, Xu, Qxu, Xu, Xu, Xu, Xos, Xos, Xos, Xos, Isa, Isa, Isa, Isa^Es, Isa^Edb, Isa^Edb, Isa, Isa^Edb, Isa, Xos, Xos, Tb^Tf, Tb^Tf, Xuc, Xuc, Xu, Xu, Xu, Xu, Uh, Uu, Xu, Tb^Tf, Tb^Tf, Uu, Uu, Tb^Tf, Xu, Xu, Xu, Qxu^Xo, Qxu, Xu, Xu, Xu, Xu, Xu
Xu, Xu, Xu, Xu, Xu, Xu, Uh, Uu, Tb^Tf, Xuc, Xuc, Xu, Xu, Xos, Xos, Isa^Es, Isa^Edt, Isa, Isa, Isa^Edb, Isa^Edt, Isa, Isa^Edb, Uu^Em, Xos, Xu, Xu, Uh, Xu, Xu, Xu, Qxu, Qxu^Xo, Qxu, Qxu, Uu^Ii, Xu, Tb^Tf, Tb^Tf, Uu, Qxu, Qxu, Qxu, Xu, Xu, Xu, Xu, Xu, Xu, Xu, Xu, Xu
Xu, Xu, Xu, Xu, Xu, Xu, Uh, Uu, Uu, Uh, Xu, Xu, Xu, Xos, Xos, Uu^Edt, Isa^Edt, Isa^Edt, Isa, Isa^Edt, Isa, Isa, Isa^Edb, Isa^Edb, Xor, Xu, Xos, Xu, Xu, Xu, Xu, Xu, Xu, Xu, Qxu, Qxu, Xu, Xu, Xu, Xu, Xu, Qxu, Qxu, Xu, Xu, Xu, Xu, Xu, Xu, Xu, Xu, Xu
Xu, Xu, Xu, Xu, Xos, Xu, Xu, Xu, Uh, Xu, Xoc, Xu, Xos, Xos, Xos, Isa^Edb, Isa, Isa, Isa^Edb, Isa, Isa, Isa, Isa, Isa^Es, Xor, Xos, Xos, Xos, Xos, Xu, Xu, Xu, Xu, Xu, Xu, Qxu^Xo, Qxu, Xu, Xu, Xu, Qxu^Xo, Qxu, Xu, Xu, Xu, Xu, Xu, Xu, Xu, Xu, Xu, Xu
Xu, Xu, Xoc, Xoc, Xor, Xos, Xos, Xu, Xoc, Xoc, Xoc, Xos, Xor, Xor^Xzm/, Cud, Isa, Isa, Isa^Edb, Isa^Edb, Isa, Isa^Edb, Isa^Edb, Uu^Edb, Isa, Isa^Pr/, Xos, Xos^Efs, Xor, Xoc, Xos, Xos, Xu, Xu, Xu, Xu, Xu, Xu, Xu, Xu, Xu, Qxu, Qxu^Xo, Xu, Xu, Xu, Xu, Xu, Xu, Xu, Xu, Xu, Xu
Xoc, Xoc, Xoc, Xoc, Xor, Xor, Xor, Xos, Xoc^Efs, Xoc^Efs, Uu^Es, Xos, Cud^Edt, Cud^Pr\, Xos, Xos, Cud, Xos, Cud, Xos, Cud, Xos, Cud, Xos, Xos, Isa^Edb, Ur^Es, Uu^Edt, Uu^Em, Xor, Xor, Xos, Wwrg, Wwg^Es, Xu, Xu, Xu, Xu, Xu, Xu, Xu, Qxu, Xu, Xu, Xu, Xu, Xu, Xu, Xu, Xu, Xu, Xu
Xoc, Xoc, Xor, Xor, Xor, Xor, Uu^Emf, Xos, Uu, Uu, Isa, Uu^Edt, Uu^Edt, Xos, Xos, Xos, Xos, Xos, Xos, Xos, Cud^Pr|, Xos, Xos, Xor, Xor, Uu^Edb, Uu^Em, Ur^Es, Uu^Emf, Uh, Xoi, Xu, Exos, Wog^Es, Xu, Xu, Xu, Xu, Xu, Xu, Xu, Xu, Xu, Xu, Xu, Xu, Xu, Xu, Xu, Xu, Xu, Xu
Xos, Xoc, Xoc^Efs, Xoc^Efs, Tb^Tf, Uh, Tb^Tf, Uh, Uu, Uu^Es, Isa, Uu^Em, Xos, Xos, Xos, Xos, Xos, Xos, Xor, Xor, Cud, Xos, Cud, Cud, Cud, Xos^Xzm\, Xoc, Uu, Xoi^Efs, Xoi^Efs, Xu, Exos, Isa, Exos, Xor, Xos, Exos, Uh, Wwg^Es, Xu, Xu, Xu, Xu, Xu, Xu, Xu, Xu, Xu, Xu, Xu, Xu, Xu
Xu, Xoc, Xos, Uu, Uu, Uu^Em, Uu^Emf, Isa^Em, Uu^Tf, Isa, Uu^Es, Xor, Xor^Xzm\, Xos, Xos, Xos, Xos, Xos, Xos, Cud^Es, healing_glyph Uu^Ii, Cud, Xos, Xos, Xos, blocked_gate Cud^Zz/, Cud, Xoi, Uu, Uh, Uu^Eb, Uu, Isa^Es, Isa, Wwf^Es, Xor^Efs, Xos, Uh, Uh, Xu, Xu, Xu, Xu, Xu, Xu, Xu, Xu, Xu, Xu, Xu, Xu, Xu
Xu, Xu, Xu, Xos, Uu^Edt, library_glyph3 Uu^Ii, Isa^Em, Tb^Tf, Uh, library_glyph7 Uu^Ii, Isa^Em, Uu, Uu^Edt, Xos^Efs, Xos, Xos, Xos, Xos, Xos, Cud, Wwf, Cud, Xos, Xos, Xos, Xos, Xoi, Uu, Uu, Uu, Isa^Es, Xu, Isa^Edt, Uu, Wwf, Wwf^Es, Uh, Xuc, Exos^Emf, Uh, Xu, Xu, Xu, Xu, Xu, Xu, Xu, Xu, Xu, Xu, Xu, Xu
Xu, Xu, Xu, Xu, Xu^Edt, Uu^Edt, Uu, Isa, Isa, Uu, Uu, Isa, Isa^Edt, Uu^Edt, Uu^Emf, Xos, Xu, Xos, Xu, Xor, Wwrg, Xos, Xos, Xos, Xu, Xos, Xos, Xoi, Uh, Uu, Isa, Isa^Edt, spell_glyph Uu^Ii, Isa, Isa^Em, Isa^Emf, Tb^Tf, Uh, Exos^Emf, Xuc, Xu, Xu, Xu, Xu, Xu, Xu, Xu, Xu, Xu, Xu, Xu, Xu
Xu, Xu, Xu, Xu, Xu, Uh, Uu^Emf, library_glyph4 Uu^Ii, Uu, Isa^Em, Isa, Uu, Isa, Isa^Em, Uh, Xu, Xor^Xzm/, Xor, Wwrg, Wog^Es, Wwrg, Xu, Isa^Dr, Isa^Edt, Uh, Xor, Xu, Xor, Uh, Uh, Wwf, Isa, Isa, Isa^Em, Wwf, Exos, Uu, Uu, Xu, Exos, Xu, Xu, Xu, Xu, Xu, Xu, Xu, Xu, Xu, Xu, Xu, Xu
Xu, Xu, Xu, Xu, Xu, Xu, Xu, Uu, Uh, Isa, library_glyph5 Uu^Ii, Isa^Em, Isa^Tf, library_glyph6 Uu^Ii, Uu^Emf, Xu, Xu, Wwrg, Wwg, Wwg^Es, lower_levels_sign Isa^Em, Uh, Ur^Br\, Tb^Tf, Xu, Xu, Xu, Xu, Isa, Isa^Emf, Isa^Em, Uu^Eb, Uu^Edt, Uu^Em, Isa, Isa, Uh, Xu, Xu, Xu, Xu, Xu, Xu, Xu, Xu, Xu, Xu, Xu, Xu, Xu, Xu, Xu
Xu, Xu, Xu, Xu, Xu, Xu, Xu, Xu, Xu, Uh, Uu, Uu^Emf, Tb^Tf, Uu^Tf, Xu, Xu, Xu, Wog^Es, flooded_trigger Wog, Wog^Es, Xor, Uh, Uu^Br|, Ur^Br\, Xu, Xu, Xu, Xu, Xor, Tb^Tf, Tb^Tf, Isa, Isa^Edt, Isa^Edt, Isa, Isa, Wwf, Wwf, Xu, Xu, Xu, Xu, Xu, Xu, Xu, Xu, Xu, Xu, Xu, Xu, Xu, Xu
Xu, Xu, Xu, Xu, Xu, Xu, Xu, Xu, Xu, Xor, Xor, Uu^Em, Xu, Xu, Xu, Xu, Xu, Xu, Wog^Xo, Wog^Xo, Xu, Xor, Uu^Br|, Tb^Tf, Isa, Uu, Tb^Tf, Xu, Xu, Xu, Xu, Xu, Uu, Xu, Xu, Xu, Xu, Xu, Xu, Xu, Xu, Xu, Xu, Xu, Xu, Xu, Xu, Xu, Xu, Xu, Xu, Xu
Xu, Xu, Xu, Xu, Xu, Xu, Xu, Xu, Xu, Xos, Xos, Xos, Xu, Xu, Xu, Xu, Xu, Xu, Wog, Wog, Xu, Xuc, Uh, Xor, Xor, Xu, Ur, Qxu, Qxu, Xos, Qxu, Qxu, Qxu, Ur, Xuc, Xu, Xu, Xu, Xu, Xu, Xu, Xu, Xu, Xu, Xu, Xu, Xu, Xu, Xu, Xu, Xu, Xu
Xu, Xu, Xu, Xu, Xu, Xu, Xu, Xu, Xu, Xos, Xos, Xos, Xu, Xu, Xu, Xu, Xu, Xu, Xu, Xu, Xu, Xu, Xu, Xu, Xu, Xu, Xuc, Uu, Ur, Qxu, Uu^Br\, Qxu, Tb^Tf, Qxu, Uh, Xu, Xu, Xu, Xu, Xu, Xu, Xu, Xu, Xu, Xu, Xu, Xu, Xu, Xu, Xu, Xu, Xu
Xu, Xu, Xu, Xu, Xu, Xu, Xu, Xu, Xu, Xos, Xos, Xos, Xu, Xu, Xu, Xu, Xu, Xu, Xu, Xu, Xu, Xu, Xu, Xu, Xu, Xuc, Uh^Qspd, Uu, barrier_glyph2 Uu^Ii, Isa, Uu, Ur^Br\, Uu^Dr, Qxu, Xu, Xu, Xu, Xu, Xu, Xu, Xu, Xu, Xu, Xu, Xu, Xu, Xu, Xu, Xu, Xu, Xu, Xu
Xu, Xu, Xu, Xu, Xu, Xu, Xu, Xu, Xu, Xos, Xos, Xos, Xu, Xu, Xu, Xu, Xu, Xu, Xu, Xu, Xu, Xu, Xu, Xu, Xu, Xu, Xu, Uh, Xu, Uh, Xu, Uh, Uh, Uh, Xu, Xu, Xu, Xu, Xu, Xu, Xu, Xu, Xu, Xu, Xu, Xu, Xu, Xu, Xu, Xu, Xu, Xu
Xu, Xu, Xu, Xu, Xu, Xu, Xu, Xu, Xu, Xos, Xos, Xos, Xu, Xu, Xu, Xu, Xu, Xu, Xu, Xu, Xu, Xu, Xu, Xu, Xu, Xu, Xu, Xu, Xu, Xu, Xu, Xu, Xu, Xu, Xu, Xu, Xu, Xu, Xu, Xu, Xu, Xu, Xu, Xu, Xu, Xu, Xu, Xu, Xu, Xu, Xu, Xu
Xu, Xu, Xu, Xu, Xu, Xu, Xu, Xu, Xu, Xos, Xos, Xos, Xu, Xu, Xu, Xu, Xu, Xu, Xu, Xu, Xu, Xu, Xu, Xu, Xu, Xu, Xu, Xu, Xu, Xu, Xu, Xu, Xu, Xu, Xu, Xu, Xu, Xu, Xu, Xu, Xu, Xu, Xu, Xu, Xu, Xu, Xu, Xu, Xu, Xu, Xu, Xu
