Xu, Xu, Xu, Xu, Xu, Xu, Xu, Xu, Xu, Xu, Xuc, Xuc, Xuc, Xu, Xu, Xu, Xu, Xu, Xu, Xu, Xu, Xu, Xu, Xu, Xu, Xu, Xu, Xu, Xu, Xu, Xu, Xu, Xu, Xu, Xu, Xu, Xu, Xu, Xu, Xu, Xu, Xu
Xu, Xu, Xu, Xu, Xu, Xu, Xu, Xu, Xu, Xu, Uh, Rb, Rb, Tb^Tf, Ur, Uh, Uh, Uu^Tf, Tb^Tf, Xu, Xu, Xu, Xu, Xu, Xu, Xu, Uu, Xu, Uu^Em, Xu, Uu^Es, Xu, Xu, Xu, Xu, Xu, Xu, Xu, Xu, Xu, Xu, Xu
Xu, Xu, Xu, Xu, Xu, Xu, Xu, Xu, Xuc, Uu^Tf, Rb, Rb, Uh, Uu, Uu, Ur, Uu, Uu^Ii, Uu^Ii, Xu, Xu, Xu, Xu, Xu, Xu, Uu^Em, Ur^Em, Uh, Ur, Uu^Em, Ur^Es, Uu^Es, Tb^Tf, Xu, Xu, Xu, Xuc, Xu, Xu, Xu, Xu, Xu
Xu, Xu, Xu, Xu, Xu, Xu, Xu, Xuc, Tb^Tf, Rb, Uu^Tf, Xom, Xom, Xom, Xom, Xom, Ur, Uu, Uh, Xuc, Xom, Xu, Uh, Uu, Uu^Ii, Ur^Em, Ur, Uu, Ur, Ur^Es, Ur, Ur^Em, Ur, Xu, Uu^Em, Xu, Xuc, Xu, Xu, Xu, Xu, Xu
Xu, Xu, Xu, Xu, Xu, Xu, Xu, Xuc, Uu^Tf, Tb^Tf, Uu^Em, Xom, Xu, Xom, Uu, Uu^Em, Uu^Tf, Uh^Ii, Cud, Cud, Cud, Xu, Tb^Tf, Uu, Ur^Ii, Ur^Ii, Ur^Es, Ur, Uh, Uh, Uh, Uh, Uh, Tb^Tf, Uu^Tf, Uu, Uu^Ii, Xuc, Xuc, Xu, Xu, Xu
Xu, Xu, Xu, Xu, Xu, Xu, Xu, Xuc, Ur, Ur, Uu^Em, Xuc, Uu^Tf, Uu^Tf, Rb, Uu, Xom, Xom, Cud, 3 Kud, Cud, Uh, Uu, Ur, Rb, Ur, Xu, Xu, Xu, Xu, Xu, Xu, Xu, Uu^Em, Uu^Em, Ur, Ur, Uh, Tb^Tf, Uh, Uh, Xu
Xu, Xu, Xu, Xu, Xu, Xu, Xu, Xu, Rb^Es, Rb^Em, Uu, Xuc, Xu, Uu^Em, Rb, Xom, Xom, Uh^Ii, Xu, Cud, Xuc, Xuc, Uh, Ur, Uu^Tf, Xu, Xu, Xu, Uu^Es, Uu^Tf, Uu^Es, Tb^Tf, Tb^Tf, Xuc, Xuc, Uu, Rb^Tf, Uu^Vu, Uu^Ii, Tb^Tf, Uh, Xu
Xu, Xu, Xu, Xu, Xu, Xu, Xu, Uh, Rb^Es, Rb, Ur, Xuc, Xu, Uh, Uu, Rb, Uu, Tb^Tfi, Rb^Em, Uh, Uu^Em, Xuc, Rb, Uu, Xu, Xu, Xu, Qxu, Qxu, Uu^Es, Xu, Uu, Uu, Xuc, Uu^Em, Ur, Uu^Vu, Ur, Cud, Uu^Ii, Uu, Xu
Xu, Xu, Xu, Xu, Xu, Xu, Xu, Uh, Uu, Rb, Ur, Uu^Es, Uu^Tf, Xu, Xu, Uu^Tf, Uu^Tf, Uu^Em, Uh, Rb^Em, Uu, Uu, Uu, Uu, Xu, Xu, Xu, Qxu, Qxu, Xu, Xu, Uu^Es, Uh, Uu, Rb, Uu, Uh, Uu, 4 Kud, Uu, Xuc, Xuc
Xu, Xu, Xu, Xu, Xu, Xu, Xu, Uh, Xu, Qxu, Qxu, Ur, Uh, Qxu, Qxu, Xu, Xu, Xu, Xu, Uh, Xu, Uu^Em, Xu, Xu, Xu, Xu, Xu, Qxu, Qxu, Xu, Qxu, Xu, Uu^Vu, Rb, Uh, Uh, Uh, Cud, Cud, Uu, Uh, Xuc
Xu, Xu, Xu, Xu, Qxu, Qxu, Qxu, Uu^Tfi, Uu^Tfi, Qxu, Qxu, Ur, Ur, Uu^Ii, Uu, Qxu, Qxu, Xu, Wog, Xu, Xu, Xu, Xu, Xu, Xu, Xu, Xu, Xu, Xu, Xu, Qxu, Qxu, Uu^Em, Rb, Uh, Xu, Xu, Xu, Xu, Uh, Xuc, Xuc
Xu, Xu, Xu, Xu, Xu, Qxu, Qxu, Xu, Uu^Tf, Xuc, Xuc, Uu^Em, Uu^Em, Qxu, Uu^Tf, Qxu, Qxu, Xu, Xu, Wog, Xu, Xu, Xu, Xu, Xu, Xu, Xu, Xu, Xu, Xu, Xu, Qxu, Qxu, Uu^Es, Qxu, Qxu, Qxu, Xu, Xu, Xu, Xu, Xu
Xu, Xu, Xu, Xu, Xu, Qxu, Qxu, Xu, Uh, Uu^Em, Xuc, Uu^Tf, Ur^Em, Tb^Tf, Uh, Qxu, Qxu, Xu, Xu, Wog, Wog, Xu, Xu, Xu, Xu, Xu, Xu, Xu, Xu, Xu, Xu, Xu, Qxu, Uu, Uu, Qxu, Qxu, Qxu, Xu, Xu, Xu, Qxu
Xu, Xu, Xu, Xu, Xu, Xu, Xu, Xu, Xu, Uu^Tf, Uh, Ur, Ur, Uu^Em, Qxu, Ur, Qxu, Xu, Xu, Xu, Wog, Xu, Xu, Xu, Xu, Xu, Xu, Xu, Xu, Xu, Xu, Xu, Uu^Tf, Ur, Ur, Uu^Em, Xu, Qxu, Xu, Xu, Qxu, Qxu
Xu, Xu, Xu, Xu, Xu, Xu, Xu, Xu, Xuc, Xuc, Uh, Uu^Ii, Ur, Uh, Qxu, Qxu, Qxu, Xuc, Xuc, Xu, Xu, Wog, Wog, Xu, Xu, Xu, Xu, Xu, Xu, Xu, Xoa, Xu, Uu, Ur, Uu, Uu^Es, Uu, Uu^Es, Uu, Uh, Uu^Tf, Qxu
Xuc, Xuc, Xuc, Xu, Xuc, Xu, Xu, Xu, Xu, Xuc, Xuc, Uu^Ii, Uu^Tf, Ur, Uu^Ii, Qxu, Xuc, Xuc, Xu, Xu, Xu, Xu, Wog, Xu, Wog, Xu, Xu, Xu, Xoa, Xoa, Uu^Em, Xoa, Uh, Uu, Ur, Uu, Xuc, Uh, Xuc, Tb^Tf, Xu, Xu
Uu^Tf, Uh, Uh, Xuc, Uu^Tf, Xuc, Uh, Xu, Xu, Xu, Xuc, Tb^Tf, Tb^Tf, Ur, Uu, Uh, Uu^Em, Xuc, Xuc, Xu, Xu, Xu, Wog, Wog, Xu, Wog, Xu, Xu, Xoa, Uh, Uh, Uu, Rb, Rb, Ur, Rb^Em, Rb^Tf, Xuc, Uu^Tf, Xuc, Xuc, Xu
Xuc, Uu^Tf, Uu^Tf, Uu^Em, Uu^Em, Uu^Tf, Uu^Em, Uu^Tf, Uu^Em, Xuc, Xuc, Xu, Xu, Xu, Uu, Ur, Uh, Xuc, Xuc, Xu, Xu, Xu, Xu, Wog, Xu, Wwf, Xu, Xu, Xoa, Tb^Tf, Uu^Es, Uu^Es, Uh, Uh, Tb^Tf, Uu^Tf, Xuc, Uu^Tf, Tb^Tf, Uu^Tf, Xuc, Xu
Ur, Ur^Em, Ur, Uu^Em, Xu, Xu, Uu^Vct, Uu, Uu, Uu, Ur, Uu^Tf, Uu^Es, Uu, Ur, Uu, Xuc, Xuc, Xu, Xu, Xu, Wwf, Xu, Wwf, Xu, Xu, Xu, Xu, Xoa, Uh, Uh, Rb^Tf, Rb^Tf, Tb^Tf, Uu^Tf, Xuc, Xuc, Tb^Tf, Tb^Tf, Uu^Tf, Xuc, Xu
Uh, Uu, Xu, Ur, Ur, Uu^Tf, Ce, Ce, Ce, Ur, Uu, Ur, Ur, Ur, Qxu, Qxu, Xu, Xu, Xu, Xos, Xu, Wog, Wog, Xu, Xuc, Wwf, Xu, Xu, Xoa, Xoa, Xoa, Rb, Xoa, Uu^Em, Xoa, Xoa, Xu, Xuc, Xuc, Xuc, Xuc, Xu
Xu, Xu, Xuc, Uu, Xu, Ur, Ce, 1 Ke, Ce, Uu, Xu, Rb, Rb, Uu, Uh, Uu, Xu, Xu, Xu, Xom, Uu^Tf, Uh, Uh, Uh, Xuc, Wog, Wog, Xoa, Xoa, Rb, Xoa, Xoa, Xoa, Xoa, Xu, Xu, Xuc, Xuc, Ur^Es, Xuc, Xuc, Xu
Uh, Xu, Uu^Em, Uu^Em, Xu, Uu^Em, Uu, Ce, Uu^Vct, Uu, Tb^Tf, Rb, Xuc, Uh, Uh, Xu, Xu, Xu, Xu, Xom, Tb^Tf, Tb^Tf, Uu^Tf, Uh, Xuc, Wog, Wwg, Wwf, Wwg, Rb^Em, Xoa, Xoa, Wog, Xoa, Wwf, Xuc, Xuc, Uh, Ur, Uu^Tf, Xuc, Xu
Uu, Uh, Uh, Xu, Uu, Uu^Em, Xu, Uu, Uh, Uu^Tf, Uh, Xuc, Xu, Uh, Xu, Xu, Xom, Xom, Xom, Xom, Xom, Tb^Tf, Uh, Xuc, Uu^Vu, Uh, Wwg, Wwf, Wwg, Wwf, Wwg, Wog, Xu, Xu, Wog, Wog, Uh, Uu^Es, Ur, Uu^Em, Uh, Xuc
Uh, Uu, Uu^Em, Uu^Es, Xuc, Uh, Xu, Xu, Uu^Em, Xuc, Xu, Xu, Xu, Xu, Xu, Xu, Xom, Xom, Uu^Tf, Xom, Re^Em, Uh, Rb, Rb, Uu^Em, Wwf, Wwg, Wwg, Uh, Wwg, Wog, Xu, Xu, Wwf, Xu, Wog, Uu^Tf, Uh, Uh^Ii, Uu^Tf, Tb^Tf, Xuc
Xuc, Uu^Es, Uu, Uu, Uu^Em, Xuc, Uu, Uu^Emf, Xuc, Xu, Xu, Xu, Uh, Xu, Xom, Xu, Uu, Uu^Em, Re^Em, Re, Re^Tf, Uu, Uh, Rb^Em, Uh, Rb^Em, Xuc, Uh, Uh, Xu, Wog, Xu, Wog, Wog, Xu, Xuc, Uu^Tf, Uh, Uu^Em, Tb^Tf, Uh, Xuc
Uh, Xuc, Uu, Xuc, Uh, Uu, Xuc, Uu, Xuc, Xu, Uh, Xu, Uh, Xu, Uu^Es, Xom, Uh, Uu, Uh, Tb^Tf, Uh, Xu, Xu, Xu, Xu, Uh, Xu, Xu, Xu, Xu, Wwf, Xu, Wwf, Wog, Xu, Xuc, Xuc, Uh, Tb^Tf, Uu^Tf, Xuc, Xuc
Xuc, Uu^Emf, Xuc, Uh, Xuc, Xuc, Uh, Uh, Xu, Xom, Xom, Uh, Uh, Ur^Es, Urb, Uu^Es, Rb, Rb, Xom, Xu, Xu, Xu, Xu, Xu, Xu, Xu, Xu, Xu, Xu, Xu, Xu, Xu, Wog, Wog, Wog, Xu, Xu, Xuc, Xuc, Xuc, Xuc, Xu
Xu, Xuc, Xu, Xuc, Xuc, Xu, Xu, Xu, Xu, Xu, Xu, Xom, Xom, Uu^Es, Uu, Urb, Rb^Em, Uu, Uu, Xom, Xom, Xu, Xu, Xu, Xu, Xu, Xu, Xu, Xu, Wwf, Xu, Wwf, Xu, Wwf, Wog, Xu, Wog, Xu, Xu, Xu, Xu, Xu
Xu, Xu, Xu, Xu, Xu, Xu, Xu, Xu, Xu, Xu, Xu, Xu, Xom, Xom, Xom, Uu, Uu, Urb, Uu, Uu, Uu, Xom, Xom, Xu, Wog, Xu, Wog, Wwf, Wog, Wog, Wwf, Xu, Wog, Xu, Xu, Wog, Xu, Wog, Wog, Xu, Wog, Xu
Xu, Xu, Xu, Xu, Xu, Xu, Xu, Xu, Xu, Xu, Xu, Xu, Xom, Xom, Xu, Xom, Xom, Uu, Uu, Urb, Urb, Uu, Cud, Wog, Wog, Wog, Wog, Wog, Wwf, Wog, Wog, Wog, Wog, Wwf, Xu, Xu, Xu, Xu, Xu, Wog, Xu, Wog
Xu, Xu, Xu, Xu, Xu, Xu, Xu, Xu, Xu, Xu, Wog, Wog, Wog, Xom, Wog, Xu, Wog, Xom, Xom, Uu, Cud, Urb, Ur, Cud, Cud, Wog, Xuc, Xu, Xuc, Xuc, Xuc, Wog, Xu, Xu, Xu, Xu, Xu, Xu, Xu, Xu, Xu, Xu
Xu, Xu, Xu, Xu, Wog, Xu, Wog, Wog, Wog, Wog, Wog, Wog, Wog, Wog, Wog, Wog, Wog, Wog, Wog, Xom, Wog, Cud, Cud, Ur, Urb, Cud, Uu, Xuc, Xuc, Xuc, Xos, Xuc, Xu, Xu, Xu, Xu, Xu, Xu, Xu, Xu, Xu, Xu
Wog, Wog, Wog, Wog, Wog, Wog, Wog, Wog, Wog, Wog, Wog, Wog, Wog, Wog, Xu, Wog, Wog, Wog, Wog, Wog, Wog, Wog, Wog, Cud, Uu, Urb, Urb, Uu^Es, Uu^Es, Xos, Xos, Xuc, Xu, Xu, Xu, Xu, Xu, Xu, Xu, Xu, Xu, Xu
Wog, Wog, Wog, Wog, Wog, Wog, Wog, Wog, Xu, Xu, Xu, Xu, Xu, Xu, Xu, Xu, Xuc, Xuc, Xuc, Wog, Xuc, Wog, Xuc, Xuc, Xuc, Uu^Em, Uu^Es, Urb^Es, Uu, Xos, Xos, Xuc, Xu, Xu, Xu, Xu, Xu, Xu, Xu, Xu, Xu, Xu
Wog, Wog, Xu, Wog, Xu, Xu, Xu, Xu, Xom^Efs, Xom, Xom, Xos, Xos, Xu, Xu, Xu, Xu, Xu, Xuc, Xuc, Xuc, Xuc, Xuc, Xos, Xos, Xos, Uu^Em, Urb, Uu, Xos, Xos, Xuc, Xu, Xu, Xu, Xu, Xu, Xu, Xu, Xu, Xu, Xu
Xu, Xu, Xu, Xu, Xos, Xos, Xom, Xos^Efs, Cud, Cud, Cud, Xos, Xos, Xos, Xos, Xu, Xu, Xu, Xos, Xuc, Xuc, Xos, Xos, Xuc, Cud, Xos, Urb^Es, Urb^Es, Uu, Xos, Xos, Xuc, Xuc, Xu, Xu, Xu, Xu, Xu, Xu, Xu, Xu, Xu
Xu, Xu, Xos, Xos, Xom^Efs, Xom^Efs, Cud, Cud, Cud, Uue^Ii, Cud, Cud, Xos^Efs, Xos, Xos, Xos, Xos, Xos, Xos, Xos, Xos, Xuc, Cud, Xos, Urb, Urb, Urb, Urb^Em, Xos, Xos, Xos, Xos, Xuc, Xu, Xu, Xu, Xu, Xu, Xu, Xu, Xu, Xu
Xu, Xos, Xos, Xos, Xos, Cud, Cud, Uue^Ii, Cud, Cud, Xos, Cud, Cud, Xoc^Efs, Xoc, Xos, Xos, Cud, Xos, Cud, Xos, Xos, Urb^Pr\, Urb, Urb, Urb, Xos, Cud, Xuc, Xos, Xos, Xos, Xuc, Xu, Xu, Xu, Xu, Xu, Xu, Xu, Xu, Xu
Xu, Xu, Xu, Xos, Xos, Xos, Xos, Cud, Xos, Xos, Xos, Xos, Xos, Cud^Pr/, Cud, Xos, Urb^Es, Urb, Urb, Urb, Urb, Urb, Urb, Urb^Pr\, Xos, Cud, Xuc, Xos, Xos, Xuc, Xuc, Xuc, Xu, Xu, Xu, Xu, Xu, Xu, Xu, Xu, Xu, Xu
Xu, Xu, Xu, Xu, Xu, Xos, Xos, Xos, Xos, Xos, Xu, Xos, Xos, Xos, Xos, Urb, Urb, Urb, Urb^Es, Urb, Urb, Urb, Urb, Urb, Xos, Xos, Xos, Xuc, Xu, Xu, Xu, Xu, Xu, Xu, Xu, Xu, Xu, Xu, Xu, Xu, Xu, Xu
Xu, Xu, Xu, Xu, Xu, Xu, Xu, Xos, Xu, Xu, Xu, Xu, Xu, Xos, Xos, Urb^Es, Urb, Urb, Urb, Urb, Urb, Urb, Urb^Es, Urb^Em, Xos, Xu, Xu, Xu, Xu, Xu, Xu, Xu, Xu, Xu, Xu, Xu, Xu, Xu, Xu, Xu, Xu, Xu
Xu, Xu, Xu, Xu, Xu, Xu, Xu, Xu, Xu, Xu, Xu, Xu, Xu, Xos, Xos, Urb, Urb, Urb, Urb, Urb, Urb, Urb, Urb, Urb, Xos, Xu, Xos, Xu, Xu, Xu, Xu, Xu, Xu, Xu, Xu, Xu, Xu, Xu, Xu, Xu, Xu, Xu
Xu, Xu, Xu, Xu, Xos, Xu, Xu, Xu, Xu, Xu, Xoc, Xu, Xos, Xos, Xos, Urb, Urb, Urb, Urb, Urb, Urb, Urb, Urb, Urb^Es, Xos, Xos, Xos, Xos, Xos, Xu, Xu, Xu, Xu, Xu, Xu, Xu, Xu, Xu, Xu, Xu, Xu, Xu
Xu, Xu, Xoc, Xoc, Xoc, Xos, Xos, Xu, Xoc, Xoc, Xoc, Xos, Xos, Xos, Cud, Urb, Urb, Urb, Urb, Urb, Urb, Urb, Urb^Es, Urb, Urb^Pr/, Xos, Xos^Efs, Xoc, Xoc, Xos, Xos, Xu, Xu, Xu, Xu, Xu, Xu, Xu, Xu, Xu, Xu, Xu
Xoc, Xoc, Xoc, Xoc, Cud, Xos, Xos, Xos, Xoc^Efs, Xoc^Efs, Cud^Es, Xos, Cud, Cud^Pr\, Xos, Xos, Cud, Xos, Cud, Xos, Cud, Xos, Cud, Xos, Xos, Urb, Urb^Es, Uu, Uu^Em, Xoc, Xoi, Xos, Xos, Xu, Xu, Xu, Xu, Xu, Xu, Xu, Xu, Xu
Xoc, Xoc, Cud, Cud, Uue^Ii, Cud, Cud, Xos, Cud, Cud, Cud, Cud, Cud^Es, Xos, Xos, Xos, Xos, Xos, Xos, Xos, Cud^Es, Xos, Xos, Xos, Xos, Uu, Uu^Em, Urb^Es, Uu^Emf, Uh, Xoi, Xoi^Efs, Xoi^Efs, Xom, Xos, Xu, Xu, Xu, Xu, Xu, Xu, Xu
Xos, Xoc, Xoc, Cud, Cud, Cud, Uue^Ii, Cud, Cud, Cud^Es, Cud, Cud, Xos, Xos, Xos, Xos, Xos, Xos, Xos, Xos, Cud, Xos, Cud, Cud, Cud^Pr/, Xos, Xoc, Uu, Xoi^Efs, Xoi^Efs, Cud, Cud, Cud^Em, Xoi, Xoi, Xos, Xos, Xu, Xu, Xu, Xu, Xu
Xu, Xoc, Xos, Xos, Xos, Cud, Cud, Cud, Uue^Ii, Cud, Cud^Es, Xos, Xos^Efs, Xos, Xos, Xos, Xos, Xos, Xos, Cud^Es, Wo, Cud, Xos, Xos, Xos, Cud, Cud, Xoi, Cud, Cud, Cud, Cud, Cud, Cud, Cud, Xoi^Efs, Xoi^Efs, Xos, Xos, Xu, Xu, Xu
Xu, Xu, Xu, Xos, Xos, Xos, Xos, Cud, Cud, Cud, Uue^Ii, Cud, Cud, Xos^Efs, Xos, Xos, Xos, Xos, Xos, Cud, Wo, Cud, Xos, Xos, Xos, Xos, Xoi, Cud, Cud, Cud^Es, Cud, Uue^Ii, Cud^Es, Cud^Es, Cud^Es, Cud, Xoi, Xos, Xos, Xos, Xu, Xu
Xu, Xu, Xu, Xu, Xu, Xos, Xos, Xos, Xos, Cud, Cud, Cud, Xos, Xos, Xos, Xos, Xu, Xos, Xu, Xos, Wo^Es, Xos, Xos, Xos, Xu, Xos, Xos, Xoi, Xoi, Cud, Cud, Cud, Cud^Es, Cud, Xoi, Xoi, Xos, Xos, Xu, Xu, Xu, Xu
Xu, Xu, Xu, Xu, Xu, Xu, Xu, Xos, Xos, Xos, Xos, Xos, Xos, Xos, Xu, Xu, Xu, Xu, Wo, Wo^Es, Wo^Es, Xu, Xu, Xu, Xu, Xu, Xu, Xos, Xos, Xoi, Xoi, Cud, Xoi, Xoi, Xos, Xos, Xu, Xu, Xu, Xu, Xu, Xu
Xu, Xu, Xu, Xu, Xu, Xu, Xu, Xu, Xu, Xos, Xos, Xos, Xu, Xu, Xu, Xu, Xu, Wo^Es, Wo, Wo^Es, Xu, Xu, Xu, Xu, Xu, Xu, Xu, Xu, Xu, Xos, Xos, Xoi, Xos, Xos, Xu, Xu, Xu, Xu, Xu, Xu, Xu, Xu
