Gs^Fds, Gs^Fms, Gs^Fds, Gs^Fms, Gs^Fms, Gs^Fds, Gs^Fds, Gg^Fet, Gs^Fms, Gs^Fds, Gg, Rp, Rp, Wwt, Wwt, Gg, Gs^Fds, Gs^Fms, Gs^Fms, Gs^Fms, Gs^Fds, Gs^Fds, Gs^Fms, Gs^Fms, Gs^Fms, Gs^Fds, Gs^Fds, Gs^Fds, Gs^Fms, Gs^Fds, Gs^Fms, Gs^Fms
Gs^Fds, Gs^Fms, Gs^Fds, Gs^Fms, Gs^Fms, Gs^Fds, Gs^Fds, Gs^Fms, Gs^Fds, Gs^Fds, Gg^Es, Rp, Rp, Wwt, Wwt, Gg, Gg, Gs^Fds, Gs^Fms, Gs^Fms, Gs^Fds, Gs^Fms, Gs^Fds, Gs^Fms, Gs^Fms, Gs^Fms, Gs^Fds, Gs^Fds, Gs^Fds, Gs^Fms, Gs^Fds, Gs^Fms
Gs^Fds, Gg^Fet, Gs^Fms, Gs^Fms, Gs^Fds, Gs^Fms, Gs^Fds, Gs^Fms, Gg, Gs^Fds, Gg^Efm, Rp, Rp, Wwt^Bsb\, Wwt^Bsb\, Rp, Rp, Gg, Gs^Fds, Gs^Fds, Gg^Fet, Gs^Fds, Gs^Fms, Gs^Fms, Gs^Fds, Gs^Fms, Gg, Gs^Fms, Gg^Fet, Gs^Fds, Gs^Fms, Gs^Fms
Gs^Fms, Gs^Fds, Gs^Fds, Gs^Fds, Gg, Gg^Fet, Gg^Efm, Gg, Rp, Gg^Efm, Rp, Rp, Rp, Wwt, Wwt, Rp, Rp, Rp, Rp, Gs^Fds, Gs^Fds, Gs^Fds, Gg^Efm, Gg, Rp, Rp, Rp, Gg, Gg^Efm, Gg^Efm, Gs^Fds, Gs^Fds
Gs^Fms, Gs^Fds, Gg, Gs^Fds, Gg, Gg, Rp, Rp, Rp, Rp, Rp, Rp, Wwrt, Wwt, Wwrt, Gg, Gg^Efm, Rp, Rp, Rp, Rp, Gg, Rp, Rp, Rp, Rp, Rp, Rp, Rp, Gg, Gg, Gg
Gs^Fds, Gg^Efm, Gg^Efm, Gg^Efm, Gg^Efm, Gg^Efm, Rp, Rp, Wwt^Ewl, Wwf^Ewl, Wwt, Wwrt, Wot, Wwt, Wwt, Wwf, Wwrt, Gg, Gg, 2 Rp, Rp, Rp, Rp, 3 Rp, Gg^Es, Gg, Gg, Rp, Rp, Rp, Rp, Gg^Efm
Gg^Efm, Gg, Gg, Gg, Rp, Rp, Rp, Wwf^Ewl, Wwt^Ewf, Wwt, Wwrt, Wot, Wot, Wot, Wot, Wwt, Wwt^Ewf, Gg^Efm, Gg, Gg, Gg, Rp, Gg^Efm, Gg, Gg, Gg, Gg^Efm, Gg, Gg, Rp, Rp, Rp
Gg, Gg^Es, Gg, Gg^Efm, Rp, Rp, Wwf, Wwf^Ewf, Wwt, Wwt, Wot, Wot, Wot, Wot, Wot, Wwt^Ewl, Wwf^Ewl, Gg^Efm, Gg^Efm, Gg^Efm, Gg, Gg^Efm, Gg, Gg, Gs^Fms, Gs^Fds, Gg, Gg, Gs^Fms, Gg, Gg, Rp
Gg^Efm, Gg^Efm, Gg, Gg^Efm, Rp, Rp, Wwrt, Wwt, Wwrt, Wot, Wot, Wot, Wot, Wot, Wwt, Wwt^Ewf, Wwf, Gg, Gg, Gg, Gg^Efm, Gg, Gg, Gg^Fet, Gs^Fds, Gg, Gg, Gg, Gs^Fds, Gs^Fms, Gs^Fds, Gg
Gg, Gg, Rp, Rp, Rp, Rp, Gg, Wwt, Wwt, Wot, Wwt, Wot, Wwt, Wwt, Wwrt, Wwt, Gg, Gg, Gg, Gg, 1 Gg, Gg^Efm, Gg, Gg, Gg, Gg^Efm, Gs^Fds, Gg^Efm, Gg, Gs^Fms, Gg^Fet, Gs^Fds
Rp, Rp, Rp, Rp, Gg, Gg, Gg, Wwrt^Ewl, Wwrt, Wwt, Wwt, Wwt, Wwf, Wwrt, Wwf^Ewf, Wwf^Ewl, Gg^Efm, Gg, Gg^Efm, Gg, Gg, Gg^Efm, Gg, Gs^Fds, Gs^Fds, Gg, Gs^Fms, Gg, Gg, Gg^Efm, Gs^Fds, Gg
Rp, Rp, Hh, Hh, Hh^Fds, Hh, Hh, Wwf^Ewl, Wwt, Wwt, Gg, Gg, Gg, Gg, Gg^Efm, Gg, Gg, Gg, Gg, Gg^Efm, Gg, Gg, Gg, Gs^Fms, Gg^Fet, Gs^Fds, Gs^Fms, Gs^Fds, Gs^Fds, Gg, Gg, Gg
Hh, Hh, Hh^Fds, Hh, Hh^Fp, Hh, Hh, Wwrt, Wwt, Wwrt, Gg^Efm, Gg^Efm, Gg^Efm, Gg, Gg^Es, Gg, Gg, Gg^Efm, Gg, Gg, Gg, Gs^Fds, Gs^Fms, Gs^Fds, Gg, Gs^Fms, Gs^Fms, Gs^Fms, Gg, Gg, Gs^Fds, Gg^Efm
Hh^Fms, Hh^Fms, Hh^Fp, Hh, Hh^Fp, Hh^Fms, Hh, Wwt, Wwt, Gg, Gg, Gg, Gg^Efm, Gg^Efm, Gg^Efm, Gg, Gg, Gg, Gg, Gs^Fds, Gs^Fms, Gg, Gg^Es, Gg^Efm, Gs^Fms, Gs^Fds, Gg^Fet, Gg, Gg^Efm, Gg^Efm, Gs^Fds, Gs^Fms
Hh^Fms, Hh, Hh, Hh^Fp, Hh^Fp, Hh^Fms, Hh, Wwt, Wwt, Gg, Hh, Hh, Hh^Fp, Gg, Gg, Gg, Hh, Gs^Fds, Gs^Fds, Gs^Fms, Gs^Fds, Gg, Gg, Gg, Gg, Gg, Gg, Gs^Fds, Gg, Gs^Fds, Gs^Fms, Gs^Fms
