border_size=1
usage=map

Gs^Fp, Gs^Fp, Gg, Hh, Gs^Fp, Gg, Gg, Gg, Hh, Hh, Hh, Gg, Mm, Gg, Hh, Hh, Gs, Gs, Gll^Fp, Gg, Gll^Fp, Gg, Gll^Fp, Gll^Fp, Gll^Fdw, Gg, Re, Re, Gll^Fdw, Gll^Fdw, Gll^Fdw, Gll, Hhd, Hhd, Hhd, Re, Gll^Fp, Gll^Fp, Gll^Fp, Gg, Gg, Gg
Gg, Gs^Fp, Hh, Hh, Gs^Fp, Gg, Gg, Hh, Hh, Hh, Hh, Hh, Hh, Mm, Hh, Hh, Gs, Gll^Fp, Gll^Fp, Gll^Fp, Gs, Gll^Fp, Gll^Fmw, Gll^Fmw, Gll^Fdw, Gll^Fdw, Re, Re, Gll^Fdw, Gll^Fdw, Re, Gll^Fdw, Re^Es, Hhd, Re, Re, Gll^Fdw, Gll^Fp, Gll^Fdw, Gg, Hh, Mm
Gg, Hh, Gg, Gs^Fms, Gs^Fp, Hh, Gs^Fp, Gg, Hh, Gg, Gg, Hh, Mm, Mm, Mm, Hh, Hh, Gs, Gs, Gll^Fp, Gs, Hhd, Hhd, Gll^Fmw, Gll^Fdw, Re, Re^Es, Gll^Fdw, Rb^Fdw, Re, Yhs, Re, Rb^Fdw, Re, Rb^Es, Gll^Fp, Yhs, Gll^Fmw, Gll^Fdw, Gll^Fp, Hh, Mm
Gg, Hh, Gg, Gg, Hh, Hh, Gs^Fms, Gg, Hh, Gg, Hh, Mm, Mm, Mv, Mm, Mm, Hh, Gs, Gs, Gll^Fp, Gs^Es, Hhd, Hhd, Gll^Fdw, Rb^Fdw, Rb^Fdw, Yhs, Rb^Fdw, Rb^Fdw, Rb^Fdw, Rb^Fdw, Yhs^Xp, Rb^Fdw, Rb^Fdw, Rb, Re, Gll, Gll^Fmw, Gll^Fdw, Gll^Fp, Hh, Mm
Gg, Gg, Gs^Fp, Gs^Fp, Hh, Hh, Gg, Gs^Fms, Gs^Fp, Gg, Hh, Mm, Mm, Mm, Mm, Mm, Hh, Gs, Gd, Gs, Gs, Gs, Re, Rb, Rb^Fdw, Yhs^Xp, Ss^Vm, Rb^Fdw, Rb^Fdw, Rb, Yhs, Rb^Fdw, Sm, Rb, Rb^Fdw, Rb^Es, Gll, Gll^Fmw, Gll^Fp, Gs, Hh, Hh
Gg, Gs^Fms, Gg, Hh, Gg, Hh, Gg, Gs^Fp, Gg, Gg^Es, Gg, Mm, Mm, Mm, Gs, Gs, Gs, Gs, Gd, Gd^Es, Gll, Re, Re, Rb^Es, Sm, Sm, Sm, Ss, Ss^Bw|r, Yhs, Chs, Chs, Yhs, Yhs^Xp, Rb^Fdw, Rb^Fdw, Rb, Gll^Fdw, Gll^Fdw, Gs, Gll^Fp, Gg
Gg, Gs^Fp, Gg, Gg, Hh, Hh, Gg, Hh, Wwg, Gs^Fp, Gs^Fp, Hh, Mm, Mm, Gs, Gs, Re, Re, Gd, Gd, Gll^Fdw, Gll^Fdw, Ss, Rb^Fdw, Yhs, Yhs^Xp, Yhs, Ss, Ss^Bw|r, Ss, 3 Khs, Chs, Ss, Yhs, Yhs, Rb^Fdw, Rb^Fdw, Gll^Fdw, Gs^Fdw, Gs^Fdw, Gll^Fp, Gll^Fp
Gg, Gg, Gg, Gg, Gs^Fp, Gs^Fms, Wwg, Wwg, Gg, Wwg, Wwg, Gg, Wwg, Hh, Wwg, Ss, Ss, Gs, Gd^Fdw, Gd^Fdw, Ss, Ss, Gll^Fdw, Ss, Ss, Ss, Ss, Ss, Ss, Chs, Chs, Yhs, Yhs, Ss, Ss^Vhs, Yhs^Xp, Rb^Fdw, Gll^Fdw, Gs, Gs^Es, Gll^Fp, Gg
Gg, Gg, Gs^Fp, Gg, Wwg, Wwg, Gg, Gg, Gg, Gg, Gs^Fms, Wwg, Wwg, Wwg, Re, Ss, Hhd^Fdw, Ss, Ss^Bw|r, Ss, Gs, Gll, Rb^Fdw, Rb^Fdw, Yhs, Ss^Vhs, Yhs^Xp, Yhs, Ss^Bw|r, Ss, Ss, Ss, Ss, Yhs^Xp, Yhs, Ss, Ss, Sm, Ss^Bw/r, Gs, Ss, Mm
Gg, Gg, Gg, Wwg, Gg, Gg, Gs^Fp, Gg, Gg, Hh, Gs^Vhr, Gs^Fp, Gg, Gg^Vhr, Re, Re, Hhd^Fdw, Hhd, Gs, Re, Gd, Gs^Vhr, Rb, Rb^Xp, Rb^Fdw, Yhs, Rb, Yhs, Rb, Ss, Sm, Yhs^Xp, Sm, Sm, Rb^Fdw, Rb^Fdw, Sm, Ss, Ss, Ss, Ss, Ss
Gg, Gg, Wwg, Wwg, Gg, Gs^Fp, Gs^Fms, Gg, Gs^Fms, Gs^Fms, Gg, Gg, Gg^Em, Gs^Fp, Gs^Fp, Gg, Hhd, Hhd^Fdw, Gs, Gs, Gd^Es, Gd, Gll, Rb, Re, Re, Rb^Fdw, Yhs, Rb, Sm, Sm, Yhs, Yhs, Sm, Rb^Fdw, Rb^Fdw, Hhd, Hhd^Fmw, Ss, Ss, Mm, Ss
Wwg, Wwg, Gs^Fms, Gs^Fp, Gg, Gs^Fp, Gs^Fms, Gg, Gs^Fms, Chr, 2 Khr, Chr, Gg, Gg, Gg, Gg, Gg, Gg, Hhd, Gs, Hhd^Fdw, Gs, Hhd, Gll, Re, Re, Gll^Fdw, Rb^Fdw, Rb, Rb^Fdw, Re^Es, Rb, Rb^Xp, Rb, Sm, Sm, Ss, Ss, Ss, Mm, Hh, Mm
Gg, Gs^Fp, Gg, Gg, Gg, Gs^Fp, Gg^Vhr, Gg^Em, Gs^Fms, Chr, Chr, Chr, Gg, Gg, Re, Re, Gg, Gg, Gg, Hhd, Hhd^Fdw, Hhd, Hhd^Fdw, Hhd, Re, Re, Re, Rb, Re, Re, Re, Rb, Rb, Rb^Es, Sm, Sm, Ss, Ss, Ss, Mm, Hh, Hh
Gg, Gs^Fp, Gg, Gg, Ds, Ds, Gg, Gs^Fp, Gs^Fp, Gs^Fp, Gg, Gg, Gg, Re, Re, Re, Gs^Fp, Gg^Em, Gg, Hhd, Gg, Hhd, Hhd, Gll, Re, Re^Es, Re, Hhd, Hhd, Hhd, Hhd^Fmw, Hhd, Re, Re, Gll, Gll, Gd, Ss^Bw|r, Hh^Fmw, Mm, Gs, Gs
Ds, Gg, Gg, Gg, Ds^Es, Ds, Gg, Gg, Gg, Gs^Fp, Gg, Gg, Ds, Re, Re, Gg, Gs^Fp, Gs^Fp, Gs^Fp, Hhd, Gg, Gg, Gll, Gll, Re, Re^Vht, Gd, Gll, Gd, Hhd, Hhd^Fmw, Hhd, Hhd, Re, Re^Es, Gd^Vht, Gs, Gs, Hh, Hh, Gs, Gs
Ds, Gg, Ds^Es, Ds, Ds, Gg, Ds, Gg, Ds, Gg, Ds, Ds, Ds, Ds, Gg, Gs^Fp, Gs^Fp, Gs^Fp, Gs^Fp, Gs^Fp, Gs^Fp, Gg, Gs, Re, Gd, Gd, Hh, Gs, Gs^Fmw, Gs, Gs, Gd, Gd, Re, Re, Re, Re, Gs, Gs, Gs^Fp, Gs, Gs
Ww, Ds^Es, Ds, Ds, Ds, Ds, Ds, Ds, Ds, Ds, Ds^Es, Ds, Ds, Gg, Gg, Gs^Fp, Gg, Gs^Fp, Gll^Fms, Gs^Fds, Gs^Fp, Gg, Gs, Gs, Gs, Hh, Gs, Gs, Gs^Fmw, Gs^Fmw, Gd^Em, Gd, Gs^Fmw, Ss, Ss, Gs^Fp, Gs^Fp, Re, Gs^Fp, Gs^Fp, Gs, Gs
Ww, Ds, Wwf^Es, Ds, Ds^Es, Ds, Ww, Ds, Ww, Ds, Ww, Ds, Ds, Gg, Ds, Gg^Vhr, Ds, Gg^Em, Gg, Gs^Fms, Gs, Gs^Fp, Gs, Gs, Hh, Gs, Ss, Gs, Gll^Fp, Gll^Fmw, Gs, Gs, Gll, Ss, Gll^Fmw, Gll^Fp, Gs^Fmw, Re, Re, Gs, Gs^Fmw, Gs^Fmw
Ww, Ww, Ww, Wwf, Ww, Ww, Ww, Ww, Ww^Vm, Wwf, Wwf, Wwf, Ww, Ds, Ds, Ds, Ds, Gg, Gs^Fp, Gs^Fms, Gg, Gg, Gs, Gs^Fp, Hh, Gs^Fmw, Gs^Fp, Ss, Gs^Fp, Gll^Fmw, Gs, Gs, Gs^Fmw, Gll^Fmw, Gs^Fmw, Gs^Fp, Gs^Fmw, Re, Gs^Fmw, Gs^Fp, Gs, Gs^Fp
Ds, Ww, Ww, Ww, Ww, Ww, Wo, Ww, Ww, Ww, Ww, Ww, Ww, Wwf, Ds^Es, Ds^Es, Ds, Gg, Gg, Gs^Fp, Gg, Gg^Es, Gg, Hh, Hh, Hh, Gs^Fms, Gs^Fmw, Gs^Fds, Gll^Fp, Gg, Gg^Vhr, Gs^Fp, Gs^Fp, Ss, Gs^Fp, Gs, Re, Gs^Fp, Gs^Fp, Gs^Em, Gs^Fp
Ds, Ds, Ww, Wwr, Wwr, Ww, Ww, Ww, Ww, Ds, Ww, Wo, Wo, Ww, Ds, Ds, Gg, Gg, Gg, Gg, Ds, Gg, Hh, Hh, Hh, Gs^Fp, Gs^Fms, Gs^Fds, Ss, Gs^Fp, Gs^Fp, Gg, Gs, Gs, Ss, Ss, Gs, Re, Re, Gs^Fp, Gs^Fp, Gs
Ww, Ww, Wwf, Ww, Ww, Wwr, Wwr, Ww, Ww, Ww, Ww, Wo, Ww, Ww, Ww, Ds, Gg, Gg, Gg, Ds, Gg, Gg, Gg, Hh, Gg, Gs^Em, Gs^Em, Gll^Fp, Ss, Ss, Gg, Gg^Em, Gs^Fp, Gs, Gg, Gg, Gg, Gs^Fp, Re, Gs^Fp, Gs^Fmw, Gs
Ww, Ww, Wwf, Ww, Ww, Ww, Wwr, Ww, Ww, Wwf, Ww, Wo, Ww, Wwf, Ww, Ds, Ds, Gg, Ds, Ds^Es, Gg, Gg, Gg, Hh, Gg, Gll^Fp, Gg, Gll^Fp, Gs, Gs^Fp, Gg, Gs^Es, Gg, Gg, Gg, Gg, Gg, Gs, Gs^Vht, Re, Gs^Fmw, Gs^Fp
Ww, Ww, Ww, Ww, Ww, Wwr, Wwr, Wwr, Wwr, Ww, Ww, Ww, Ww, Ww, Wwf, Ds^Es, Gg, Gg, Ds^Es, Ds, Gg, Ds, Gg, Gg, Gg, Gg, Gg, Gg, Gg, Gg, Gs^Fp, Gg, Ss, Gg, Ss, Gg, Gg, Gs^Fp, Re, Re, Gs, Gs^Fp
Ww, Ww, Wo, Ww, Wo, Ww, Ww, Wwr, Ww, Ww, Wo, Ww, Ww, Ww, Ww, Ww, Ds, Ds, Ds, Ds, Ds, Ds, Ds, Gg, Gg, Gg, Ds, Gg^Vhr, Gg, Gs^Em, Gg, Gg, Gs^Fp, Ss, Ss^Vhs, Ss, Gs^Fp, Gs^Fp, Re, Re, Gs^Fp, Gs^Fp
Ww, Wo, Wo, Ww, Wo, Wo, Ww, Ww, Wo, Wo, Ww, Wwr, Ww, Ww^Vm, Ww, Wwf, Ds, Wwf, Ww, Ww, Ww, Ds, Ds, Gg, Gg^Es, Gg, Ds, Gg, Ds, Gg, Gg, Gs^Fms, Gg, Gg, Gg, Ss, Ce, Gs, Re, Gs, Gs^Fmw, Gs^Fp
Ww, Wo, Wo, Ww, Ww, Ww, Ww, Ww, Wo, Wo, Ww, Wwr, Wwr, Ww, Ww, Ds^Es, Ww, Ww, Ds, Wwf, Ww, Ds^Es, Wwf, Ds, Ds, Gg, Ww, Ds, Ww, Ds^Es, Ds, Gg, Gg, Gg, Gg, Ce, Ket, Ce, Re, Gs, Gs^Fp, Gs^Fp
Wo, Ww, Wo, Ww, Ww, Wwf, Ww, Ww, Ww, Wo, Ww, Ww, Ww, Wwr, Ww, Ww, Wo, Ww, Ww, Ww, Ww, Wwf, Ww^Vm, Wwf, Ww, Ww, Ds, Ww, Ww, Wwf, Wwf^Es, Gg, Gs, Gg, Gs^Fp, Ce, Ce, Re, Gs^Es, Gs^Fds, Gll^Fms, Gs^Ft
Wo, Wo, Wo, Wo, Wo, Ww, Ww, Wo, Wo, Wo, Wo, Ww, Ww, Ww, Ww, Wo, Wo, Ww, Ww, Wo, Ww, Ww, Ww, Ww, Ww, Wwf, Ww, Ww, Ww, Ww, Ww, Ds, Ds, Gs, Gs^Fp, Gs^Fp, Gs, Re, Gs, Gll^Fms, Gs^Ft, Gs^Fms
Wo, Wo, Ww, Ww, Ww, Ww, Wo, Wo, Wo, Wo, Wo, Ww, Ww, Wo, Ww, Wo, Wwr, Ww, Wwr, Ww, Wwr, Ww, Ww, Wo, Wo, Ww, Ww, Wwr, Ww, Ds, Ds, Ds, Ds, Gs, Gs^Fp, Gs^Em, Gs^Fp, Re, Re, Gs^Fms, Gs^Fms, Gs^Fms
Wo, Wo, Wo, Wo, Ww, Wo, Wo, Wo, Wo, Wo, Wo, Ww, Ww, Wwf, Wwf, Ww, Ww, Wwr, Wo, Ww, Ww, Wwr, Wwr, Wwr, Ww, Ww, Ww, Ww, Ds, Ww, Wwf, Ds, Gs^Fp, Gs^Fp, Gg, Gs^Fp, Gs^Fp, Gs^Fds, Re, Gs^Fds, Gs^Fds, Gs^Ft
Wo, Wo, Wo, Ww, Wo, Wo, Wo, Wo, Wo, Wo, Wo, Wo, Wo, Ww, Ww, Ww, Wo, Ww, Wo, Wo, Wo, Ww, Ww, Ww, Wo, Ww, Wwf, Ds, Ds, Wwf, Wwf, Ds, Ds, Gs^Fp, Gg, Gs^Fp, Gg, Re, Re, Gs^Fp, Gll^Fds, Gll^Fds
Wo, Wo, Wo, Ww, Wo, Wo, Wo, Wo, Wo, Wo, Wo, Wo, Wo, Wo, Wo, Ww, Wo, Wo, Wo, Wo, Wo, Ww, Wo, Ww, Ww, Ww, Ww, Ww, Ww, Ww, Ww, Ww, Ww, Ds, Gg, Gg, Re, Re, Gs^Fms, Gs^Fms, Gll^Fds, Gll^Fms
Wo, Wo, Wo, Wo, Ww, Wo, Wo, Wo, Wo, Wo, Wo, Wo, Wo, Wo, Wo, Wo, Wo, Wo, Wo, Wo, Wo, Wo, Ww, Ww, Ww, Ww, Wwr, Ww, Ww, Ww, Ww, Ww, Wwf, Ds, Ds, Gg^Vhr, Re, Re, Gg^Em, Gs^Fms, Gll^Fms, Gll^Fms
Wo, Wo, Wo, Wo, Wo, Wo, Wo, Wo, Wo, Wo, Wo, Wo, Wo, Wo, Wo, Wo, Wo, Wo, Wo, Wo, Wo, Wo, Wwf, Ww, Ww, Ww, Wwr, Ww, Ww, Ww, Wwf, Ww, Ds, Ds^Es, Ds, Gg, Re, Gg, Gs^Fds, Gll^Fds, Gll^Fds, Gll^Fds
Wo, Wo, Wo, Wo, Wo, Wo, Wo, Wo, Wo, Wo, Wo, Wo, Wo, Wo, Wo, Wo, Wo, Wo, Wo, Wo, Wo, Wo, Wo, Ww, Ww, Wwr, Ww, Ww, Ww, Wwf, Ww, Ww, Ds^Es, Ds, Gg, Gg, Gg, Gg, Gs^Fds, Gs^Fds, Gll^Fds, Gll^Fds
Wo, Wo, Wo, Wo, Wo, Wo, Wo, Wo, Wo, Wo, Wo, Wo, Wo, Wo, Wo, Wo, Wo, Wo, Wo, Wo, Ww, Ww, Ww, Ww, Wwr, Ww, Ww, Ww, Ww, Ww, Wwf, Ds^Es, Ds, Ds, Ds^Es, Gg^Es, Gg, Gg, Gs^Fms, Gs^Fms, Gs^Fds, Gll^Fds
Wo, Wo, Wo, Wo, Wo, Wo, Wo, Wo, Wo, Wo, Wo, Wo, Wo, Wo, Wo, Wo, Wo, Wo, Wo, Wo, Ww, Ww, Wwr, Wwr, Wwr, Wwr, Ww, Ww, Ww, Ww, Ds, Ds, Wwf, Ds, Ds, Gg, Gg, Re, Gg^Em, Gg, Gll^Fms, Gg
Wo, Wo, Wo, Wo, Wo, Wo, Wo, Wo, Wo, Wo, Wo, Wo, Wo, Wo, Wo, Wo, Wo, Wo, Ww, Ww, Wwr, Ww, Ww, Ww, Wwr, Wwr, Ww, Ww, Ww, Ww, Ww, Ww, Wwf, Ww, Ds, Gg, Gg, Re, Re, Gg, Gg^Es, Gg
Wo, Wo, Wo, Wo, Wo, Wo, Wo, Wo, Wo, Wo, Wo, Wo, Wo, Wo, Wo, Wo, Ww, Ww, Ww, Ww, Ww, Ww, Wwf, Ww, Ww, Wwr, Ww, Ww, Ww, Ww, Ww, Wwf, Ds, Ds^Es, Ds, Gg, Gs^Fds, Gg, Re, Gg^Vhr, Gs^Fds, Gs^Fms
Wo, Wo, Wo, Wo, Wo, Wo, Wo, Wo, Wo, Wo, Wo, Wo, Wo, Wo, Wo, Wo, Wo, Wwf, Wo, Wo, Wo, Ww, Wo, Ww, Ww, Ww, Ww, Ww, Ww, Ww, Ww, Ww, Ds, Ds, Gg, Gg, Gg, Gg, Gg, Gg, Gg, Gg
Wo, Wo, Wo, Wo, Wo, Wo, Wo, Wo, Ww, Wo, Wo, Wo, Wo, Wo, Wo, Wo, Wo, Wo, Wo, Wo, Wo, Wo, Wo, Ww, Wwr, Ww, Ww, Ww, Ww, Ww, Ww, Ds^Es, Ds, Gg, Gs^Fp, Gs^Fds, Gg, Gg, Re, Gg, Gg, Gg
Wo, Wo, Wo, Wo, Wo, Wo, Wo, Wo, Ww, Wo, Wo, Wo, Wo, Wo, Wo, Wo, Wo, Wo, Wo, Wo, Wo, Wo, Ww, Ww, Ww, Ww, Ww, Ww, Ww, Ww, Ww, Ds, Ds, Gs^Fp, Gll^Fp, Gs^Fp, Gs^Fms, Gg, Re, Gll^Fds, Gg, Gg
Wo, Wo, Wo, Wo, Wo, Ww, Ww, Ww, Ww, Ww, Ww, Wo, Wo, Wo, Wo, Wo, Wo, Wo, Wo, Wo, Ww, Wwf, Ww, Ww, Wwr, Ww, Ww, Ww, Ww, Wwf, Ds^Es, Ds, Gs^Fp, Gs^Fp, Gs^Fp, Gll^Fds, Gs^Fds, Gg, Gg, Re, Gs^Fds, Gg^Es
Wo, Wo, Wo, Wo, Wo, Wo, Ww, Wwf, Gs, Gs^Fp, Ww, Ww, Wo, Wo, Wo, Wo, Wo, Wo, Wo, Ww, Ww, Wwf, Ww, Ww, Wwr, Ww, Ww, Ww, Ds^Es, Ds, Ds, Gs^Fp, Gs^Fp, Gs, Gs^Fp, Gll^Fms, Gs^Fms, Gs^Fp, Gg^Em, Re, Gs^Fms, Gll^Fds
Wo, Wo, Wo, Wo, Wo, Wo, Ww, Gs, Gs^Fp, Khr, Ww, Ww, Wo, Wo, Wo, Wo, Wo, Wo, Ww, Ww, Wo, Wo, Ww, Ww, Wwr, Wwr, Ww, Ww, Ww, Wwf^Es, Ds, Ds, Gs, Gs^Fms, Gs^Fp, Gs^Fms, Gs^Fp, Gs^Fp, Gg^Em, Re, Re, Gs^Fds
Wo, Wo, Wo, Wo, Wo, Ww, Ww, Gs, Ww, Chw, Wo, Wo, Wo, Wo, Wo, Wo, Ww, Ww, Wwr, Wo, Wwf, Wo, Wo, Ww, Ww, Ww, Ww, Ww, Wwf, Ds^Es, Ds, Gg, Gs^Fp, Gg, Gg, Gg^Em, Gg, Gg, Gg, Gg, Re, Gs^Fds
Wo, Wo, Wo, Wo, Wo, Ww, Ww, Ww, Ww, Ww, Wo, Wo, Wo, Wo, Wo, Wo, Wwr, Wwr, Wwr, Wo, Ww, Ww, Ww, Ww, Ww, Wwf, Ww, Wwf, Wwf, Ds, Gg, Gg, Gg, Gg, Gg, Gg, Gg, Gg, Gg, Gg, Re, Gs^Fms
Wo, Wo, Wo, Ww, Wo, Wo, Wo, Wo, Wo, Ww, Wo, Wo, Wo, Wo, Wo, Ww, Wwr, Wwr, Wo, Ww, Ww, Wwr, Ww, Ww, Ww, Ww, Ww, Ds, Ds, Ds, Ds, Gg^Es, Gg, Gg, Gg, Gg, 1 Gg, Gg, Gg, Gg, Gg^Es, Re
Wo, Wo, Wo, Wo, Wo, Wo, Wo, Wo, Wo, Wo, Wo, Wo, Wo, Wo, Wo, Ww, Wwr, Wwr, Wo, Wo, Wo, Ww, Wwr, Ww, Ww, Ww, Ww, Ds, Ww, Ds, Wwf, Ds, Ds, Ds, Gg, Gg, Gg, Gg, Gg, Ds, Gg, Gg
Wo, Wo, Wo, Wo, Wo, Wo, Wo, Wo, Wo, Wo, Wo, Wo, Wo, Wo, Wo, Wo, Wwr, Wo, Wo, Wo, Wo, Ww, Ww, Wwr, Ww, Ww, Ww, Ww, Ww, Wwf, Wwf, Wwf, Ds^Es, Ds, Ds, Gg, Gg, Gg, Ds, Ds, Gg, Gg
Wo, Wo, Wo, Wo, Wo, Wo, Wo, Wo, Wo, Wo, Wo, Wo, Wo, Wo, Wo, Wo, Wo, Wo, Wo, Wo, Wwr, Ww, Ww, Ww, Ww, Ww, Wo, Ww, Ww, Wwf, Ww, Ds, Ds, Ds, Ds, Ds, Ds, Ds, Ds, Ds^Es, Ds, Gg
Wo, Wo, Wo, Wo, Wo, Wo, Wo, Wo, Wo, Wo, Wo, Wo, Wo, Wo, Wo, Wo, Wo, Wo, Wo, Ww, Wwr, Wwr, Wwr, Ww, Wwf, Ww, Wo, Ww, Ww, Ww, Ww, Wwf, Ds, Wwf, Ww, Ww, Ww, Ww, Ww, Ds, Ww, Ds
Wo, Wo, Wo, Wo, Wo, Wo, Wo, Wo, Wo, Wo, Wo, Wo, Wo, Wo, Wo, Wo, Wo, Wo, Wo, Wo, Wo, Wwr, Wo, Wo, Wo, Wo, Wo, Ww, Ww, Ww, Ww, Wwf, Ds, Ds, Ww, Ww, Ww, Wwf, Ww, Ww, Wwf, Ww
Wo, Wo, Wo, Wo, Wo, Wo, Wo, Wo, Wo, Wo, Wo, Wo, Wo, Wo, Wo, Wo, Wo, Wo, Wo, Wo, Wo, Wo, Wo, Wo, Wo, Wo, Wo, Ww, Ww, Ww, Ww, Ww, Ds, Ww, Ww, Ww, Ww, Ww, Ww, Ww, Ww, Wwf
Wo, Wo, Wo, Wo, Wo, Wo, Wo, Wo, Wo, Wo, Wo, Wo, Wo, Wo, Wo, Wo, Wo, Wo, Wo, Wo, Wo, Wo, Wo, Wo, Wo, Wwr, Wwr, Wwf, Ww, Ww, Ww, Ww, Ww, Ww, Ww, Ww, Ww, Ww, Ww, Ww, Ww, Ww
Wo, Wo, Wo, Wo, Wo, Wo, Wo, Wo, Wo, Wo, Wo, Wo, Wo, Wo, Wo, Wo, Wo, Wo, Wo, Wo, Wo, Wo, Wo, Wo, Wo, Wwr, Wwr, Ww, Ww, Ww, Wwr, Wwr, Wwr, Wo, Wo, Ww, Wo, Wwf, Ww, Ww, Ww, Ww
Wo, Wo, Wo, Wo, Wo, Wo, Wo, Wo, Wo, Wo, Wo, Wo, Wo, Wo, Wo, Wo, Wo, Wo, Wo, Wo, Wo, Wo, Wo, Wo, Wo, Wo, Ww, Wo, Wo, Wo, Wo, Wo, Wo, Wwr, Wo, Wo, Wo, Wo, Wo, Ww, Wwr, Ww
