Gs^Fp, Gs^Fp, Gg, Hh, Gs^Fp, Gg, Gg, Gg, Hh, Hh, Hh, Gg, Mm, Gg, Hh, Hh, Gs, Gs, Gll^Fp, Gg, Gll^Fp, Gg, Gll^Fp, Gll^Fp, Gll^Fdw, Gg, Re, Re, Gll^Fdw, Gll^Fdw, Gll^Fdw, Gll, Hhd, Hhd, Hhd, Re, Gll^Fp, Gll^Fp, Gll^Fp, Gg, Gg, Gg
Gg, Gs^Fp, Hh, Hh, Gs^Fp, Gs, Gg, Hh, Hh, Hh, Hh, Hh, Hh, Mm, Hh, Hh, Gs, Gll^Fp, Gll^Fp, Gll^Fp, Gs, Gll^Fp, Gll^Fmw, Gll^Fmw, Gll^Fdw, Gll^Fdw, Re, Re, Gll^Fdw, Gll^Fdw, Re, Gll^Fdw, Re^Es, Hhd, Re, Re, Gll^Fdw, Gll^Fp, Gll^Fdw, Gg, Hh, Mm
Gg, Hh, Gg, Gs^Fms, Gs^Fp, Hh, Gs^Fp, Gg, Hh, Gg, Gg, Hh, Mm, Mm, Mm, Hh, Hh, Gs, Gs, Gll^Fp, Gs, Hhd, Hhd, Gll^Fmw, Gll^Fdw, Re^Edb, Re^Es, Gll^Fdw, Rb^Fdw, Re, Yhs, Re, Rb^Fdw, Re, Rb^Es, Gll^Fp, Yhs, Gll^Fmw, Gll^Fdw, Gll^Fp, Hh, Mm
Gg, Hh, Gs, Gs, Hh, Hh, Gs^Fms, Gs, Hh, Gg, Hh, Mm, Mm, Mv, Mm, Mm, Hh, Gs, Gs, Gll^Fp, Gs^Es, Hhd, Hhd, Gll^Fdw, Rb^Fdw, Rb^Fdw, Yhs, Rb^Fdw, Rb^Fdw, Rb^Fdw, Rb^Fdw, Yhs^Xp, Rb^Fdw, Rb^Fdw, Rb^Edb, Re, Gll, Gll^Fmw, Gll^Fdw, Gll^Fp, Hh, Mm
Gg, Gg, Gs^Fp, Gs^Fp, Hh, Hh, Gs, Gs^Fms, Gs^Fp, Gg, Hh, Mm, Mm, Mm, Mm, Mm, Hh, Gs, Gd, Gs, Gs^Edb, Gs, Re^Edb, Rb, Rb^Fdw, Yhs^Xp, Ss^Vm, Rb^Fdw, Rb^Fdw, Rb^Em, Yhs, Rb^Fdw, Sm, Rb^Em, Rb^Fdw, Rb^Es, Gll^Edb, Gll^Fmw, Gll^Fp, Gs, Hh, Hh
Gg, Gs^Fms, Gs, Hh, Gg, Hh, Gg, Gs^Fp, Gs, Gg^Es, Gg, Mm, Mm, Mm, Gs, Gs, Gs, Gs, Gd, Gd^Es, Gll^Edb, Re^Edb, Re^Edb, Rb^Es, Sm, Sm, Sm, Ss, Ss^Bw|r, Yhs, Chs, Chs, Yhs, Yhs^Xp, Rb^Fdw, Rb^Fdw, Rb^Edb, Gll^Fdw, Gll^Fdw, Gs, Gll^Fp, Gg
Gg, Gs^Fp, Gd, Gg, Hh, Hh, Gg, Hh, Wwg, Gs^Fp, Gs^Fp, Hh, Mm, Mm, Gs, Gs, Re, Re^Edt, Gd, Gd^Edb, Gll^Fdw, Gll^Fdw, Ss, Rb^Fdw, Yhs, Yhs^Xp, Yhs, Ss, Ss^Bw|r, Ss, 3 Khs, Chs, Ss, Yhs, Yhs, Rb^Fdw, Rb^Fdw, Gll^Fdw, Gs^Fdw, Gs^Fdw, Gll^Fp, Gll^Fp
Gs, Gs, Gg, Gg, Gs^Fp, Gs^Fms, Wwg, Wwg, Gg, Wwg, Wwg, Gg, Wwg, Hh, Wwg, Ss, Ss, Gs, Gd^Fdw, Gd^Fdw, Ss, Ss, Gll^Fdw, Ss, Ss, Ss, Ss, Ss, Ss, Chs, Chs, Yhs, Yhs, Ss, Ss^Vhs, Yhs^Xp, Rb^Fdw, Gll^Fdw, Gs, Gs^Es, Gll^Fp, Gg
Gs, Gg, Gs^Fp, Gs, Wwg, Wwg, Gs, Gg, Gs, Gs, Gs^Fms, Wwg, Wwg, Wwg, Re, Ss, Hhd^Fdw, Ss, Ss^Bw|r, Ss, Gs^Edt, Gll, Rb^Fdw, Rb^Fdw, Yhs, Ss^Vhs, Yhs^Xp, Yhs, Ss^Bw|r, Ss, Ss, Ss, Ss, Yhs^Xp, Yhs, Ss, Ss, Sm, Ss^Bw/r, Gs, Ss, Mm
Gs, Gs, Gg, Wwg, Gg, Gs, Gs^Fp, Gg, Gg, Hh, Gs^Vhr, Gs^Fp, Gg, Gg^Vhr, Re, Re, Hhd^Fdw, Hhd, Gs, Re^Edt, Gd^Edt, Gs^Vhr, Rb, Rb^Xp, Rb^Fdw, Yhs, Rb^Em, Yhs, Rb^Edb, Ss, Sm, Yhs^Xp, Sm, Sm, Rb^Fdw, Rb^Fdw, Sm, Ss, Ss, Ss, Ss, Ss
Gg, Gg, Wwg, Wwg, Gg, Gs^Fp, Gs^Fms, Gg, Gs^Fms, Gs^Fms, Gg, Gs, Gg^Em, Gs^Fp, Gs^Fp, Gg, Hhd, Hhd^Fdw, Gs, Gs^Edt, Gd^Es, Gd, Gll, Co, Re^Em, Re, Rb^Fdw, Yhs^Edb, Rb^Edb, Sm, Sm, Yhs^Edb, Yhs^Edb, Sm, Rb^Fdw, Rb^Fdw, Hhd, Hhd^Fmw, Ss, Ss, Mm, Ss
Wwg, Wwg, Gs^Fms, Gs^Fp, Gs, Gs^Fp, Gs^Fms, Gs, Gs^Fms, Chr, 2 Khr, Chr, Gs, Gs, Gs, Gs, Gg, Gg, Hhd, Gs, Hhd^Fdw, Gs, Hhd, Gll, Re^Edb, Re^Edb, Gll^Fdw, Rb^Fetd, Rb, Rb^Fdw, Re^Es, Rb^Em, Rb^Xp, Rb^Em, Sm, Sm, Ss, Ss, Ss, Mm, Hh, Mm
Gg, Gs^Fp, Gs, Gg, Gs^Edt, Gs^Fp, Gg^Vhr, Gg^Em, Gs^Fms, Chr, Chr, Chr, Gd, Gg^Edt, Re, Re, Gg, Gs, Gg, Hhd, Hhd^Fdw, Hhd, Hhd^Fdw, Hhd, Re, Re^Edb, Re, Rb, Re, Re, Re, Rb, Rb, Rb^Es, Sm, Sm, Ss, Ss, Ss, Mm, Hh, Hh
Gs, Gs^Fp, Gs, Chr, Ds^Edt, Ds^Esd, Gg, Gs^Fp, Gs^Fp, Gs^Fp, Gg, Gg, Gg, Re^Edt, Re, Gd, Gs^Fp, Gs^Em, Gs, Chr, Gg, Hhd, Hhd, Gll, Re^Edt, Re^Es, Re, Co, Hhd, Hhd, Hhd^Fmw, Co, Re, Re, Gll, Gll, Gd, Ss^Bw|r, Hh^Fmw, Mm, Gs, Gs
Ds, Gs, Gg, Gs, Ds^Esd, Ds, Gs, Gg, Gg, Gs^Fp, Gs, Gs, Ds, Re, Re, Gg, Gs^Fp, Gs^Fp, Gs^Fp, Hhd, Gg, Gg, Gll, Gll, Re^Edt, Rd^Vht, Gd, Gll, Gd, Hhd, Hhd^Fmw, Hhd, Hhd, Re, Re^Es, Rd^Vht, Gs^Edb, Gs, Hh, Hh, Gs, Gs
Ds, Gs, Ds^Es, Ds, Ds^Esd, Gs^Esd, Ds^Edt, Gg, Ds^Esd, Gs, Ds^Esd, Ds^Edt, Ds, Ds^Esd, Gg, Gs^Fp, Gs^Fp, Gs^Fp, Gs^Fp, Gs^Fp, Gs^Fp, Gs^Edt, Gs, Re^Edt, Gd^Edt, Gd, Hh, Gs, Gs^Fmw, Gs, Gs, Gd, Gd, Re, Re, Re^Edb, Rp^Edb, Gs, Gs, Gs^Fp, Gs, Gs
Wwg, Ds^Es, Ds, Ds, Ds, Ds^Edt, Ds^Esd, Ds^Edt, Ds, Ds, Ds^Es, Ds, Ds^Esd, Gs^Esd, Gg, Gs^Fp, Gg, Gs^Fp, Gll^Fms, Gs^Fds, Gs^Fp, Gg, Gd, Gs, Gs, Hh, Gs, Gs, Gs^Fmw, Gs^Fmw, Gd^Em, Gd^Edt, Gs^Fmw, Ss, Ss, Gs^Fp, Gs^Fp, Rp, Gs^Fp, Gs^Fp, Gs, Gs
Wwg, Ds, Wwf^Es, Ds, Ds^Es, Ds, Wwrg, Ds, Wwg, Ds, Ww, Ds, Ds^Esd, Gs^Esd, Ds^Edt, Gs^Vhr, Ds, Gg^Em, Gs, Gs^Fms, Gs, Gs^Fp, Gs, Gs, Hh, Gs, Ss, Gs, Gll^Fp, Gll^Fmw, Gs, Gs^Edt, Gll^Edt, Ss, Gll^Fmw, Gll^Fp, Gs^Fmw, Re, Re, Gs, Gs^Fmw, Gs^Fmw
Wwg, Wwg, Wwg, Wwf, Wwg, Wwg, Wwg, Wwg, Wwg^Vm, Wwf, Wwf, Wwf^Es, Wwrg, Ds, Ds, Ds, Ds^Esd, Gg, Gs^Fp, Gs^Fms, Gs, Gd, Gs, Gs^Fp, Hh, Gs^Fmw, Gs^Fp, Ss, Gs^Fp, Gll^Fmw, Gs, Gs^Edt, Gs^Fmw, Gll^Fmw, Gs^Fmw, Gs^Fp, Gs^Fmw, Rp, Gs^Fmw, Gs^Fp, Gd^Fetd, Gs^Fp
Ds, Wwrg, Wwg, Wwg, Wwg, Wwg, Wog, Wwg, Wwg, Wwg, Wwg, Wwg, Wwg, Wwf, Ds^Es, Ds^Es, Ds, Gs, Gg, Gs^Fp, Gs^Edt, Gs^Es, Gg, Hh, Hh, Hh, Gs^Fms, Gs^Fmw, Gs^Fds, Gll^Fp, Gg, Gg^Vhr, Gs^Fp, Gs^Fp, Ss, Gs^Fp, Gs, Re, Gs^Fp, Gs^Fp, Gs^Em, Gs^Fp
Ds, Ds, Wwg, Wwrg, Wwrg, Wwg, Wwg, Wwg, Wwrg, Ds, Wwg, Wog, Wog, Wwg, Ds, Ds, Gs^Esd, Gg, Gg, Gs, Ds^Esd, Gs^Edt, Hh, Hh, Hh, Gs^Fp, Gs^Fms, Gs^Fds, Ss, Gs^Fp, Gs^Fp, Gg, Gs, Gs, Ss, Ss, Gs, Re, Re, Gs^Fp, Gs^Fp, Gs
Wwg, Wwrg, Wwf, Wwg, Wwg, Wwrg, Wwrg, Wwg, Wwg, Wwrg, Wwg, Wog, Wwg, Wwrg, Wwrg, Ds^Esd, Chr, Gg, Gs^Esd, Ds^Esd, Gs, Gs, Gg, Hh, Gg, Gs^Em, Gs^Em, Gll^Fp, Ss, Ss, Gs, Gg^Em, Gs^Fp, Gs, Gd^Edt, Gg, Gg, Gs^Fp, Rp, Gs^Fp, Gs^Fmw, Gs
Wwg, Wwg, Wwf, Wwg, Wwg, Wwg, Wwrg, Wwg, Wwg, Wwf, Wwg, Wog, Wwg, Wwf, Wwrg, Ds, Ds, Gg, Ds, Ds^Es, Gs^Edt, Gg, Gs, Hh, Gg, Gll^Fp, Gd, Gll^Fp, Gs, Gs^Fp, Gg, Gs^Es, Gg, Gg, Gs, Gs^Edt, Gs, Gs, Gs^Vht, Re, Gs^Fmw, Gs^Fp
Wwg, Wwg, Wwg, Wwg, Wwg, Wwrg, Wwrg, Wwrg, Wwrg, Wwg, Wwg, Wwg, Wwg, Wwg, Wwf, Ds^Es, Gs, Gs, Ds^Es, Ds^Esd, Gs, Ds, Gg, Gg, Gg, Gs, Gs, Gs, Gg, Gs, Gs^Fp, Gg, Ss, Gs, Ss, Gg, Gg, Gs^Fp, Re, Re, Gs, Gs^Fp
Wwg, Wwg, Wog, Wwg, Wog, Wwg, Wwg, Wwrg, Wwg, Wwg, Wog, Wwg, Wwg, Wwg, Wwg, Wwg, Ds, Ds, Ds, Ds, Ds, Ds^Esd, Ds, Gs^Edt, Gg, Gg, Ds^Esd, Gs^Vhr, Gg, Gs^Em, Gg, Gg, Gs^Fp, Ss, Ss^Vhs, Ss, Gs^Fp, Gs^Fp, Re, Re, Gs^Fp, Gs^Fp
Wwg, Wog, Wog, Wwg, Wog, Wog, Wwg, Wwg, Wog, Wog, Wwg, Wwrg, Wwg, Wwg^Vm, Wwg, Wwf^Es, Ds, Wwf, Wwg, Wwg, Wwg, Ds, Ds^Esd, Gg^Esd, Gs^Es, Gs, Ds^Esd, Gs, Ds, Gs, Gg, Gs^Fms, Gg, Gs, Gg^Edb, Ss, Cer, Gs, Rp, Gs, Gs^Fmw, Gs^Fp
Wwg, Wog, Wog, Wwg, Wwg, Wwg, Wwg, Wwg, Wog, Wog, Wwg, Wwrg, Wwrg, Wwg, Wwg, Ds^Es, Wwg, Wwrg, Ds, Wwf, Wwg, Ds^Es, Wwf, Ds, Ds, Gs^Esd, Wwrg, Ds, Wwg, Ds^Es, Ds^Esd, Gs, Gs, Gd^Edb, Gs^Edb, Cer^Edb, Ket, Cer^Edb, Re, Gs, Gs^Fp, Gs^Fp
Wog, Wwg, Wog, Wwg, Wwg, Wwf, Wwg, Wwg, Wwg, Wog, Wwg, Wwg, Wwg, Wwrg, Wwg, Wwg, Wog, Wwg, Wwg, Wwg, Wwg, Wwf, Wwg^Vm, Wwf, Wwg, Wwg, Ds, Wwg, Wwg, Wwf, Wwf^Es, Gs^Esd, Gs, Gg, Gs^Fp, Cer^Edb, Cer, Re, Gs^Es, Gs^Fds, Gll^Fms, Gs^Ft
Wog, Wog, Wog, Wog, Wog, Wwg, Wwg, Wog, Wog, Wog, Wog, Wwg, Wwg, Wwg, Wwg, Wog, Wog, Wwg, Wwg, Wog, Wwg, Wwg, Wwg, Wwg, Wwg, Wwf, Wwg, Wwg, Wwg, Wwg, Wwg, Ds^Esd, Ds, Gs, Gs^Fp, Gs^Fp, Gs, Re, Gs, Gll^Fms, Gs^Ft, Gs^Fms
Wog, Wog, Wwg, Wwg, Wwg, Wwg, Wog, Wog, Wog, Wog, Wog, Wwg, Wwg, Wog, Wwg, Wog, Wwrg, Wwg, Wwrg, Wwg, Wwrg, Wwg, Wwg, Wog, Wog, Wwg, Wwg, Wwrg, Wwg, Ds, Ds, Ds, Ds^Esd, Gs, Gs^Fp, Gg^Em, Gs^Fp, Rp, Re, Gs^Fms, Gs^Fms, Gs^Fms
Wog, Wog, Wog, Wog, Wwg, Wog, Wog, Wog, Wog, Wog, Wog, Wwg, Wwg, Wwf, Wwf, Wwg, Wwg, Wwrg, Wog, Wwg, Wwg, Wwrg, Wwrg, Wwrg, Wwg, Wwg, Wwg, Wwg, Ds, Wwrg, Wwf^Es, Ds, Gs^Fp, Gs^Fp, Gs, Gs^Fp, Gs^Fp, Gs^Fds, Re, Gs^Fds, Gs^Fds, Gs^Ft
Wog, Wog, Wog, Wwg, Wog, Wog, Wog, Wog, Wog, Wog, Wog, Wog, Wog, Wwg, Wwg, Wwg, Wog, Wwg, Wog, Wog, Wog, Wwg, Wwg, Wwg, Wog, Wwg, Wwf, Ds, Ds, Wwf, Wwf, Ds, Ds, Gs^Fp, Gg, Gs^Fp, Gs, Re, Re, Gs^Fp, Gll^Fds, Gll^Fds
Wog, Wog, Wog, Wwg, Wog, Wog, Wog, Wog, Wog, Wog, Wog, Wog, Wog, Wog, Wog, Wwg, Wog, Wog, Wog, Wog, Wog, Wwg, Wog, Wwg, Wwg, Wwg, Wwg, Wwg, Wwg, Wwg, Wwg, Wwrg, Wwg, Ds^Esd, Gs, Gg, Re, Re, Gs^Fms, Gs^Fms, Gll^Fds, Gll^Fms
Wog, Wog, Wog, Wog, Wwg, Wog, Wog, Wog, Wog, Wog, Wog, Wog, Wog, Wog, Wog, Wog, Wog, Wog, Wog, Wog, Wog, Wog, Wwg, Wwg, Wwg, Wwg, Wwrg, Wwg, Wwg, Wwg, Wwg, Wwg, Wwf, Ds, Ds^Esd, Gs^Vhr, Re, Re, Gg^Em, Gs^Fms, Gll^Fms, Gll^Fms
Wog, Wog, Wog, Wog, Wog, Wog, Wog, Wog, Wog, Wog, Wog, Wog, Wog, Wog, Wog, Wog, Wog, Wog, Wog, Wog, Wog, Wog, Wwf, Wwg, Wwg, Wwg, Wwrg, Wwg, Wwg, Wwg, Wwf, Wwg, Ds, Ds^Es, Ds, Gg, Re, Gs, Gs^Fds, Gll^Fds, Gll^Fds, Gll^Fds
Wog, Wog, Wog, Wog, Wog, Wog, Wog, Wog, Wog, Wog, Wog, Wog, Wog, Wog, Wog, Wog, Wog, Wog, Wog, Wog, Wog, Wog, Wog, Wwg, Wwg, Wwrg, Wwg, Wwg, Wwg, Wwf, Wwg, Wwrg, Ds^Es, Ds, Gs^Esd, Gg^Esd, Gs, Gg, Gs^Fds, Gs^Fds, Gll^Fds, Gll^Fds
Wog, Wog, Wog, Wog, Wog, Wog, Wog, Wog, Wog, Wog, Wog, Wog, Wog, Wog, Wog, Wog, Wog, Wog, Wog, Wog, Wwg, Wwg, Wwg, Wwg, Wwrg, Wwg, Wwg, Wwg, Wwg, Wwg, Wwf, Ds^Es, Ds, Ds^Esd, Ds^Es, Gg^Es, Gg, Gd, Gs^Fms, Gs^Fms, Gs^Fds, Gll^Fds
Wog, Wog, Wog, Wog, Wog, Wog, Wog, Wog, Wog, Wog, Wog, Wog, Wog, Wog, Wog, Wog, Wog, Wog, Wog, Wog, Wwg, Wwg, Wwrg, Wwrg, Wwrg, Wwrg, Wwg, Wwg, Wwg, Wwg, Ds, Ds, Wwf, Ds, Ds^Esd, Gg, Gg, Re, Gg^Em, Gg, Gll^Fms, Gg
Wog, Wog, Wog, Wog, Wog, Wog, Wog, Wog, Wog, Wog, Wog, Wog, Wog, Wog, Wog, Wog, Wog, Wog, Wwg, Wwg, Wwrg, Wwg, Wwg, Wwg, Wwrg, Wwrg, Wwg, Wwg, Wwg, Wwrg, Wwg, Wwg, Wwf, Ww, Ds, Gs^Esd, Gg, Re, Re, Gg, Gg^Es, Gg
Wog, Wog, Wog, Wog, Wog, Wog, Wog, Wog, Wog, Wog, Wog, Wog, Wog, Wog, Wog, Wog, Wwg, Wwg, Wwg, Wwg, Wwg, Wwg, Wwf, Wwg, Wwg, Wwrg, Wwg, Wwg, Wwg, Wwg, Wwg, Wwf, Ds, Ds^Es, Ds, Gg, Gs^Fds, Gg, Re, Gg^Vhr, Gs^Fds, Gs^Fms
Wog, Wog, Wog, Wog, Wog, Wog, Wog, Wog, Wog, Wog, Wog, Wog, Wog, Wog, Wog, Wog, Wog, Wwf, Wog, Wog, Wog, Wwg, Wog, Wwg, Wwg, Wwg, Wwg, Wwg, Wwg, Wwg, Wwrg, Wwg, Ds, Ds^Esd, Gg, Gg, Gg, Gd, Gg, Gg, Gs, Gg
Wog, Wog, Wog, Wog, Wog, Wog, Wog, Wog, Wwg, Wwrg, Wwrg, Wog, Wog, Wog, Wog, Wog, Wog, Wog, Wog, Wog, Wog, Wog, Wog, Wwg, Wwrg, Wwg, Wwg, Wwg, Wwg, Wwrg, Wwrg, Ds^Es, Ds, Gs, Gs^Fp, Gs^Fds, Gg, Gs, Re, Gg, Gg, Gg
Wog, Wog, Wog, Wog, Wog, Wog, Wog, Wwrg, Wwg, Wwrg, Wwrg, Wog, Wog, Wog, Wog, Wog, Wog, Wog, Wog, Wog, Wog, Wog, Wwg, Wwg, Wwg, Wwg, Wwg, Wwg, Wwg, Wwg, Wwg, Ds, Ds^Esd, Gs^Fp, Gll^Fp, Gs^Fp, Gs^Fms, Gg, Re, Gll^Fds, Gg, Gg
Wog, Wog, Wog, Wog, Wog, Wwg, Wwg, Wwg, Wwrg, Wwg, Wwg, Wwrg, Wog, Wog, Wog, Wog, Wog, Wog, Wog, Wog, Wwg, Wwf, Wwg, Wwg, Wwrg, Wwg, Wwg, Wwg, Wwg, Wwf, Ds^Es, Ds, Gs^Fp, Gs^Fp, Gs^Fp, Gll^Fds, Gs^Fds, Gg, Gg, Re, Gs^Fds, Gg^Es
Wog, Wog, Wog, Wog, Wog, Wwrg, Wwg, Wwf, Ds^Esd, Gd^Fdw, Wwg, Wwg, Wwrg, Wog, Wog, Wog, Wog, Wog, Wog, Wwg, Wwg, Wwf, Wwg, Wwg, Wwrg, Wwg, Wwg, Wwrg, Ds^Es, Ds, Ds, Gs^Fp, Gs^Fp, Gll^Em, Gs^Fp, Gll^Fms, Gs^Fms, Gs^Fp, Gg^Em, Re, Gs^Fms, Gll^Fds
Wog, Wog, Wog, Wog, Wog, Wog, Wwg, Ds^Esd, Gd^Feth, Khr, Wwg, Wwrg, Wog, Wog, Wog, Wog, Wog, Wog, Wwg, Wwg, Wog, Wog, Wwg, Wwg, Wwrg, Wwrg, Wwg, Wwg, Wwg, Wwf^Es, Ds, Ds^Esd, Gs, Gs^Fms, Gs^Fp, Gs^Fms, Gs^Fp, Gs^Fp, Gg^Em, Re, Re, Gs^Fds
Wog, Wog, Wog, Wwg, Wwg, Wwg, Wwg, Ds, Wwrg, Chw, Wwrg, Wog, Wog, Wog, Wog, Wog, Wwg, Wwg, Wwrg, Wog, Wwf, Wog, Wog, Wwg, Wwg, Wwg, Wwg, Wwg, Wwf, Ds^Es, Ds^Esd, Gg, Gs^Fp, Gg, Gg, Gg^Em, Gg, Gs, Gs, Gg, Re, Gs^Fds
Wog, Wog, Wog, Wwrg, Wwrg, Wwrg, Wwrg, Wwg, Wwg, Wwrg, Wog, Wog, Wog, Wog, Wog, Wog, Wwrg, Wwrg, Wwrg, Wog, Wwg, Wwg, Wwg, Wwg, Wwg, Wwf, Wwg, Wwf, Wwf^Es, Ds, Gs, Gg, Gs, Gg, Gg, Gg, Gg, Gg, Gg, Gg, Re, Gs^Fms
Wog, Wog, Wog, Wwg, Wog, Wog, Wog, Wog, Wog, Wwg, Wog, Wog, Wog, Wog, Wog, Wwg, Wwrg, Wwrg, Wog, Wwg, Wwg, Wwrg, Wwg, Wwg, Wwg, Wwg, Wwrg, Ds, Ds, Ds^Esd, Ds, Gg^Es, Gs^Esd, Gs, Gg, Gs, 1 Gs, Gs, Gg, Gg, Gg^Es, Re
Wog, Wog, Wog, Wog, Wog, Wog, Wog, Wog, Wog, Wog, Wog, Wog, Wog, Wog, Wog, Wwg, Wwrg, Wwrg, Wog, Wog, Wog, Wwg, Wwrg, Wwg, Wwg, Wwg, Wwg, Ds, Wwg, Ds, Wwf, Ds^Esd, Ds, Ds, Gs, Gg, Gg, Gg, Gs, Ds, Gg, Gg
Wog, Wog, Wog, Wog, Wog, Wog, Wog, Wog, Wog, Wog, Wog, Wog, Wog, Wog, Wog, Wog, Wwrg, Wog, Wog, Wog, Wog, Wwg, Wwg, Wwrg, Wwg, Wwg, Wwg, Wwrg, Wwg, Wwf^Es, Wwf, Wwf, Ds^Es, Ds, Ds^Esd, Gg, Gs, Gg, Ds, Ds^Esd, Gs, Gg
Wog, Wog, Wog, Wog, Wog, Wog, Wog, Wog, Wog, Wog, Wog, Wog, Wog, Wog, Wog, Wog, Wog, Wog, Wog, Wog, Wwrg, Wwg, Wwg, Wwg, Wwg, Wwg, Wog, Wwg, Wwrg, Wwf, Wwrg, Ds, Ds, Ds, Ds, Ds, Ds, Ds^Esd, Ds, Ds^Es, Ds, Gg
Wog, Wog, Wog, Wog, Wog, Wog, Wog, Wog, Wog, Wog, Wog, Wog, Wog, Wog, Wog, Wog, Wog, Wog, Wog, Wwg, Wwrg, Wwrg, Wwrg, Wwg, Wwf, Wwg, Wog, Wwg, Wwg, Wwg, Wwrg, Wwf, Ds, Wwf, Wwg, Wwrg, Wwg, Wwg, Wwrg, Ds, Wwg, Ds
Wog, Wog, Wog, Wog, Wog, Wog, Wog, Wog, Wog, Wog, Wog, Wog, Wog, Wog, Wog, Wog, Wog, Wog, Wog, Wog, Wog, Wwrg, Wog, Wog, Wog, Wog, Wog, Wwg, Wwg, Wwg, Wwg, Wwf^Es, Ds^Es, Ds, Wwg, Wwg, Wwg, Wwf^Es, Wwg, Wwrg, Wwf, Wwg
Wog, Wog, Wog, Wog, Wog, Wog, Wog, Wog, Wog, Wog, Wog, Wog, Wog, Wog, Wog, Wog, Wog, Wog, Wog, Wog, Wog, Wog, Wog, Wog, Wog, Wog, Wog, Wwg, Wwg, Wwg, Wwg, Wwrg, Ds, Wwg, Wwg, Wwg, Wwg, Wwg, Wwg, Wwg, Wwg, Wwf
Wog, Wog, Wog, Wog, Wog, Wog, Wog, Wog, Wog, Wog, Wog, Wog, Wog, Wog, Wog, Wog, Wog, Wog, Wog, Wog, Wog, Wog, Wog, Wog, Wog, Wwrg, Wwrg, Wwf, Wwg, Wwg, Wwg, Wwg, Wwg, Wwg, Wwg, Wwg, Wwg, Wwg, Wwg, Wwg, Wwg, Wwg
Wog, Wog, Wog, Wog, Wog, Wog, Wog, Wog, Wog, Wog, Wog, Wog, Wog, Wog, Wog, Wog, Wog, Wog, Wog, Wog, Wog, Wog, Wog, Wog, Wog, Wwrg, Wwrg, Wwg, Wwg, Wwg, Wwrg, Wwrg, Wwrg, Wog, Wog, Wwg, Wog, Wwf, Wwg, Wwg, Wwg, Wwg
Wog, Wog, Wog, Wog, Wog, Wog, Wog, Wog, Wog, Wog, Wog, Wog, Wog, Wog, Wog, Wog, Wog, Wog, Wog, Wog, Wog, Wog, Wog, Wog, Wog, Wog, Wwg, Wog, Wog, Wog, Wog, Wog, Wog, Wwrg, Wog, Wog, Wog, Wog, Wog, Wwg, Wwrg, Wwg
