Xuc, Xuc, Xuc, Xuc, Xuc, Xuc, Xuc, Xuc, Xu, Xuc, Yhr, Yhr, Yhr, Xu, Xuc, Xuc, Xuc, Xuc, Xuc, Xuc, Xuc, Xos, Xos, Xos, Xos, Xos, Xos, Xos, Yhl, Yhl, Yhl, Yhl, Xos, Xos, Xos, Xos, Xos, Xos, Xos, Xos, Xos, Xos, Xos, Xos, Xos, Xos, Xos, Xos, Xos, Xos, Xos, Xos
Xu, Xu, Xu, Xu, Xu, Xu, Xu, Xu, Xu, Xu, Yhr, Yhr, Yhr^Xp, Xu, Xuc, Xuc, Xuc, Xuc, Xuc, Xuc, Xuc, Xos, Xos, Xos, Xos, Xos, Yhl, Yhl, Yhl, Yhl, Xos, Xos, Xos, Xos, Xos, Xos, Xos, Xos, Xos, Xos, Xos, Xos, Xos, Xos, Xos, Xos, Xos, Xos, Xos, Xos, Xos, Xos
Xu, Xu, Xu, Xu, Xuc, Xu, Xuc, Xuc, Xu, Xu, Yhr^Xp, Yhr^Xp, Yhr^Pr/, Xu, Xuc, Xuc, Xuc, Xuc, Xuc, Xuc, Xuc, Xos, Xos, Xos, Yhl, Yhl, Yhl, Yhl^Xp, Xos, Xos, Xos, Xos, Xos, Xos, Xos, Xos, Xos, Xos, Xos, Xos, Xos, Xos, Xos, Xos, Xos, Xos, Xos, Xos, Xos, Xos, Xos, Xos
Xu, Xu, Xu, Xuc, Xu, Xuc, Xuc, Xu, Xu, Xu, Yhr^Pr/, Yhr^Pr/, Yhr, Xuc, Xuc, Xuc, Xu, Xuc, Xuc, Xom, Xom, Xos, Yhl, Yhl^Xp, Yhl, Yhl, Xos, Xos, Xos, Xos, Xos, Xos, Xos, Xos, Xos, Xos, Xos, Xos, Xos, Xos, Xos, Xos, Xos, Xos, Xos, Xos, Xos, Xos, Xos, Xos, Xos, Xos
Xu, Xu, Xu, Xu, Xu, Yhr, Yhr, Xuc, Yhr, Xuc, Yhr^Xp, Yhr, Yhr, Xuc, Xu, Xu, Xu, Xu, Xuc, Xom, Yhl^Pw\, Yhl, Yhl^Xp, Yhl, Xos, Xos, Xos, Xos, Xos, Xos, Xos, Xos, Xos, Xos, Xos, Xos, Xos, Xos, Xos, Xos, Xos, Xos, Xos, Xos, Xos, Xos, Xos, Xos, Xos, Xos, Xos, Xos
Xuc, Xu, Xuc, Xu, Yhr, Yhr^Xp, Yhr, Yhr, Yhr^Xp, Yhr, Yhr^Tf, Yhr^Xp, Yhr, Uh, Xu, Xu, Uh, Xuc, Yhl^Xp, Yhl^Xp, Yhl^Xp, Yhl^Pw\, Xos, Xos, Xos, Yhl, Xos, Xos, Xos, Xos, Xos, Xos, Xos, Xos, Xos, Xos, Xos, Xos, Xos, Xos, Xos, Xos, Xos, Xos, Xos, Xos, Xos, Xos, Xos, Xos, Xos, Xos
Xu, Xuc, Xu, Xuc, Yhr^Xp, Yhr^Xp, Xuc, Yhr, Tb^Tf, Yhr^Efs, Uu^Tf, Tb^Tf, Tb^Tf, Uh, Tb^Tf, Uh, Yhl, Yhl, Yhl, Yhl, Xuc, Xos, Xos, Xos, Xos, Yhl^Xo, Xos, Xos, Xos, Xos, Xos, Xos, Xos, Xos, Xos, Xos, Xos, Xos, Xos, Xos, Xos, Xos, Xos, Xos, Xos, Xos, Xos, Xos, Xos, Xos, Xos, Xos
Xu, Xu, Yhr, Yhr, Yhr, Yhr, Uh, Xuc, Tb^Tf, Uu^Vu, Re, Uu, Uu, Uh, Uu^Tf, Uh^Tf, Uh, Yhl^Xp, Uh, Xuc, Xuc, Xos, Xos, Xos, Xos, Yhl^Xp, Xos, Xos, Xos, Xos, Xos, Xos, Xos, Xos, Xos, Xos, Xos, Xos, Xos, Xos, Xos, Xos, Xos, Xos, Xos, Xos, Xos, Xos, Xos, Xos, Xos, Xos
Yhr^Pr\, Yhr, Yhr, Yhr^Xp, Yhr^Efs, Yhr, Uh, Tb^Tf, Re, Re, Re, Uh, Uu, Re, Re, Yhl^Xp, Yhl^Xp, Uh, Xom^Efs, Xuc, Xuc, Xos, Xos, Xos, Xos, Xos, Xos, Xos, Xos, Xos, Xos, Xos, Xos, Xos, Xos, Xos, Xos, Xos, Xos, Xos, Xos, Xos, Xos, Xos, Xos, Xos, Xos, Xos, Xos, Xos, Xos, Xos
Yhr, Yhr^Pr\, Yhr^Pr\, Yhr^Xp, Uh, Uh, Ss, Uu, Re, Re, Uh, Uu^Tf, Uu^Tf, Re, Uu, Yhl^Xp, Yhl, Yhl, Yhl, Xom^Efs, Xos, Xos, Xos, Xos, Xos^Efs, Uh, Xos^Efs, Xos, Xos, Xos, Xos, Xos, Yhl^Xo, Yhl, Xos, Xos, Xos, Xos, Xos, Xos, Xos, Xos, Xos, Xos, Xos, Xos, Xos, Xos, Xos, Xos, Xos, Xos
Yhr, Yhr, Xuc, Xuc, Uh, Ss, Uu, Uu, Uu, Tb^Tf, Tb^Tf, Xuc, Xuc, Uh, Yhl, Re, Xuc, Xuc, Xos, Yhl^Xp, Xos, Xos, Xos^Efs, Xos^Efs, Urb, Urb, Urb, Xos^Efs, Xos^Efs, Xos, Xos, Yhl^Xp, Xos, Xos, Xos, Xos, Xos, Xos, Xos, Xos, Xos, Xos, Xos, Xos, Xos, Xos, Xos, Xos, Xos, Xos, Xos, Xos
Xuc, Xuc, Xu, Ss, Ss, Ss, Uu, Re, Re, Uh, Tb^Tf, Uh, Xuc, Xuc, Xuc, Xuc, Xuc, Xuc, Xos, Xos, Xos, Uh, Urb, Urb, Wog, Wog, Wog, Urb, Urb, Uh, Xos, Xos, Xos, Xos, Xos, Xos, Xos, Xos, Xos, Xos, Xos, Xos, Xos, Xos, Xos, Xos, Xos, Xos, Xos, Xos, Xos, Xos
Xu, Xuc, Xuc, Xu, Xu, Tb^Tf, Tb^Tf, Uu, Re, Uu^Vu, Uh, Xom, Xuc, Xuc, Xuc, Xos, Xos, Xos, Xos, Xos, Xos, Xos, Urb, Urb, Wog, Uu^Ii, Wog, Urb, Urb, Xos, Xos, Xos, Xos, Xos, Xos, Xos, Xos, Xos, Xos, Xos, Xos, Xos, Xos, Xos, Xos, Xos, Xos, Xos, Xos, Xos, Xos, Xos
Wwb, Xu, Xom, Xuc, Xu, Uh, Uu^Em, Uu^Em, Uu, Uu, Uh, Xom, Xuc, Xuc, Xos, Xos, Xos, Xos, Xos, Xos, Xos, Xos, Urb, Urb, Urb, Wwg^Bw|, Urb, Urb, Urb, Xos, Xos^Xzm\, Xos, Xos, Xos, Xos, Xos, Xos, Xos, Xos, Xos, Xos, Xos, Wog, Xos, Xos, Xos, Xos, Xos, Xos, Xos, Xos, Xos
Wwb, Wwb, Wwb, Xom, Xu, Uh, Uh, Uu^Em, Re, Uu, Yhl^Xp, Xuc, Xuc, Xos, Xos, Xos, Xos, Xos, Xos, Xos, Xos, Uh, Xos, Urb, Urb, Urb, Urb, Urb, Xos, Uh, Xos, Xos, Xos, Xos, Xos, Xos, Xos, Xos, Xos, Xos, Wog, Wog, Xos, Xos, Xos, Xos, Xos, Xos, Xos, Xos, Xos, Xos
Yhl, Wwb, Wwb, Wwb, Wwb^Xo, Uh, Uh, Uu^Es, Re, Re^Efs, Uu, Yhl, Yhl, Uh, Uh, Xos, Xos, Xos, Yhl^Xo, Yhl^Xp, Xos, Xos, Xos, Xos, Xos, Urb, Xos, Xos, Xos, Xos, Xos, Yhl^Xp, Yhl^Xo, Xos, Xos, Xos, Xos, Xos, Wog, Wog, Xos, Xos, Xos, Xos, Xos, Xos, Xos, Xos, Xos, Xos, Xos, Xos
Wwb, Yhl^Xp, Yhl, Wwb, Wwb, Wwb^Xo, Wwb^Xo, Uh, Uh, Ur, Ur, Uh, Uh, Yhl^Xp, Yhl^Xp, Xos, Xos^Xzm\, Yhl, Xos^Xzm/, Xos, Uh^Xo, Uu, Xos, Xos, Uh, Ur, Xos^Xzm/, Xos, Uu^Tf, Uh, Tb^Tf, Xos, Xos, Yhl, Xos, Xos, Wog, Wog, Xos, Xos, Xos, Xos, Xos, Xos, Xos, Xos, Xos, Xos, Xos, Xos, Xuc, Xuc
Yhl, Wwb, Wwb, Yhl^Xp, Yhl, Wwb, Wwb, Wwb^Xo, Wwb^Xo, Xu, Xu, Ur, Ur, Uu^Tf, Uu^Vu, Yhl^Xp, Yhl^Xp, Xos^Xzm\, Uu^Emf, Uu^Tf, Uh^Xo, Ur^Br/, Xos, Uh, Uu, Ur, Ur, Ur, Rb, Uh, Uu^Emf, Xuc, Xuc, Xos, Wog, Wog^Xo, Xos, Yhl^Xo, Yhl^Xp, Xos, Xos, Xos, Xos, Xos, Xos, Xos, Xos, Xos, Xuc, Xuc, Xuc, Xuc
Wwb, Yhl^Xp, Yhl, Wwb, Wwb, Yhl^Xp, Yhl, Wwb, Wwb, Wwb, Wwb^Xo, Uu^Tf, Uu^Tf, Ur, Yhl, Uh, Ur^Br/, Ur^Br/, Uu^Br\, Ur^Br/, Uu, Uh^Xo, Xos, Uh, Xos, Uu, Xuc, Uh, Uu^Vu, Rb, Uu^Em, Xuc, Wog^Es, Wog, Cud, Xos, Yhl, Xos, Xos, Uh, Uh, Xos, Xos, Xos, Xos, Xos, Xuc, Xuc, Xuc, Xuc, Xuc, Xuc
Yhl, Wwb, Wwb, Yhl^Xp, Yhl^Ii, Wwb, Wwb, Yhl^Xp, Yhl^Xp, Wwb^Ii, Wwb^Xo, Wwb^Xo, Wwb^Pr/, Uu^Vu, Ur, Ur, Uu^Em, Uu^Em, Uu^Ii, Uu^Em, Yhl, Uh^Xo, Xos, Xos, Xos, Uh, Xos, Xuc, Xuc, Rb, Wwg^Bw\, Wwg, Uu^Es, Cud, Uh, Xos, Xos, Yhl, Yhl^Xo, Xos, Uu^Vu, Uh, Xos, Xos, Xu, Xu, Xu, Xuc, Xuc, Xuc, Xuc, Xuc
Wwb, Yhl^Xp, Yhl, Wwb, Wwb, Yhl^Xp, Yhl^Xp, Wwb, Wwb^Xo, Wwb^Xo, Wwb^Pr/, Wwb^Pr/, Urb, Urb, Urb, Ur, Uu^Vu, Uu^Em, Yhl^Xp, Uh, Xos, Yhl^Xp, Yhl, Xos, Xos, Xos, Xos, Xuc, Wwg, Wwg^Es, Uu^Em, Uu, Ur^Em, Uh, Urb, Uh, Xos, Xos, Xos, Yhl^Xp, Ur^Br|, Uh, Xuc, Xu, Yhl^Xo, Yhl, Xu, Xuc, Xuc, Xuc, Xuc, Xuc
Yhl, Wwb, Wwb, Yhl^Xp, Yhl^Xp, Wwb, Wwb^Xo, Wwb^Xo, Wwb^Pr/, Wwb^Pr/, Urb, Urb, Urb, Urb, Wwb^Pr/, Wwb^Pr/, Wwb^Xo, Xos, Xos, Yhl, Yhl, Xos, Xos, Yhl, Xos, Xos, Wog^Xo, Wog, Xos, Cud, Uu, Ur^Es, Ur^Br/, Ur, Uh, Urb, Rb, Uu^Vu, Urb, Uh, Ur^Br/, Uh, Yhl^Xp, Yhl, Xu, Xu, Xuc, Xuc, Xuc, Xuc, Xuc, Xuc
Wwb, Yhl^Xp, Yhl^Xp, Wwb, Wwb^Xo, Wwb^Xo, Wwb^Pr/, Wwb^Pr/, Urb, Urb, Urb, Urb, Wwb^Pr/, Wwb^Pr/, Wwb^Xo, Wwb^Xo, Wwb, Wwb, Wwb, Xos, Xos, Yhl, Xos, Xos, Wog, Wog, Xos, Xos, Xos, Xos, Ur^Br/, Ur^Br/, Uu^Tf, Uh, Tb^Tf, Urb^Efs, Rb^Br\, Uu^Em, Ur^Br\, Ur^Br|, Uh, Uh^Ii, Xuc, Uh, Xuc, Xuc, Xuc, Xuc, Xuc, Xuc, Xuc, Xuc
Yhl^Xp, Wwb, Wwb, Wwb^Xo, Wwb^Xo, Wwb^Xo, Wwb^Pr\, Urb, Urb, Urb, Wwb^Pr/, Wwb^Pr/, Wwb^Xo, Wwb^Xo, Wwb^Ii, Yhl^Xp, Yhl^Xp, Xuc, Xuc, Wwb, Xos, Xos, Wog, Wog, Xos, Xos, Xos, Xos, Xos, Ur^Br|, Xos, Xos, Uu, Tb^Tf, Uh, Tb^Tfi, Rb^Tf, Ur^Br\, Ur^Br\, Ur^Br|, Uu^Em, Xuc, Uh, Xuc, Xuc, Xuc, Xuc, Xuc, Xuc, Xuc, Xuc, Xuc
Wwb, Wwb, Wwb, Wwb, Wwb, Wwb^Xo, Wwb^Xo, Wwb^Pr\, Wwb^Xo, Wwb^Pr/, Wwb^Xo, Wwb^Xo, Wwb, Yhl^Xp, Yhl^Xp, Xuc, Xuc, Yhl, Xuc, Xos, Wog, Wog, Xos, Xos, Xos, Xos, Xos, Xos, Ur^Br/, Ur^Xo, Xos, Xos, Uu, Uh, Uu^Ii, Uu^Tf, Uue^Em, Uue^Efs, Uue, Ur^Br\, Ur^Br\, Uu, Uh, Xom, Xom, Xuc, Xuc, Xuc, Xuc, Xuc, Xom, Xuc
Wwb, Wwb^Ii, Wwb, Wwb, Wwb, Wwb, Wwb, Wwb^Xo, Wwb^Xo, Wwb^Xo, Wwb, Yhl^Xp, Yhl^Xp, Xuc, Xuc, Yhl, Xuc, Xuc, Xuc, Xos, Xos, Xos, Xos, Xos, Xos, Xos, Xos, Uu^Br/, Xos, Xos, Yhl, Yhl^Xp, Uh, Uu^Vu, Urb, Urb^Em, Uue, Uue^Ii, Uhe, Uu^Es, Uu^Ii, Ur^Br\, Uh, Uh, Uu^Em, Xuc, Xuc, Xuc, Xuc, Xom, Qxu, Xuc
Wwb, Wwb, Wwb, Wwb, Wwb, Wwb, Wwb, Wwb^Ii, Wwb, Yhl^Xp, Yhl^Xp, Xuc, Xuc, Yhl, Xuc, Xuc, Xuc, Xuc, Xuc, Xuc, Xuc, Xos, Xos, Xos, Xos, Xos, Xos, Xos, Yhl, Yhl^Xo, Xos, Uh, Xos, Uh, Urb, Uue^Em, Uue, Uhe^Ii, Xuc, Xuc, Xu, Uu^Ii, Uu, Ur^Br\, 1 Ur^Br\, Uu, Uu, Xu, Xom, Qxu, Qxu, Xuc
Wwb, Wwb, Wwb, Wwb, Wwb, Wwb, Wwb, Yhl^Xp, Yhl^Xp, Xuc, Xuc, Yhl, Xuc, Xuc, Xuc, Xuc, Xuc, Xuc, Xuc, Xuc, Xuc, Xuc, Xuc, Xos, Xos, Xos, Yhl, Yhl, Xos, Qxe, Qxe, Xos, Qxe, Urb, Uue, Uue, Uhe, Uhe, Xuc, Xuc, Xuc, Xu, Xom, Uu, Uu, Ur^Br\, Ur^Br\, Uu, Uu, Qxu, Xuc, Xuc
Wwb, Wwb, Wwb, Wwb, Wwb, Yhl^Xp, Yhl^Xp, Xuc, Xuc, Yhl, Xuc, Xuc, Xuc, Xuc, Xuc, Xuc, Xuc, Xuc, Xuc, Xuc, Xuc, Xuc, Xuc, Xos, Xos, Yhl, Xos, Xos, Xos, Qxe, Qxe, Qxe, Qxe, Qxe, Qxe, Xos, Xos, Xuc, Xuc, Xuc, Xuc, Xu, Xuc, Xom, Xom, Uu, Uu, Ur^Br\, Ur^Br\, Uu^Em, Uu^Em, Xuc
Wwb, Wwb, Wwb, Yhl^Xp, Yhl^Xp, Xuc, Xuc, Yhl, Xuc, Xuc, Xuc, Xuc, Xuc, Xuc, Xuc, Xuc, Xuc, Xuc, Xuc, Xuc, Xuc, Xuc, Xos, Xos, Xos, Xos, Qxe, Xos, Qxe, Qxe, Qxe, Xos, Xos, Qxe, Qxe, Xos, Xos, Xuc, Xuc, Xuc, Xuc, Xuc, Xuc, Xuc, Xuc, Xom, Xom, Uu, Ur^Es, Ur^Br\, Ur^Br\, Uu
Wwb, Yhl^Xp, Yhl^Xp, Xuc, Xuc, Yhl, Xuc, Xuc, Xuc, Xuc, Xuc, Xuc, Xuc, Xuc, Xuc, Xuc, Xuc, Xuc, Xuc, Xuc, Xos, Xos, Xos, Xos, Qxe, Qxe, Qxe, Qxe, Qxe, Qxe, Qxe, Xos, Xos, Qxe, Qxe, Xos, Xos, Xuc, Xuc, Xuc, Xuc, Xuc, Xuc, Xuc, Xom, Xuc, Xom, Qxu, Xom, Uu^Ii, Uu, Ur^Br\
Xuc, Xuc, Xuc, Yhl, Xuc, Xuc, Xuc, Xuc, Xuc, Xuc, Xuc, Xuc, Xuc, Xuc, Xuc, Xuc, Xuc, Xuc, Xos, Xos, Xos, Xos, Qxe, Qxe, Qxe, Qxe, Qxe, Qxe, Qxe, Qxe, Qxe, Qxe, Qxe, Qxe, Qxe, Xos, Xos, Xos, Xuc, Xuc, Xuc, Xuc, Xos, Xom, Xom, Xom, Xom, Xom, Xom, Xom, Xom, Uu^Ii
