Rr, Urb, Urb, Xoc, Xoc^Efs, Xoc, Xoc, Xoc, Xoc, Xoc, Yhr, Xoc, Xoc, Xoc, Xoc, Xoc, Xoc, Xoc, Xoc, Xoc, Xoc, Xoc^Efs, Cud, Cud, Cud, Xoc
Urb, Rr, Rr, Urb, Urb^Pr/, Xoc^Efs, Xoc, Xoc^Efs, Xoc, Xoc, Urb, Xoc^Efs, Xoc^Efs, Xoc, Xoc^Efs, Xoc^Efs, Cud^Ebur, Xoc, Cud^Ebme, Xoc, Cud, Cud, Cud, Cud, Xoc, Xoc
Xoc, Urb, Urb^Pr/, Rr^Pr/, Rr, Urb, Urb, Xoc^Efs, Cud, Urb, Xoc^Efs, Urb, Cud, Xoc, Urb, Cud^&A, Cud, Cud, 3 Kud, Cud, 2 Kud, Cud, Xoc, Xoc, Xoc, Xoc
Xoc, Xoc, Xoc, Urb, Urb, Rr, Rr, Urb, Urb, Urb, Urb, Urb, Urb, Urb, Cud^&A, Cud^&A, Cud, Cud, Cud, Cud, Cud, Cud, Xoc, Xoc, Xoc, Xoc
Xoc, Xoc, Xoc, Xoc, Urb, Urb, Urb, Rr, Urb, Urb, Wwg, Wwg, Wwg, Urb, Urb, Cud^&A, Cud^&A, 4 Kud, Cud, Cud, Cud, Cud, Xoc^Efs, Xoc, Xoc, Xoc
Xoc, Xoc, Xoc, Xoc, Urb, Urb, Urb, Urb, Wwg, Wwg, Wwg, Wwg, Urb, Urb, Rr, Urb, Urb, Cud^&A, Cud^&A, 5 Kud, Cud^&A, Cud^&A, Cud^&A, Xoc^Efs, Xoc, Xoc
Xoc^Efs, Xoc, Xoc, Xoc^Efs, Cud, Urb, Urb, Urb, Urb, Wwg, Urb, Urb, Rr, Rr, Rr, Rr, Rr, Urb, Urb, Cud^&A, Urb, Urb, Urb, Xoc, Yhr, Yhr
Yhl, Yhr^Xo, Yhr^Xp, Xoc^Efs, Urb, Urb, Urb, Urb, Urb, Urb, Urb, Rr, Rr, 1 Rr, Rr, Rr, Urb, Urb, Wwg, Urb, Urb, Xoc^Efs, Urb, Urb, Xoc, Xoc
Xoc, Xoc, Xoc, Urb, Urb, Xoc^Efs, Urb, Urb, Wwg, Wwg, Wwg, Urb, Urb, Rr, Urb, Urb, Wwg, Wwg, Wwg, Wwg, Urb, Urb, Cud, Xoc, Xoc, Xoc
Xoc, Xoc, Xoc, Xoc, Cud, Urb, Urb, Urb, Urb, Wwg, Wwg, Wwg, Wwg, Urb, Urb, Wwg, Wwg, Wwg, Urb, Urb, Urb, Urb, Xoc, Xoc, Xoc, Xoc
Xoc, Xoc, Xoc, Xoc, Urb, Urb, Urb, Urb, Rr, Urb, Urb, Wwg, Urb, Urb, Urb, Urb, Urb, Urb, Urb, Urb, Xoc^Efs, Xoc, Xoc, Xoc, Xoc, Xoc
Xoc, Xoc, Xoc^Efs, Xoc^Efs, Urb, Urb, Rr, Rr, Urb, Urb, Xoc^Efs, Urb, Urb, Urb, Urb, Urb, Urb, Rr, Rr, Urb, Urb, Xoc^Efs, Xoc, Xoc, Xoc, Xoc
Xoc, Xoc, Cud, Urb, Rr, Rr, Urb, Urb, Cud, Urb, Urb, Urb, Cud, Urb, Urb, Urb, Xoc, Urb, Urb, Rr, Cud, Cud, Urb, Xoc^Efs, Xoc^Efs, Xoc
Urb, Urb, Rr, Cud, Cud, Urb, Xoc, Xoc, Xoc, Xoc, Yhr^Xp, Xoc, Xoc, Xoc, Xoc, Xoc, Xoc, Xoc, Xoc, Cud, Urb, Rr, Rr, Urb, Urb, Xoc
Rr, Rr, Urb, Urb, Xoc, Xoc, Xoc, Xoc, Xoc, Xoc, Yhr^Xo, Xoc^Efs, Xoc^Efs, Xoc, Xos, Xoc, Xoc, Xoc, Xoc, Xoc, Xoc, Urb, Urb, Rr, Rr, Urb
Urb, Urb, Xoc, Xoc, Xoc, Xoc, Xoc, Xoc, Xoc, Xoc, Xoc, Yhl^Xp, Yhl, Xoc, Xos, Xos, Xoc, Xoc, Xoc, Xoc, Xoc, Xoc, Xoc, Urb, Cud, Cud
Xoc, Xoc, Xoc, Xoc, Xoc, Xoc, Xoc, Xoc, Xoc, Xoc, Xoc, Xoc, Xoc, Yhl, Xos, Xoc, Xoc, Xoc, Xoc, Xoc, Xoc, Xoc, Xoc, Xoc, Xoc, Urb
Xoc, Xoc, Xoc, Xoc, Xoc, Xoc, Xoc, Xoc, Xoc, Xoc, Xoc, Xoc, Xoc, Yhl^Xp, Xoc, Xoc, Xoc, Xoc, Xoc, Xoc, Xoc, Xoc, Xoc, Xoc, Xoc, Xoc
