border_size=1
usage=map

Xuc, Xuc, Xuc, Xuc, Xuc, Xuc, Xuc, Xuc, Xuc, Xuc, Yhr, Yhr, Yhr, Xuc, Xuc, Xuc, Xuc, Xuc, Xuc, Xuc, Xuc, Xos, Xos, Xos, Xos, Xos, Xos, Xos, Yhl, Yhl, Yhl, Yhl, Xos, Xos, Xos, Xos, Xos, Xos, Xos, Xos, Xos, Xos, Xos, Xos, Xos, Xos, Xos, Xos, Xos, Xos, Xos, Xos
Xuc, Xuc, Xuc, Xuc, Xuc, Xuc, Xuc, Xuc, Xuc, Xuc, Yhr, Yhr, Yhr^Xp, Xuc, Xuc, Xuc, Xuc, Xuc, Xuc, Xuc, Xuc, Xos, Xos, Xos, Xos, Xos, Yhl, Yhl, Yhl, Yhl, Xos, Xos, Xos, Xos, Xos, Xos, Xos, Xos, Xos, Xos, Xos, Xos, Xos, Xos, Xos, Xos, Xos, Xos, Xos, Xos, Xos, Xos
Xuc, Xuc, Xuc, Xuc, Xuc, Xuc, Xuc, Xuc, Xuc, Xuc, Yhr^Xp, Yhr^Xp, Yhr^Z/, Xuc, Xuc, Xuc, Xuc, Xuc, Xuc, Xuc, Xuc, Xos, Xos, Xos, Yhl, Yhl, Yhl, Yhl^Xp, Xos, Xos, Xos, Xos, Xos, Xos, Xos, Xos, Xos, Xos, Xos, Xos, Xos, Xos, Xos, Xos, Xos, Xos, Xos, Xos, Xos, Xos, Xos, Xos
Xuc, Xuc, Xuc, Xuc, Xuc, Xuc, Xuc, Xuc, Xuc, Xuc, Yhr^Z/, Yhr^Z/, Yhr, Xuc, Xuc, Xuc, Xuc, Xuc, Xuc, Xuc, Xuc, Xos, Yhl, Yhl^Xp, Yhl, Yhl, Xos, Xos, Xos, Xos, Xos, Xos, Xos, Xos, Xos, Xos, Xos, Xos, Xos, Xos, Xos, Xos, Xos, Xos, Xos, Xos, Xos, Xos, Xos, Xos, Xos, Xos
Xuc, Xuc, Xuc, Xuc, Xuc, Yhr, Yhr, Xuc, Yhr, Xuc, Yhr^Xp, Yhr, Yhr, Xuc, Xuc, Xuc, Xuc, Xuc, Xuc, Xuc, Yhl^Z\, Yhl, Yhl^Xp, Yhl, Xos, Xos, Xos, Xos, Xos, Xos, Xos, Xos, Xos, Xos, Xos, Xos, Xos, Xos, Xos, Xos, Xos, Xos, Xos, Xos, Xos, Xos, Xos, Xos, Xos, Xos, Xos, Xos
Xuc, Xuc, Xuc, Xuc, Yhr, Yhr^Xp, Yhr, Yhr, Yhr^Xp, Yhr, Yhr^Uf, Yhr^Xp, Yhr, Uh, Xuc, Xuc, Uh, Xuc, Yhl^Xp, Yhl^Xp, Yhl^Xp, Yhl^Z\, Xos, Xos, Xos, Yhl, Xos, Xos, Xos, Xos, Xos, Xos, Xos, Xos, Xos, Xos, Xos, Xos, Xos, Xos, Xos, Xos, Xos, Xos, Xos, Xos, Xos, Xos, Xos, Xos, Xos, Xos
Xuc, Xuc, Xuc, Xuc, Yhr^Xp, Yhr^Xp, Xuc, Yhr, Uu^Uf, Yhr, Uu^Uf, Uu^Uf, Uu^Uf, Uh, Uu^Uf, Uh, Yhl, Yhl, Yhl, Yhl, Xuc, Xos, Xos, Xos, Xos, Yhl^Xo, Xos, Xos, Xos, Xos, Xos, Xos, Xos, Xos, Xos, Xos, Xos, Xos, Xos, Xos, Xos, Xos, Xos, Xos, Xos, Xos, Xos, Xos, Xos, Xos, Xos, Xos
Xuc, Xuc, Yhr, Yhr, Yhr, Yhr, Uh, Xuc, Uu^Uf, Uu^Vu, Re, Uu, Uu, Uh, Uu^Uf, Uh^Uf, Uh, Yhl^Xp, Uh, Xuc, Xuc, Xos, Xos, Xos, Xos, Yhl^Xp, Xos, Xos, Xos, Xos, Xos, Xos, Xos, Xos, Xos, Xos, Xos, Xos, Xos, Xos, Xos, Xos, Xos, Xos, Xos, Xos, Xos, Xos, Xos, Xos, Xos, Xos
Yhr^Z\, Yhr, Yhr, Yhr^Xp, Yhr, Yhr, Uh, Uu^Uf, Re, Re, Re, Uh, Uu, Re, Re, Yhl^Xp, Yhl^Xp, Uh, Xuc, Xuc, Xuc, Xos, Xos, Xos, Xos, Xos, Xos, Xos, Xos, Xos, Xos, Xos, Xos, Xos, Xos, Xos, Xos, Xos, Xos, Xos, Xos, Xos, Xos, Xos, Xos, Xos, Xos, Xos, Xos, Xos, Xos, Xos
Yhr, Yhr^Z\, Yhr^Z\, Yhr^Xp, Uh, Uh, Ss, Uu, Re, Re, Uh, Uu^Uf, Uu^Uf, Re, Uu, Yhl^Xp, Yhl, Yhl, Yhl, Xuc, Xos, Xos, Xos, Xos, Xol, Uh, Xol, Xos, Xos, Xos, Xos, Xos, Yhl^Xo, Yhl, Xos, Xos, Xos, Xos, Xos, Xos, Xos, Xos, Xos, Xos, Xos, Xos, Xos, Xos, Xos, Xos, Xos, Xos
Yhr, Yhr, Xuc, Xuc, Uh, Ss, Uu, Uu, Uu, Uu^Uf, Uu^Uf, Xuc, Xuc, Uh, Yhl, Re, Xuc, Xuc, Xos, Yhl^Xp, Xos, Xos, Xol, Xol, Urb, Urb, Urb, Xol, Xol, Xos, Xos, Yhl^Xp, Xos, Xos, Xos, Xos, Xos, Xos, Xos, Xos, Xos, Xos, Xos, Xos, Xos, Xos, Xos, Xos, Xos, Xos, Xos, Xos
Xuc, Xuc, Xuc, Ss, Ss, Ss, Uu, Re, Re, Uh, Uu^Uf, Uh, Xuc, Xuc, Xuc, Xuc, Xuc, Xuc, Xos, Xos, Xos, Uh, Urb, Urb, Wog, Wog, Wog, Urb, Urb, Uh, Xos, Xos, Xos, Xos, Xos, Xos, Xos, Xos, Xos, Xos, Xos, Xos, Xos, Xos, Xos, Xos, Xos, Xos, Xos, Xos, Xos, Xos
Xuc, Xuc, Xuc, Xuc, Xuc, Uu^Uf, Uu^Uf, Uu, Re, Uu^Vu, Uh, Xuc, Xuc, Xuc, Xuc, Xos, Xos, Xos, Xos, Xos, Xos, Xol, Urb, Urb, Wog, Uu^Ii, Wog, Urb, Urb, Xol, Xos, Xos, Xos, Xos, Xos, Xos, Xos, Xos, Xos, Xos, Xos, Xos, Xos, Xos, Xos, Xos, Xos, Xos, Xos, Xos, Xos, Xos
Wwb, Xuc, Xuc, Xuc, Xuc, Uh, Uu^Em, Uu^Em, Uu, Uu, Uh, Xuc, Xuc, Xuc, Xos, Xos, Xos, Xos, Xos, Xos, Xos, Xol, Urb, Urb, Urb, Wwg^Bw|, Urb, Urb, Urb, Xol, Xos^Xzm\, Xos, Xos, Xos, Xos, Xos, Xos, Xos, Xos, Xos, Xos, Xos, Wog, Xos, Xos, Xos, Xos, Xos, Xos, Xos, Xos, Xos
Wwb, Wwb, Wwb, Xuc, Xuc, Uh, Uh, Uu^Em, Re, Uu, Yhl^Xp, Xuc, Xuc, Xos, Xos, Xos, Xos, Xos, Xos, Xos, Xos, Uh, Xol, Urb, Urb, Urb, Urb, Urb, Xol, Uh, Xos, Xos, Xos, Xos, Xos, Xos, Xos, Xos, Xos, Xos, Wog, Wog, Xos, Xos, Xos, Xos, Xos, Xos, Xos, Xos, Xos, Xos
Yhl, Wwb, Wwb, Wwb, Wwb^Xo, Uh, Uh, Uu^Es, Re, Re, Uu, Yhl, Yhl, Uh, Uh, Xos, Xos, Xos, Yhl^Xo, Yhl^Xp, Xos, Xos, Xos, Xol, Xol, Urb, Xol, Xol, Xos, Xos, Xos, Yhl^Xp, Yhl^Xo, Xos, Xos, Xos, Xos, Xos, Wog, Wog, Xos, Xos, Xos, Xos, Xos, Xos, Xos, Xos, Xos, Xos, Xos, Xos
Wwb, Yhl^Xp, Yhl, Wwb, Wwb, Wwb^Xo, Wwb^Xo, Uh, Uh, Ur, Ur, Uh, Uh, Yhl^Xp, Yhl^Xp, Xos, Xos^Xzm\, Yhl, Xos^Xzm/, Xos, Uh^Xo, Uu, Xos, Xos, Uh, Ur, Xos^Xzm/, Xos, Uu^Uf, Uh, Uu^Uf, Xos, Xos, Yhl, Xos, Xos, Wog, Wog, Xos, Xos, Xos, Xos, Xos, Xos, Xos, Xos, Xos, Xos, Xos, Xos, Xuc, Xuc
Yhl, Wwb, Wwb, Yhl^Xp, Yhl, Wwb, Wwb, Wwb^Xo, Wwb^Xo, Xuc, Xuc, Ur, Ur, Uu^Uf, Uu^Vu, Yhl^Xp, Yhl^Xp, Xos^Xzm\, Uu^Emf, Uu^Uf, Uh^Xo, Ur^Br/, Xos, Uh, Uu, Ur, Ur, Ur, Rb, Uh, Uu^Emf, Xuc, Xuc, Xos, Wog, Wog^Xo, Xos, Yhl^Xo, Yhl^Xp, Xos, Xos, Xos, Xos, Xos, Xos, Xos, Xos, Xos, Xuc, Xuc, Xuc, Xuc
Wwb, Yhl^Xp, Yhl, Wwb, Wwb, Yhl^Xp, Yhl, Wwb, Wwb, Wwb, Wwb^Xo, Uu^Uf, Uu^Uf, Ur, Yhl, Uh, Ur^Br/, Ur^Br/, Uu^Br\, Ur^Br/, Uu, Uh^Xo, Xos, Uh, Xos, Uu, Xuc, Uh, Uu^Vu, Rb, Uu^Em, Xuc, Wog^Es, Wog, Cud, Xos, Yhl, Xos, Xos, Uh, Uh, Xos, Xos, Xos, Xos, Xos, Xuc, Xuc, Xuc, Xuc, Xuc, Xuc
Yhl, Wwb, Wwb, Yhl^Xp, Yhl^Ii, Wwb, Wwb, Yhl^Xp, Yhl^Xp, Wwb^Ii, Wwb^Xo, Wwb^Xo, Wwb^Z/, Uu^Vu, Ur, Ur, Uu^Em, Uu^Em, Uu^Ii, Uu^Em, Yhl, Uh^Xo, Xos, Xos, Xos, Uh, Xos, Xuc, Xuc, Rb, Wwg^Bw\, Wwg, Uu^Es, Cud, Uh, Xos, Xos, Yhl, Yhl^Xo, Xos, Uu^Vu, Uh, Xos, Xos, Xuc, Xuc, Xuc, Xuc, Xuc, Xuc, Xuc, Xuc
Wwb, Yhl^Xp, Yhl, Wwb, Wwb, Yhl^Xp, Yhl^Xp, Wwb, Wwb^Xo, Wwb^Xo, Wwb^Z/, Wwb^Z/, Urb, Urb, Urb, Ur, Uu^Vu, Uu^Em, Yhl^Xp, Uh, Xos, Yhl^Xp, Yhl, Xos, Xos, Xos, Xos, Xuc, Wwg, Wwg^Es, Uu^Em, Uu, Ur^Em, Uh, Urb, Uh, Xos, Xos, Xos, Yhl^Xp, Ur^Br|, Uh, Xuc, Xuc, Yhl^Xo, Yhl, Xuc, Xuc, Xuc, Xuc, Xuc, Xuc
Yhl, Wwb, Wwb, Yhl^Xp, Yhl^Xp, Wwb, Wwb^Xo, Wwb^Xo, Wwb^Z/, Wwb^Z/, Urb, Urb, Urb, Urb, Wwb^Z/, Wwb^Z/, Wwb^Xo, Xos, Xos, Yhl, Yhl, Xos, Xos, Yhl, Xos, Xos, Wog^Xo, Wog, Xos, Cud, Uu, Ur^Es, Ur^Br/, Ur, Uh, Urb, Rb, Uu^Vu, Urb, Uh, Ur^Br/, Uh, Yhl^Xp, Yhl, Xuc, Xuc, Xuc, Xuc, Xuc, Xuc, Xuc, Xuc
Wwb, Yhl^Xp, Yhl^Xp, Wwb, Wwb^Xo, Wwb^Xo, Wwb^Z/, Wwb^Z/, Urb, Urb, Urb, Urb, Wwb^Z/, Wwb^Z/, Wwb^Xo, Wwb^Xo, Wwb, Wwb, Wwb, Xos, Xos, Yhl, Xos, Xos, Wog, Wog, Xos, Xos, Xos, Xos, Ur^Br/, Ur^Br/, Uu^Uf, Uh, Uu^Uf, Urb, Rb^Br\, Uu^Em, Ur^Br\, Ur^Br|, Uh, Uh^Ii, Xuc, Uh, Xuc, Xuc, Xuc, Xuc, Xuc, Xuc, Xuc, Xuc
Yhl^Xp, Wwb, Wwb, Wwb^Xo, Wwb^Xo, Wwb^Xo, Wwb^Z\, Urb, Urb, Urb, Wwb^Z/, Wwb^Z/, Wwb^Xo, Wwb^Xo, Wwb^Ii, Yhl^Xp, Yhl^Xp, Xuc, Xuc, Wwb, Xos, Xos, Wog, Wog, Xos, Xos, Xos, Xos, Xos, Ur^Br|, Xos, Xos, Uu, Uh^Uf, Uh, Rb^Ufi, Rb^Uf, Ur^Br\, Ur^Br\, Ur^Br|, Uu^Em, Xuc, Uh, Xuc, Xuc, Xuc, Xuc, Xuc, Xuc, Xuc, Xuc, Xuc
Wwb, Wwb, Wwb, Wwb, Wwb, Wwb^Xo, Wwb^Xo, Wwb^Z\, Wwb^Xo, Wwb^Z/, Wwb^Xo, Wwb^Xo, Wwb, Yhl^Xp, Yhl^Xp, Xuc, Xuc, Yhl, Xuc, Xos, Wog, Wog, Xos, Xos, Xos, Xos, Xos, Xos, Ur^Br/, Ur^Xo, Xos, Xos, Uu, Uh, Uu^Ii, Uu^Uf, Uue^Em, Uue, Uue, Ur^Br\, Ur^Br\, Uu, Uh, Xuc, Xuc, Xuc, Xuc, Xuc, Xuc, Xuc, Xuc, Xuc
Wwb, Wwb^Ii, Wwb, Wwb, Wwb, Wwb, Wwb, Wwb^Xo, Wwb^Xo, Wwb^Xo, Wwb, Yhl^Xp, Yhl^Xp, Xuc, Xuc, Yhl, Xuc, Xuc, Xuc, Xos, Xos, Xos, Xos, Xos, Xos, Xos, Xos, Uu^Br/, Xos, Xos, Yhl, Yhl^Xp, Uh, Uu^Vu, Urb, Urb^Em, Uue, Uue^Ii, Uhe, Uu^Es, Uu^Ii, Ur^Br\, Uh, Uh, Uu^Em, Xuc, Xuc, Xuc, Xuc, Xuc, Qxu, Xuc
Wwb, Wwb, Wwb, Wwb, Wwb, Wwb, Wwb, Wwb^Ii, Wwb, Yhl^Xp, Yhl^Xp, Xuc, Xuc, Yhl, Xuc, Xuc, Xuc, Xuc, Xuc, Xuc, Xuc, Xos, Xos, Xos, Xos, Xos, Xos, Xos, Yhl, Yhl^Xo, Xos, Uh, Xos, Uh, Urb, Uue^Em, Uue, Uhe^Ii, Xuce, Xuce, Xuc, Uu^Ii, Uu, Ur^Br\, 1 Ur^Br\, Uu, Uu, Xuc, Xuc, Qxu, Qxu, Xuc
Wwb, Wwb, Wwb, Wwb, Wwb, Wwb, Wwb, Yhl^Xp, Yhl^Xp, Xuc, Xuc, Yhl, Xuc, Xuc, Xuc, Xuc, Xuc, Xuc, Xuc, Xuc, Xuc, Xuc, Xuc, Xos, Xos, Xos, Yhl, Yhl, Xos, Qxe, Qxe, Xos, Qxe, Urb, Uue, Uue, Uhe, Uhe, Xuce, Xuce, Xuc, Xuc, Xuc, Uu, Uu, Ur^Br\, Ur^Br\, Uu, Uu, Qxu, Xuc, Xuc
Wwb, Wwb, Wwb, Wwb, Wwb, Yhl^Xp, Yhl^Xp, Xuc, Xuc, Yhl, Xuc, Xuc, Xuc, Xuc, Xuc, Xuc, Xuc, Xuc, Xuc, Xuc, Xuc, Xuc, Xuc, Xos, Xos, Yhl, Xos, Xos, Xos, Qxe, Qxe, Qxe, Qxe, Qxe, Qxe, Xos, Xos, Xuce, Xuce, Xuce, Xuce, Xuc, Xuc, Xuc, Xuc, Uu, Uu, Ur^Br\, Ur^Br\, Uu^Em, Uu^Em, Xuc
Wwb, Wwb, Wwb, Yhl^Xp, Yhl^Xp, Xuc, Xuc, Yhl, Xuc, Xuc, Xuc, Xuc, Xuc, Xuc, Xuc, Xuc, Xuc, Xuc, Xuc, Xuc, Xuc, Xuc, Xos, Xos, Xos, Xos, Qxe, Xos, Qxe, Qxe, Qxe, Xos, Xos, Qxe, Qxe, Xos, Xos, Xuce, Xuce, Xuce, Xuc, Xuc, Xuc, Xuc, Xuc, Xuc, Xuc, Uu, Ur^Es, Ur^Br\, Ur^Br\, Uu
Wwb, Yhl^Xp, Yhl^Xp, Xuc, Xuc, Yhl, Xuc, Xuc, Xuc, Xuc, Xuc, Xuc, Xuc, Xuc, Xuc, Xuc, Xuc, Xuc, Xuc, Xuc, Xos, Xos, Xos, Xos, Qxe, Qxe, Qxe, Qxe, Qxe, Qxe, Qxe, Xos, Xos, Qxe, Qxe, Xos, Xos, Xuce, Xuce, Xuce, Xuc, Xuc, Xuc, Xuc, Xuc, Xuc, Xuc, Qxu, Xuc, Uu^Ii, Uu, Ur^Br\
Xuc, Xuc, Xuc, Yhl, Xuc, Xuc, Xuc, Xuc, Xuc, Xuc, Xuc, Xuc, Xuc, Xuc, Xuc, Xuc, Xuc, Xuc, Xos, Xos, Xos, Xos, Qxe, Qxe, Qxe, Qxe, Qxe, Qxe, Qxe, Qxe, Qxe, Qxe, Qxe, Qxe, Qxe, Xos, Xos, Xos, Xuce, Xuce, Xuc, Xuc, Xos, Xuc, Xuc, Xuc, Xuc, Xuc, Xuc, Xuc, Xuc, Uu^Ii
