Xuc, Xuc, Xuc, Xuc, Xuc, Xuc, Xuc, Xuc, Xuc, Xuc, Xuc, Xuc, Xuc, Xuc, Xu, Yhl, Xu, Xu, Ss, Ss, Ss, Xuc, Xuc, Xuc, Xuc, Wog, Wog, Xuc, Xuc, Xuc, Xuc, Xuc, Xuc, Xuc, Xuc, Xuc, Xuc, Xuc, Xuc, Xuc, Xuc, Xuc, Xue, Xue, Wo^Ii, Wo^Ii, Wo^Ii, Xue, Xuc, Xuc, Xuc, Xuc, Xuc, Xuc
Xuc, Xuc, Xuc, Xuc, Xuc, Xuc, Xuc, Xuc, Xuc, Xuc, Xuc, Xuc, Xuc, Xuc, Xu, Yhl, Xu, Ss, Xuc, Ss, Ss, Xu, Xu, Xuc, Wog, Ss, Ss, Xuc, Xuc, Xuc, Xuc, Xuc, Xuc, Xuc, Xuc, Xuc, Xuc, Xuc, Xuc, Xuc, Xue, Xue, Uue, Wo^Ii, Wo^Ii, Wo^Ii, Xue, Xue, Xuc, Xuc, Xuc, Xuc, Xuc, Xuc
Xuc, Xuc, Xuc, Xuc, Xuc, Xuc, Xuc, Xuc, Xuc, Xuc, Xuc, Xuc, Xu, Xu, Xu, Yhl^Xp, Yhl^Xp, Ss, Ss, Ss, Xuc, Xu, Xu, Ss, Wog, Ss, Xuc, Xuc, Xuc, Xuc, Xuc, Xuc, Xuc, Xuc, Xuc, Xuc, Xuc, Xuc, Xuc, Xuc, Xue, Xue, Uue^Uf, Uue^Ii, Wo^Ii, Wo^Ii, Uu^Uf, Xue, Xuc, Xuc, Xuc, Xuc, Xuc, Xuc
Xuc, Xuc, Xu, Xuc, Xu, Xu, Xuc, Xuc, Xuc, Xuc, Xuc, Xuc, Xu, Ss, Ss, Xu, Xu, Yhl, Yhl^Xp, Xu, Xu, Xuc, Xuc, Wwg, Ss, Xuc, Xuc, Xom, Xom, Xuc, Xuc, Xuc, Xuc, Xuc, Xuc, Xuc, Xuc, Xuc, Xuc, Xom, Uue, Uue^Ii, Uue^Uf, Wo^Ii, Wo, Uue, Xue, Xuc, Xuc, Xuc, Xuc, Xuc, Xuc, Xuc
Xuc, Xuc, Xuc, Xu, Qxu, Xu, Xuc, Xuc, Xos, Xuc, Xuc, Xuc, Xu, Xu, Ss, Xu, Xu, Xu, Uh, Xu, Uue, Xuc, Uu^Em, Ss, Ss, Xuc, Ss, Ss, Ss, Xom, Xuc, Xuc, Xuc, Xuc, Xuc, Xuc, Xuc, Xuc, Xuc, Xom, Xom, Uue, Uue^Ii, Wo, Wo, Uue^Ii, Xuc, Xuc, Xuc, Xuc, Xuc, Xuc, Xuc, Xuc
Uu, Xuc, Xuc, Qxu, Qxu, Xom, Xom, Xom, Xuc, Xos, Xos, Xu, Xu, Yhl, Yhl^Xp, Xuc, Xuc, Uu^Es, Uh, Uu^Es, Uue^Em, Uue, Uh, Uu, Ss, Ss, Xuc, Ss, Ss, Xuc, Xuc, Xuc, Xuc, Xuc, Xuc, Xuc, Xuc, Xom, Xom, Xom, Wog, Wo, Wo, Wog, Xuc, Xuc, Xuc, Xuc, Xuc, Xuc, Xuc, Xuc, Xuc, Xuc
Ur^Br\, Uu, Uu, Qxu, Xom, Xom, Uh, Xuc, Xu, Xuc, Xuc, Xos, Xos, Xu, Yhl, Yhl^Es, Uu^Es, Xuc, Uu^Em, Uu, Uu, Uue, Uh, Uh, Uh, Xuc, Xuc, Xuc, Xuc, Xuc, Xuc, Xuc, Xuc, Xuc, Xuc, Xuc, Xuc, Xuc, Wo, Wo, Wo, Wo, Xom, Wog, Xom, Xuc, Xuc, Xuc, Xuc, Xuc, Xuc, Xuc, Xuc, Xuc
Uu, Ur^Br\, Ur^Br\, Uu^Em, Uu^Em, Xom, Uh, Xu, Xu, Xu, Xuc, Xuc, Xuc, Xos, Xuc, Xuc, Uu, Uu, Uu^Uf, 2 Uu, Uh, Xuc, Uh, Uu^Es, Yhl^Xp, Yhl^Xp, Yhl, Xuc, Xuc, Xuc, Xuc, Xuc, Xuc, Xuc, Xuc, Xuc, Xom, Wo, Wo, Wog, Xom, Xom, Xuc, Xom, Xuc, Xuc, Xuc, Xuc, Xuc, Xuc, Xuc, Xuc, Xuc, Xuc
Xuc, Uu, Ur^Es, Ur^Br\, Ur^Br\, Uu, Uu^Em, Uh, Xu, Uh, Uh, Uh, Xuc, Xos, Yhl, Yhl^Xp, Xuc, Uh, Uu^Em, Uu^Uf, Uu^Em, Xuc, Uu^Em, Uu, Xuc, Yhl^Xp, Xuc, Xuc, Xuc, Xuc, Xuc, Xuc, Xuc, Xuc, Xom, Xom, Wog, Wog, Wo, Wog, Xom, Xuc, Xuc, Xuc, Xuc, Xuc, Xuc, Xuc, Xuc, Xuc, Xuc, Xuc, Xuc, Xuc
Xuc, Qxu, Xuc, Uu^Ii, Uu, Ur^Br\, Ur^Br\, Uu^Ii, Uu^Ii, Uh, Uh, Xuc, Uh, Xos, Xos, Xuc, Xuc, Uu^Uf, Uh, Uu, Uu^Em, Uh, Uu^Uf, Uu^Uf, Yhl^Xp, Xuc, Xuc, Xuc, Xuc, Xuc, Xuc, Xuc, Xuc, Xom, Wog, Wog, Wog, Wog, Xuc, Xom, Xuc, Xuc, Xuc, Xuc, Xuc, Xuc, Xuc, Xuc, Xuc, Xuc, Xuc, Xuc, Xuc, Xuc
Xuc, Xuc, Xuc, Xuc, Xuc, Uu^Ii, Uu, Ur^Br\, Ur^Br\, Uu, Re^Es, Xuc, Uh, Xom, Xom, Xos, Xos, Xuc, Uh, Uu^Xo, Xuc, Xuc, Xuc, Yhl, Xuc, Xuc, Xuc, Xuc, Xos, Xos, Xos, Xuc, Xuc, Xuc, Wog, Wog, Xuc, Xuc, Xuc, Xuc, Xuc, Xuc, Xuc, Xuc, Xuc, Xuc, Xuc, Xuc, Xuc, Xuc, Xuc, Xuc, Xuc, Xuc
Xuc, Xuc, Xuc, Xuc, Qxu, Xuc, Qxu, Qxu, Uu^Es, Ur^Br\, Uu^Br\, Re^Em, Uu, Uh, Xuc, Xuc, Xuc, Xos, Xos^Efs, Uu, Xos, Xos, Xos, Xuc, Xuc, Xuc, Xos, Xos, Xos, Xos, Xos, Xos, Wog, Wog, Wog, Wog, Xuc, Xuc, Xuc, Xuc, Xuc, Xuc, Xuc, Xuc, Xuc, Xuc, Xuc, Xuc, Xuc, Xuc, Xuc, Xuc, Xuc, Xuc
Xuc, Xuc, Xuc, Xuc, Qxu, Qxu, Qxu, Qxu, Uh, Qxu, Uh, Uu^Br\, Rb, Uu^Uf, Uu^Em, Uh, Uh, Uu^Em, Ur^Es, Xos^Efs, Xos^Efs, Xuc, Xom, Xos, Xos, Xos, Xos, Xos, Xos, Xos, Wog, Wog, Wog, Wog, Xos, Xuc, Xuc, Xuc, Xuc, Xuc, Xuc, Xuc, Xuc, Xuc, Xuc, Xuc, Xuc, Xuc, Xuc, Xuc, Xuc, Xuc, Xuc, Xuc
Xuc, Xuc, Xuc, Xuc, Xuc, Qxu, Xuc, Xuc, Uhe, Uue, Re^Uf, Re^Es, Rb^Es, Uu, Uh, Uh, Uu^Uf, Uu, Ur, Uu, Uu, Xuc, Uh, Xom, Xos, Xos, Xos, Xos, Wog, Wog, Wog, Wog, Xos, Xos, Yhl, Xos, Xos, Xuc, Xuc, Xuc, Xuc, Xuc, Xuc, Xuc, Xuc, Xuc, Xuc, Xuc, Xuc, Xuc, Xuc, Xuc, Xuc, Xuc
Xuc, Xuc, Xuc, Xuc, Xuc, Xuc, Xuc, Xuc, Xuc, Uhe, Uue^Uf, Re^Uf, Re^Ii, Uh, Uh, Uh, Uu^Uf, Uh^Es, Ur, Uh, Uu^Ii, Uh, Xos, Xos, Xos, Xos, Wog, Wog, Wog, Wog, Xos, Xos, Yhl, Yhl, Yhl, Yhl, Yhl, Xos, Xos, Xuc, Xuc, Xuc, Xuc, Xuc, Xuc, Xuc, Xuc, Xuc, Xuc, Xuc, Xuc, Xuc, Xuc, Xuc
Xuc, Xuc, Xuc, Xuc, Xuc, Xuc, Xuc, Xuc, Xuc, Uhe, Xuc, Xuc, Uue, Uue, Xuc, Xuc, Xuc, Uu^Em, Ur^Es, Ur^Ii, Urb^Es, Uu, Xos, Xos, Wog^Xo, Wog, Wog, Wog, Xos, Xos, Xos, Yhl, Yhl, Yhl, Yhl, Yhl, Xos, Xos, Xos, Xos, Xos, Xuc, Xuc, Xuc, Xuc, Xuc, Xuc, Xuc, Xuc, Xuc, Xuc, Xuc, Xuc, Xuc
Xuc, Xuc, Xuc, Xuc, Xuc, Xuc, Xuc, Xuc, Xuc, Xuc, Xuc, Xuc, Xuc, Xuc, Xos, Xos, Uu, Uh^Ii, Urb, Ur, Urb, Urb, Wwrg, Wog, Wog, Wog^Xo, Xos, Xos, Xos, Xos, Xos, Yhl, Yhl, Yhl, Xos, Xos, Xos, Xos, Xos, Xos, Xos, Xos, Xos, Xuc, Xuc, Xuc, Xuc, Xuc, Xuc, Xuc, Xuc, Xuc, Xuc, Xuc
Xuc, Xuc, Xuc, Xuc, Xuc, Xuc, Xuc, Xuc, Xuc, Xuc, Xuc, Xuc, Xos, Xos, Xos, Xos, Uh, Urb, Urb, Urb, Urb, Urb^Ii, Wwg, Wog, Ss, Xos, Xos, Xos, Xos, Xos, Xos, Yhl, Yhl, Yhl, Xos, Xos, Xos, Xos, Xos, Xos, Xos, Xos, Xos, Xos, Xos, Xuc, Xuc, Xuc, Xuc, Xuc, Xuc, Xuc, Xuc, Xuc
Xuc, Xuc, Xuc, Xuc, Xuc, Xuc, Xuc, Xuc, Xuc, Xuc, Xos, Xos, Xos, Xos, Ss, Ss, Ss, Sm, Urb, Wwf, Urb^Ii, Wwg^Es, Wwg^Es, Wwrg, Xos, Xos, Xos, Xos, Xos, Xos, Yhl^Pr\, Yhl, Yhl, Yhl, Xos, Xos, Xos, Xos, Xos, Xos, Xos, Xos, Xos, Xos, Xos, Xos, Xos, Xuc, Xuc, Xuc, Xuc, Xuc, Xuc, Xuc
Xuc, Xuc, Xuc, Xuc, Xuc, Xuc, Xuc, Xuc, Xos, Xos, Xos, Xos, Xos, Xos, Ss, Ss, Ss, Sm, Wwrg, Wwf^Es, Urb, Wwf, Urb^Pr/, Urb^Pr/, Xos, Xos, Xos, Xu, Uhe, Xos, Yhl^Es, Yhl^Pr\, Yhl^Pr\, Yhl, Xos, Xos, Xos, Xos, Xos, Xos, Xos, Xos, Xos, Xos, Xos, Xos, Xos, Xos, Xos, Xuc, Xuc, Xuc, Xuc, Xuc
Xuc, Xuc, Xuc, Xuc, Xuc, Xuc, Xos, Xos, Xos, Xos, Xos, Xos, Xos, Xos, Xos, Sm, Xos, Sm, Wwg^Es, Wwg, Xos, Urb^Pr/, Urb, Urb, Xos, Xos, Xos, Xuc, Uhe, Yhr^Es, Yhr, Yhr, Yhl, Xos, Xos, Xos, Uh, Uh, Uh, Xos, Xos, Xos, Xos, Xos, Xos, Xos, Xos, Xos, Xos, Xos, Xos, Xuc, Xuc, Xuc
Xuc, Xuc, Xuc, Xuc, Xos, Xos, Xos, Xos, Xos, Xos, Xos, Xos, Xos, Xos, Xos, Xos, Wog, Wog, Wwg, Wwg, Xos, Urb, Urb, Urb, Xos, Xos, Xu, Xos, Uue^Es, Uue^Es, 3 Uue, Yhl, Xuc, Xos, Xos, Uh, Uu^Uf, Uu^Uf, Uu^Uf, Uh, Xos, Xos, Xos, Xos, Xos, Xos, Xos, Xos, Xos, Xos, Xos, Xos, Xos, Xuc
Xuc, Xuc, Xuc, Xos, Xos, Xos, Xos, Xos, Xos, Xos, Xos, Xos, Xos, Xos, Wog, Wog^Xo, Wog^Xo, Wog, Xos, Xos, Xos, Urb, Cud, Cud, Urb, Xos^Efs, Xos^Efs, Uhe, Uhe, Yhr, Uue^Es, Yhr, Xuc, Xos, Xos, Uh, Yhr, Yhr, Uu^Uf, Uh, Xos, Xos, Xos, Xos, Xos, Xos, Xos, Xos, Xos, Xos, Xos, Xos, Xos, Xos
Xuc, Xuc, Xuc, Xuc, Xuc, Xos, Xos, Xos, Xos, Xos, Xos, Xos, Wog, Wog, Wog, Wog, Xos, Xos, Xos, Xos, Xos, Cud, Urb, Urb, Urb, Rb, Rb, Xos^Efs, Xos^Efs, Uue, Xu, Uue, Xos, Xos, Xos, Uu^Ii, Yhr, Yhr, Uh, Uh, Xos, Xos, Xos, Xos, Uh, Uh, Xos, Xos, Xos, Xos, Xos, Xos, Xuc, Xuc
Xuc, Xuc, Xuc, Xuc, Xuc, Xuc, Xuc, Xos, Xos, Xos, Xos, Wog, Wog, Wog, Xos, Xos, Xos, Xos, Xos, Xos, Xos, Xos, Xos, Urb, Rb, Urb, Rb, Rb^Es, Rb^Em, Xos^Efs, Xos, Xos, Xos, Xos, Xos^Uov, Xos^Uov, Xos, Uu^Uf, Xos, Xos, Xos, Xos, Uhe, Uh, Xos, Xos, Xos, Xos, Xos, Xos, Xuc, Xuc, Xuc, Xuc
Xuc, Xuc, Xuc, Xuc, Xuc, Xuc, Xuc, Xuc, Xuc, Xos, Xos, Wog, Wog, Xos, Xos, Xos, Xos, Xos, Xos, Xos, Xos, Xos, Xos, Xos, Xos, Rb, Urb, Rb, Rb, Xos, Xos, Xos, Xos^Uov, Xos^Uov, Xos, Xos, Xos, Xos, Xos, Xos, Uhe, Uhe^Xo, Xos, Xos, Xos, Xos, Xos, Xos, Xuc, Xuc, Xuc, Xuc, Yhr, Yhr
Xuc, Xuc, Xuc, Xuc, Xuc, Xuc, Xuc, Xuc, Xuc, Xuc, Xuc, Wog, Wog, Wog, Xos, Xos, Xos, Xos, Xos, Xos, Xos, Xos, Xos, Xos, Xos, Xos, Rb, Rb^Em, Rb, Xos, Xos, Xos^Uov, Xos^Uov, Xos, Ur^Br\, Xos, Xos, Xos, Xos, Qxe, Uue^Uf, Uhe, Yhl, Xos, Xos, Xos, Uue, Xuc, Xuc, Xuc, Yhr, Yhr, Xuc, Xuc
Xuc, Xuc, Xuc, Xuc, Xuc, Xuc, Xuc, Xuc, Xuc, Xuc, Xuc, Xuc, Wog, Wog, Xos, Xos, Xos, Xos, Xos, Xos, Xos, Xos, Xos, Xos, Yhr^Xo, Yhr^Xp, Urb, Rb^Es, Re^Uf, Xos, Xos^Uov, Xos^Uov, Xos, Xos, Xos, Uh^Xo, Ur^Br\, Xos, Uh, Qxe, Uue^Uf, Uhe, Yhl, Xos, Uhe, Uue^Xo, Xos, Xuc, Xuc, Yhr, Xuc, Xuc, Xuc, Xuc
Xos, Xuc, Xos, Xuc, Xuc, Xuc, Xuc, Xuc, Xuc, Xuc, Xuc, Xuc, Wog, Wog, Xos, Xos, Xos, Xos, Xos, Xos, Xos, Xos, Xos, Yhr, Xos, Xos, Urb, Uh, Uh, Xos^Uov, Xos, Xos, Yhr, Yhr, Yhr, Xos, Uh, Ur, Ur, Uue^Emf, Qxe, Qxe, Ur^Br/, Ur^Br/, Uhe, Xos, Xos, Xuc, Xuc, Yhr, Xuc, Xuc, Xuc, Xu
Wwb, Xos, Xos, Xos, Xos, Xos, Xos, Xuc, Xuc, Xuc, Xuc, Xuc, Wog, Wog, Xos, Xos, Xos, Xos, Xos, Xos, Xos, Xos, Xos, Xos, Yhr^Xo, Yhr^Xp, Urb^Uf, Uh, Ur, Xos, Xos, Yhr, Yhr^Xp, Yhr^Xp, Uh, Uh, Uu, Uu^Uf, Uu^Br/, Ur^Br\, Ur^Br/, Qxe, Uue, Uue, Qxe, Xos, Xos, Xuc, Xuc, Yhr^Xo, Xuc, Xuc, Xuc, Xuc
Xos, Wwb, Wwb, Xos, Yhl, Yhl^Xp, Yhl^Xp, Xos, Xos, Xuc, Wog, Wog, Wog, Wog, Xos, Xos, Xos, Xos, Xos, Xos, Xos, Xos, Xos, Yhr, Xos, Xos, Uue^Uf, Urb, Ur, Uh, Uh, Xos, Uh, Uu^Uf, Uu, Rb, Ur, Ur^Br/, Urb, Uu^Uf, Urb^Br|, Uue, Uue, Uue, Xos, Xos, Xos, Xuc, Xuc, Yhr^Xp, Uue, Xuc, Xuc, Xuc
Wwb, Xos, Xos, Wwb, Wwb, Xos, Xos, Xos, Wog, Wwg, Wog, Wog, Xuc, Xuc, Xos, Xos, Xos, Xos, Xos, Xos, Xos, Xos, Xos, Xos, Yhr^Xo, Yhr^Xp, Uhe, Uue, Urb, Uh, Urb^Em, Uu, Uu, Uu, Ur, Ur^Br/, Uu^Em, Uh, Xos, Urb, Uu, Uue, Xos, Xos, Xos, Xos, Qxe, Xuc, Uue^Uf, Uue, Uhe, Xuc, Xuc, Xuc
Xos, Wwb, Wwb, Xos, Xos, Wwb^Pr/, Wwg, Wog, Wwg, Wwg, Xos, Xos, Xuc, Xuc, Xuc, Xos, Xos, Xos, Xos, Xos, Xos, Xos, Xos, Yhr, Xos, Xos, Uhe, Uue, Uue, Urb, Ur, Ur, Ur^Br\, Ur^Br/, Uu, Uu^Em, Uu^Es, Xos, Xos, Uu, Ur, Re, Xos, Xos, Xos, Qxe, Qxe, Uhe, Uue^Uf, Uhe, Uue, Xuc, Xuc, Xuc
Wwb, Xos, Xos, Wwb^Pr/, Wwb, Wwg, Wwg, Wwg, Wwb^Pr/, Xos, Xos, Xos, Xos, Xuc, Xuc, Xuc, Xuc, Xos, Xos, Xos, Xos, Xos, Xos, Xos, Qxe, Qxe, Qxe, Qxe, Uue^Uf, Uue, Uue, Uhe, Uu, Uu^Br|, Uh, Uh, Yhr^Xp, Xos, Xos, Urb, Cud, Cud, Xos, Xos, Xos, Qxe, Qxe, Uue^Uf, Uue, Uue, Qxe, Qxe, Xuc, Xuc
Xos, Wwb^Pr/, Wwb, Wwb, Wwg, Wwg, Wwb^Pr/, Xos, Xos, Wwb, Wwb, Xos, Xos, Xuc, Xuc, Xuc, Xuc, Xuc, Xuc, Xos, Xos, Xos, Xos, Xos, Qxe, Qxe, Qxe, Qxe, Xos, Uue^Emf, Xos, Xos, Yhl^Br/, Yhl^Xp, Yhl, Yhr^Xp, Xos, Xos, Xos, Cud, Ur, Urb, Xos^Efs, Xos, Xos, Xos, Xos^Efs, Uue, Urb, Uue^Uf, Qxe, Qxe, Xos, Xos
Wwb, Wwb, Wwb, Wwb, Wwb^Pr/, Xos, Xos, Wwb, Wwb, Xos, Xos, Wwb, Wwb, Xos, Xos, Xuc, Xuc, Xuc, Xuc, Xuc, Xuc, Xos, Xos, Qxe, Qxe, Qxe, Qxe, Qxe, Xos, Xos, Xos, Yhl^Xp, Yhl^Br|, Yhl, Xos, Xos, Xos, Xos, Rb, Urb, Urb, Ur, Rb^Es, Xos^Efs, Xos, Xos^Efs, Uu, Urb, Ur^Em, Uue, Xos, Xos, Xos, Xos
Wwb, Wwb, Xos, Xos, Yhl^Xp, Wwb, Wwb, Xos, Xos, Wwb, Wwb, Xos, Wwb, Xos, Xos, Xuc, Xuc, Xuc, Xuc, Xuc, Xuc, Xuc, Xuc, Xos, Xos, Qxe, Xos, Xos, Yhl, Xos, Yhl^Xo, Yhl^Br/, Xos, Xos, Xos, Xos, Xos, Xos, Urb^Es, Urb, Urb, Ur, Rb, Rb, Urb, Rb, Uu, Uu, Urb^Em, Xos, Xos, Xos, Xos, Xos
Xos, Xos, Xos, Yhl^Xp, Xos, Xos, Yhl^Xp, Wwb, Wwb, Xos, Wwb, Xos, Wwb, Xos, Xuc, Xuc, Xuc, Xuc, Xuc, Xuc, Xuc, Xuc, Xuc, Xuc, Xuc, Xos, Xos, Xos, Yhl, Yhl, Xos, Xos, Xos, Xos, Yhl^Xp, Xos, Uue^Em, Uue^Es, Uue^Uf, Uue, Uu^Uf, Re, Re^Es, Urb, Urb, Rb, Urb, Ur^Es, Urb, Xos^Efs, Xos^Efs, Xos, Xos, Xos
Xos, Xos, Xos, Xos, Xos, Yhl^Xp, Xos, Xos, Wwb, Xos, Wwb, Xos, Wwb, Xos, Xos, Xuc, Xuc, Xuc, Xuc, Xuc, Xuc, Xuc, Xuc, Xuc, Xuc, Xuc, Xuc, Yhl, Xos, Xos, Xos, Xos, Yhl, Yhl^Xo, Xos, Uh, Uue, Uhe^Em, Uue^Uf, Uue, Uu^Emf, Uu, Re^Em, Uu, Urb, 1 Urb, Urb, Urb, Rr, Urb, Urb, Xos, Xos^Efs, Xos
Xos, Xos, Xos, Xos, Xos, Xos, Xos, Xos, Wwb, Xos, Wwb, Xos, Xos, Wwb, Wwb, Xos, Xuc, Xuc, Xuc, Xuc, Xuc, Xuc, Xuc, Xuc, Xuc, Xuc, Xuc, Yhl, Xuc, Xos, Xos, Yhl, Xos, Xos, Xos, Xos, Uhe, Uue^Uf, Uhe, Uue^Em, Uue^Es, Uu^Es, Uu, Uu^Em, Uu, Uu, Uu, Urb, Urb, Rd, Rd, Urb, Urb, Xos^Efs
Xos, Xos, Xos, Xos, Xos, Xos, Xos, Xos, Wwb, Xos, Xos, Wwb, Wwb, Xos, Wwb, Xos, Xuc, Xuc, Xuc, Xuc, Xuc, Xuc, Xuc, Xuc, Xuc, Xuc, Yhl, Yhl, Xuc, Xuc, Xuc, Xos, Xos, Xos, Yhr^Xo, Yhr^Xp, Xos, Xos, Qxe, Qxe, Qxe, Uu^Em, Uu^Em, Uu^Es, Uh, Uu, Uu^Uf, Uu, Xos, Urb, Urb, Rr, Rd, Urb
Xos, Xos, Xos, Xos, Xos, Xos, Xos, Xos, Xos, Wwb, Xos, Xos, Wwb, Xos, Wwb, Xos, Xuc, Xuc, Xuc, Xuc, Xuc, Xuc, Xuc, Xuc, Yhl, Yhl, Xuc, Xuc, Xuc, Xuc, Xuc, Xuc, Xuc, Yhr, Xos, Xos, Xos, Qxe, Qxe, Qxe, Qxe, Qxe, Uu^Uf, Uu^Uf, Uu, Uh, Uu, Uh, Xos, Xos, Xos, Urb, Urb, Rr
