Qxe, Dd, Hd, Md, Md, Md, Hhd, Md^Xm, Uzw, Uhe, Uhe, Uue, Qxe, Yhs, Hd, Hd, Hd, Hd, Hd, Hd, Hd, Hd, Hd, Dd, Rr, Ds, Hd, Ds, Ds, Hd, Md, Md, Hhd, Md^Xm, Md^Xm, Hhd, Hhd, Md^Xm
Dd, Qxe, Qxe, Hhd, Md, Hhd, Hd, Ds, Uzw, Yhs, Yhs^Yva, Uue, Qxe, Hd, Dd, Hd, Co, Dd, Dd^Vda, Hd, Dd, Dd, Dd, Dd^Vda, Rr, Ds, Ds, Ds^Dr, Rb, Ds, Ds, Hd, Md, Md^Xm, Hhd, Md, Hhd, Md
Co, Dd, Hd, Qxe, Md, Md^Xm, Qxe, Qxe, Qxe, Qxe, Qxe, Qxe, Hd, Dd, Co, Co, Dd, Rr, Rr, Dd, Co, Co, Co, Rr, Rr^Esd, Dd^Vdt, Ds, Ds, Dd, Rb, Ds, Ds, Hd, Hhd, Md, Md^Xm, Uhe, Hhd
Dd, Hd, Hhd, Md, Hhd, Md, Hd, Dd^Es, Dd, Dd, Dd, Hd, Ds, Ds^Edpp, Ds, Dd, Co, Co, Co, Co, Co, 4 Ko, Co, Rr, Rr, Ds, Dd, Co, Co, Dd, Hd, Hd, Uhe, Md, Uhe, Uue, Uue, Md
Dd, Hd, Md, Md, Hd, Hd, Co, Dd, Rr, Co, Co, Dd, Dd, Ds, Ds, Dd, Dd, Dd, Dd, Rr, Rr, Co, Rd, Co, Co, Co, Rr, Dd, Co, Dd, Hd, Uzw, Uue, Yhs, Qxe, Uhe, Yhs, Md
Hd, Hd, Dd, Dd^Es, Dd^Dr, Dd, Dd, Co, Rr, Rr, Dd, Ds, Co, Dd^Edpp, Ds, Dd^Vdt, Rd^Esd, Dd, Dd^Vda, Rr, Rr, Ds, Ds, Ds, Dd, Dd, Dd, Rr, Rr, Dd, Ds, Uzw, Uzw, Uue, Qxe, Yhs, Uhe, Hd
Mdd, Hd, Hd, Dd, Hd, Hd, Dd, Dd, Rr^Esd, Dd, Dd, Ds, Co, Dd, Dd, Dd, Dd, Rd, Rr, Rr, Dd, Dd^Vdt, Ds, Ds^Es, Dd, Dd^Vda, Dd, Dd, Dd, Rd^Esd, Rd, Ds^Es, Qxe, Qxe, Dd, Uzw, Dd, Dd
Mdd, Mdd, Hd, Dd, Dd, Dd, Ds, Rr, Ds, Dd, Dd, Dd, Dd, Co, Co, Ds, Co, Dd, Dd, Dd, Co, Dd, Ds, Ds, Co, Dd, Dd, Dd, Dd, Dd^Es, Dd, Rd, Ds, Dd, Dd, Dd, Dd, Dd
Hd, Mdd, Mdd, Hd, Hd, Ds, Ds, Re, Ds, Hd, Hd, Dd, Ds, Dd, Dd, Ds, Ds, Co, Co, Rr, Rr, Co, Ds, Co, Ds, Hd, Co, Co, Dd, Dd^Es, Co, Rd^Esd, Ds, Ds, Co, Ds, Ds, Dd
Hd, Hd, Mdd, Mdd, Hd, Yhs^Yva, Yhs^Xp, Ds, Ds, Hd, Dd, Yhs, Yhs^Xp, Ds, Dd^Es, Yhs, Ds, Dd, Dd, Rd, Rd^Esd, Dd, Ds, Ds, Ds, Ds, Dd, Dd, Dd, Co, Re, Re, Co, Co, Dd, Re, Co, Dd
Hd, Hd, Yhs, Mdd, Uue^Tf, Uue, Qxe, Yhs^Xp, Qxe, Dd, Dd, Dd, Dd, Dd, Dd^Es, Dd, Dd^Vdt, Dd, Dd, Dd, Ds, Ds, Yhs^Xp, Yhs, Rd, Rd^Esd, Ds, Hd, Dd, Ds, Re, Ds, Dd, Dd, Dd, Re, Ds, Co
Mdd, Uue, Yhs^Yva, Yhs^Xp, Yhs, Uue, Uhe, Qxe, Uzw, Qxe, Qxe, Dd, Dd, Ds^Es, Ds, Ds, Ds, Dd, Ds^Es, Rd^Esd, Ds^Es, Ds^Es, Yhs, Rd^Esd, Rd, Ds^Esd, Dd, Qxe, Qxe, Dd, Dd, Ds, Hd, Dd, Dd^Edpp, Ds, Dd^Es, Dd
Mdd, Uue, Uzw, Yhs^Yva, Yhs^Xp, Yhs^Xp, Uzw, Uzw, Uzw, Uhe, Uhe, Dd, Dd, Dd, Hd, Yhs, Ds, Ds, Ds, Ds, Ds, Ds, Ds, Rd, Ds, Dd, Dd, Dd, Qxe, Qxe, Qxe, Hd, Dd, Dd, Dd, Rd^Esd, Rd, Re^Esd
Mdd, Mdd, Mdd, Uzw, Uue, Yhs, Uue^Tf, Uzw, Dd, Ds, Ds, Dd, Rd^Esd, Dd, Qxe, Hd, Dd, Yhs, Yhs^Xp, Yhs, Ds, Ds, Dd, Ds^Es, Ds, Ds, Dd, Qxe, Yhs^Yva, Yhs, Qxe, Ds, Ds, Hd, Hd, Rd, Rd, Re
Hd, Mdd, Mdd, Uhe, Yhs^Xp, Uue^Tf, Uhe, Uhe, Hd, Ds, Dd^Edp, Dd, Dd, Dd, Qxe, Dd, Hd, Dd, Yhs, Yhs^Yva, Ds, Dd^Vdt, Dd, Rd^Esd, Dd, Dd, Dd, Qxe, Yhs^Xp, Yhs^Xp, Ds, Qxe, Dd, Ds, Hd, Hd, Hd, Rd
Hd, Hd, Yhs, Yhs^Xp, Hd, Uue, Hd, Uhe, Mdd, Hd, Ds, Dd^Vdr, Dd, Qxe, Qxe, Dd, Hd, Dd, Ds, Ds, Dd, Dd, Dd, Rd, Qxe, Dd, Dd, Re^Esd, Rd, Rd, Dd^Es, Hd, Dd, Hd, Dd^Edpp, Hd, Hd, Hd
Ds, Ds, Uue, Uue^Tf, Dd, Dd, Hd, Hd, Dd, Dd, Ds, Dd, Dd, Qxe, Dd, Dd, Dd, Hd, Dd, Rd^Esd, Rd, Re, Dd, Dd, Qxe, Dd, Dd, Re, Rd, Rd^Esd, Dd, Dd, Qxe, Qxe, Yhs^Xp, Dd^Dr, Hd, Dd
Ds, Ds, Dd, Dd, Ds, Dd, Dd, Hd, Dd, Dd, Ds, Hd, Dd, Dd, Dd, Dd^Vdt, Dd, Dd^Edp, Rd, Dd, Re, Re, Rd, Qxe, Dd, Dd, Ds, Dd, Hd, Rd^Esd, Rd^Qhh, Dd, Qxe, Yhs, Re^Esd, Yhs^Yva, Uzw, Dd
Cdr, Dd, Hd, Dd, Ds, Dd, Dd, Dd, Ds, Dd^Dr, Ds^Es, Dd, Dd, Dd, Rd, Rd, Dd, Rd^Esd, Rd, Rd, Re, Rd, Rd^Esd, Dd, Dd^Vdr, Dd, Dd, Dd, Hd, Rd^Qhh, Ds, Hd, Qxe, Rd, Re, Yhs^Xp, Uzw, Uzw
Cdr, Hd, Hd, Dd, Dd, Dd, Ds, Ds^Es, Rd, Ds, Ds, Hd, Mdd, Dd, Cdr, Rd, Dd, Rd^Esd, Dd, Rd, Rd, Rd^Esd, Cdr, Dd, Dd, Dd, Dd, Cdr, Hd, Ds^Qhh, Ds^Dr, Qxe, Dd, Rd, Rd, Re, Rd, Uzw
Dd, Hd, Kdr, Dd, Cdr, Cdr, Cdr, Ds^Es, Rd, Rd^Esd, Ds, Hd, Hd, Dd, Hd, Cdr, Dd, Hd, Dd, Dd, Dd^Edp, Dd, Hd^Qhh, Dd^Qhh, Hd, Ds, Dd, Dd, Rd, Rd^Qhh, Dd^Es, Dd, Dd, Rd^Esd, Dd^Es, Rd^Esd, Dd, Dd
Mdd, Hd, Mdd, Mdd, Hd, Qxe, Qxe, Ds, Ds, Ds, Dd, Dd, Dd^Vdt, Dd, Dd, Cdr, Dd, Dd, Rr^Esd, Rd, Dd, Hd, Dd^Qhh, Ds, Dd, Hd, Dd, Dd^Es, Rd, Rd^Qhh, Rd^Esd, Dd^Edp, Rd^Esd, Rd, Ds, Dd^Dr, Re^Esd, Re
Hd, Hd, Mdd, Mdd, Hd, Qxe, Hd, Dd^Edp, Hd, Hd, Cdr, Dd, Dd, Dd, Dd, Hd, Ds, Rd^Esd, Re, Ds, Dd, Dd^Edp, Dd^Qhh, Dd, Hd, Dd, Dd^Vdt, Rd^Esd, Rd^Esd, Ds^Qhh, Dd^Qhh, Ds, Ds, Ds, Dd, Dd^Es, Re, Re^_mh
Hd, Hd, Mdd, Hd, Mdd, Qxe, Dd, Hd, Dd^Edp, Dd, Hd, Dd, Ds, Rd^Esd, Dd, Dd, Rd, Rd, Rr, Rd^Esd, Cdr, Dd^Qhh, Dd, Hd, Hd, Hd, Rd^Esd, Rd, Dd^Qhh, Dd^Qhh, Hd, Ds, Dd, Hd, Dd, Re, Hd, Hd
Hd, Hd, Hd, Mdd, Qxe, Qxe, Dd, Dd, Dd^Edp, Dd, Dd, Hd, Rd^Esd, Rd, Rd, Dd^Es, Dd^Edp, Dd, Rr^Esd, Rd, Dd, Dd, Ds, Ds, Rd, Dd, Dd, Hd^Qhh, Hd^Qhh, Hd, Hhd, Dd, Md, Hd, Hd, Dd, Hd, Dd
Hhd, Hd, Hd, Qxe, Dd, Dd^Dr, Dd, Ds, Dd, Dd, Dd, Dd, Rd, Rd, Dd, Dd^Dr, Rd, Dd^Vdt, Rr, Dd, Dd^Vdr, Dd, Ds, Rd^Esd, Ds^Edpp, Dd, Dd, Hd^Qhh, Hd, Hd, Md, Md, Md^Xm, Dd, Hd, Hd, Hhd, Hhd
Md, Hhd, Hd, Dd, Dd, Ds, Dd^Vdr, Dd, Hd, Hd, Hd, Dd^Vdt, Dd, Dd, Dd^Dr, Dd, Cdr, Dd, Cdr, Dd, Rd^Esd, Rd^Esd, Dd^Dr, Ds, Ds, Dd, Dd, Dd^Qhh, Md, Md, Hd, Md, Md, Md, Hd, Hhd, Md^Xm, Md^Xm
Md^Xm, Md, Hhd, Hd, Hd, Dd, Hd, Hd, Hd, Md, Hd, Hd, Cdr, Dd, Dd^Dr, Dd^Dr, Dd, Cdr, 1 Ke, Cdr, Dd, Dd^Dr, Dd, Ds, Dd, Dd, Hd, Hd, Hd, Hd, Md^Xm, Md, Md, Hd, Hd, Hd, Md^Xm, Md^Xm
Md, Md^Xm, Md, Md, Cdr, Md, Hd, Hd, Hd, Md, Hhd, Hd, Hd^Qhu, Dd, Dd^Dr, Dd^Vdr, Rd, Cdr, Cdr, Cdr, Dd, Dd^Vdt, Dd, Dd, Hd, Dd^Edpp, Dd, Hd, Hd, Md, Md^Xm, Md^Xm, Hhd, Hhd, Md, Hhd, Md, Md^Xm
Hhd, Hhd, Md, Hd, Hd, Kdr, Hd, Hhd, Md, Hhd, Cdr, Hd, Dd^Qhu, Dd, Rd^Esd, Rd, Dd, Cdr, Rd, Dd, Dd^Dr, Dd, Dd, Dd, Hd, Dd, Dd, Hd, Hd, Md, Hhd, Md, Md, Md, Md^Xm, Md, Md, Md
Hd, Hd, Hhd, Hd, Hd, Md, Hhd, Hhd, Md, Cdr, Hd, Hd^Qhu, Hd, Dd^Dr, Rd, Rd^Esd, Dd^Vdt, Rr, Rr, Dd^Dr, Dd, Cdr, Hd, Hd, Md, Dd, Dd, Hd, Md, Hd, Md, Hd, Hd, Md, Md, Md, Hd, Hd
Hd^Qhu, Hd^Qhu, Hhd^Qhu, Md, Hd, Md, Md, Md, Cdr, Cdr, Hd, Hd^Qhu, Dd, Dd, Dd, Dd, Rd, Rr, Dd, Dd, Dd, Hd^Qhh, Hhd, Md, Md, Md, Hd, Hd, Hd, Hd, Hd, Hd, Hhd, Hhd, Hd, Hd, Hd, Hd
Dd, Dd, Hd, Hd^Qhu, Hd^Qhu, Hd, Hhd, Cdr, Hd, Hd, Hhd^Qhu, Hd^Qhu, Dd, Rd^Esd, Rd^Esd, Dd, Dd, Dd, Dd, Dd^Vdt, Hd, Hd^Qhh, Md, Md, Md, Hhd, Dd, Hd, Hd, Hd, Dd, Hd, Hd, Md, Md, Md^Xm, Hd, Hd
Dd, Dd, Dd, Dd^Dr, Hd^Qhu, Hd, Hhd^Qhu, Hd, Hd^Qhu, Dd, Dd^Qhu, Dd, Dd, Dd^Vdt, Rr, Rr, Hd, Hd, Hd, Hd, Hd^Qhh, Md^Qhh, Hhd, Rb, Hhd, Hhd, Hd, Kdr, Dd^Dr, Hd, Dd, Dd, Hd, Hd, Hd, Hd, Hd, Hd
Hd, Dd^Edp, Dd, Ds^Es, Rb^Es, Dd^Qhu, Hd, Hd^Qhu, Dd, Dd^Qhu, Rd^Esd, Rd^Esd, Dd, Rd, Rr, Re, Dd, Dd, Dd, Dd^Qhh, Dd^Qhh, Cdr, Md, Rb, Rd, Rb, Cdr, Cdr, Hd, Hd, Hd, Dd, Hd, Hd, Hd, Hd, Md^Xm, Md
Hd, Hd, Ds, Ds, Rb^Es, Rb, Rb, Hd, Dd, Dd^Dr, Rd, Rd, Hd, Dd, Rd^Esd, Dd, Rd, Dd^Es, Dd^Edpp, Dd, Dd^Qhh, Hd, Hd, Hhd, Rd, Rd, Hd, Hd, Hd, Dd, Hd, Md, Hd, Hd, Hd, Hd, Md^Xm, Md
Dd, Dd, Hd, Rb, Uzw, Uzw, Rb, Uzw, Hd, Rb, Rb, Rd, Dd, Dd, Dd, Dd, Re^Esd, Dd, Dd, Dd, Dd, Dd^Qhh, Dd^Qhh, Dd, Hd, Hd, Dd^Qhh, Hd^Qhh, Dd^Qhh, Rd, Hd, Hd, Dd, Md, Md, Md^Xm, Md^Xm, Md^Xm
Hd, Hd, Cdr, Hd, Rb, Rb^Es, Rb, Rb, Dd^Es, Uzw, Rb, Rb, Uzw^Es, Uzw^Es, Uzw, Dd, Re^Esd, Dd, Dd, Dd^Vdt, Dd, Dd^Qhh, Uzw, Hd^Qhh, Hd^Qhh, Dd^Qhh, Dd^Edpp, Dd^Dr, Dd, Dd^Qhh, Dd^Qhh, Dd, Hd, Md, Md, Mv, Md, Md
Hhd, Hd, Hhd, Ds, Ds, Ds, Ds^Es, Dd, Re^Es, Ds, Ds, Rb, Rb, Rb, Re, Re, Dd, Dd, Uzw, Dd, Dd, Rb^Esd, Rb, Dd, Rb, Dd, Dd^Edp, Dd, Hd, Cdr, Hhd, Rb, Hd, Hd, Md, Md, Md, Md
Md, Md, Hd, Hd, Md, Dd, Ds^Edp, Dd^Es, Ds, Ds, Ds^Es, Rd, Cdr, Dd^Es, Dd, Dd^Vdt, Rb, Dd^Dr, Rb, Uzw, Uzw, Uzw^Es, Rb, Rb, Dd, Dd, Dd^Es, Dd^Vdr, Hd, Cdr, Hhd, Rb, Rd, Hd, Hd, Md, Hd, Md
Md, Md, Md, Hd, Hd, Hd, Ds, Ds, Rd^Vct, Rd, Ds, Re, Ds, Re, Dd, Dd, Dd^Edp, Rb, Ds, Rb^Es, Rb^Es, Uzw, Rb, Rd^Esd, Rd, Rb^Es, Uzw^Es, Hd, Hd, Hd, Hd, Hd, Hd, Hd, Hd, Hd, Hd, Md
Hd, Hhd, Hd, Hd, Hd, Hhd, Ce, Ds, Ds, Re, Rd, Ds^Es, Re, Rr, Dd^Edpp, Dd, Rd^Esd, Ds, Ds, Rb, Ds, Rb, Dd, Rd, Rd, Rb, Rb^Es, Uzw, Hd, Hd, Dd, Hd, Dd^Vdt, Hd, Hd, Hd, Hhd, Hd
Hd, Cdr, Hd, Dd, Dd, Ce, 3 Ke, Ce, Ds, Re^Esd, Rr, Rr, Cdr, Dd, Dd, Dd, Rd, Dd, Ds, Ds, Ds, Ds^Es, Ds, Dd^Vdt, Dd, Rb^Es, Hd, Uzw, Dd, Dd^Edp, Dd, Dd, Dd, Dd, Ce, Ce, Ce, Md
Cdr, Cdr, Hd, Dd^Vct, Hd, Hhd, Ce, Ce, Hd, Re, Rd, Hd, Dd, Dd, Dd, Hd, Rd^Esd, Dd, Dd, Dd^Edpp, Dd, Rd^Esd, Rd, Dd, Rd^Esd, Rd^Es, Dd, Hd, Rb^Esd, Dd, Rb^Esd, Rb, Re^Vct, Dd, Ce, 2 Ke, Hhd, Hhd
Hhd, Hhd, Md, Hd, Md, Hd, Hhd, Hd, Dd, Rd^Vct, Hd, Hd, Hd, Hd, Dd, Hd, Dd, Rd, Dd, Dd, Hhd, Rd, Rd, Hhd, Hhd, Rd, Dd, Dd^Edpp, Rb, Rb, Uzw, Uzw, Rb, Dd, Dd, Ce, Hd, Hhd
Hhd, Md, Md^Xm, Hhd, Md, Hhd, Md, Hd, Rr, Rd, Hhd, Hd, Hd, Hd, Hd, Hd, Hd, Hd, Cdr, Hhd, Md, Md, Md, Hhd, Hhd, Hhd, Dd, Dd, Dd, Dd, Dd, Uzw, Uzw, Re^Vct, Uzw, Dd, Hd, Dd
Md, Md, Hhd, Md^Xm, Md^Xm, Md, Md, Rr, Hhd, Hhd, Hhd, Hd, Hd, Hd, Hd, Hd, Hd, Hd, Cdr, Hhd, Hhd, Md, Md, Hhd, Md, Hhd, Cdr, Dd, Hhd, Dd, Dd, Uzw, Dd, Rb, Rb^Esd, Dd, Uzw, Dd
Hhd, Hhd, Hhd, Md, Md, Md, Rr, Rr, Md, Md, Md^_ml, Md, Hhd, Hd, Hd, Hd, Dd, Hd, Hhd, Cdr, Kdr, Md, Md, Md, Md, Md, Hhd, Hhd, Hhd, Hhd, Hd, Hd, Hd, Hd, Dd, Rb, Uzw, Uzw
