border_size=1
usage=map

Hd, Dd, Ds, Dd, Uzw, Dd, Dd, Dd, Dd, Cud, Cud, Qxv, Cud, Yhs, Yhs, Uzw, Uzw, Dd, Dd, Dd, Uzw, Hd, Dd, Hd^Xo, Dd^Xo, Xv, Xv, Xv, Xos, Xos, Xos, Xos, Xos, Xos, Xos, Xos, Xos, Xos, Ss, Ss, Ss, Ss, Ss, Ss, Ss, Ss, Xos, Xos, Xos, Xos, Ss, Xos, Xos, Xos, Xos, Xos, Ss, Xos, Xos, Xos, Ss, Ss, Xos, Xos, Xos, Ss, Ss, Ss, Xos, Xos, Xos, Xos, Ss, Ss, Xos, Xos, Xos, Xos
Hd, Hd, Yhs, Ds, Ds, Dd, Uzw, Dd, Dd, Hd, Dd, Qxv, Yhs, Yhs, Dd, Dd, Dd, Dd, Uzw, Uzw, Yhs, Uzw, Dd, Dd^Xo, Dd^Xo, Xv, Xos, Xos, Xos, Xos, Xos, Xos, Xos, Xos, Xos, Xos, Xos, Xos, Xos, Ss, Ss, Ss, Ss, Ss, Xos, Ss, Ss, Xos, Xos, Xos, Ss, Xos, Yhl^Xp, Xos, Xos^Xzm\, Xos, Ss, Xos, Xos, Xos, Ss, Ss, Xos, Xos, Uu, Uh, Uu^Uf, Uh, Uh, Xos, Yhl^Em, Xos, Yhl, Xos, Uu^Ii, Xos, Xos, Xos
Re^Uf, Hd, Yhs, Yhs^Xp, Ds, Uzw, Uzw, Uzw, Ds^Cov, Ds^Cov, Ds^Cov, Dd, Dd, Dd, Dd, Dd, Dd, Dd, Re^Uf, Uzw, Yhs, Yhs^Xp, Dd, Dd^Xo, Dd^Xo, Xv, Xos, Yhl^Xp, Xos, Yhl^Xp, Xos, Yhl^Xp, Xos, Yhl^Xp, Xos, Yhl^Xp, Xos, Xos, Xos, Ss, Ss, Ss, Ss, Xos, Xos^Xzm/, Xos, Ss, Ss, Yhl^Xp, Yhl^Xp, Ss, Yhl^Xp, Yhl^Uf, Yhl^Xp, Yhl^Xp, Ss, Xos, Yhl, Yhl^Xp, Xos, Ss, Ss, Yhl^Xp, Uu, Yhl^Xp, Yhl^Xp, Yhl^Xp, Yhl^Xp, Yhl^Xp, Yhl, Yhl, Yhl, Yhl, Yhl^Em, Yhl^Em, Xos, Ss, Ss
Uu^Uf, Yhs, Dd, Dd, Dd, Ds, Ds, Ds, Yhs^Cov, 1 Yhs^Kov, Ds^Cov, Ds, Dd, Dd, Dd, Uzw, Uzw, Dd, Dd, Re^Uf, Dd, Dd, Qxv, Dd^Xo, Dd^Xo, Xv, Xos, Yhl, Xos, Yhl, Xos, Yhl, Xos, Yhl, Xos, Yhl, Xos, Xos, Xos, Ss, Ss, Ss, Xos, Xos, Ss, Ss, Yhl^Uf, Ss, Ss, Yhl^Uf, Yhl^Uf, Ss, Yhl, Yhl^Xp, Yhl^Xp, Ss, Yhl^Xp, Yhl, Xos, Ss, Ss, Xos, Ss, Yhl^Xp, Xos, Yhl^Xp, Xos, Yhl^Xp, Yhl^Xp, Yhl^Xp, Xos, Xos, Ss, Yhl, Yhl, Yhl^Xp, Ss, Ss
Uu^Uf, Yhs, Re^Uf, Re^Uf, Qxv, Qxv, Ds, Yhs, Ds, Ds^Cov, Uzw, Uzw, Dd, Dd, Dd, Uzw, Yhs, Dd, Dd, Re^Uf, Dd, Dd, Qxv, Qxv^Xo, Qxv^Xo, Xv, Yhl, Yhl, Yhl, Yhl, Yhl, Yhl, Yhl, Yhl, Yhl, Yhl, Yhl, Xos, Yhl^Xp, Ss, Ss, Xos, Xos^Xzm/, Xos, Ss, Yhl^Uf, Yhl^Uf, Yhl^Xp, Ss, Yhl^Uf, Ss, Ss, Yhl^Uf, Yhl^Xp, Ss^Uf, Ss, Xos, Yhl^Xp, Yhl^Kov, Ss, Yhl^Xp, Xos, Ss, Yhl, Yhl^Xp, Xos, Ss, Ss, Xos, Xos, Xos, Xos, Ss^Xo, Ss, Yhl, Yhl^Xp, Xos, Xos
Dd, Uu^Uf, Uu^Uf, Cud, Qxv, Qxv, Dd, Hd, Dd, Dd, Dd, Dd, Dd, Dd, Uzw, Dd, Dd, Yhs^Xp, Yhs, Cud, Cud, Dd, Dd, Qxv^Xo, Qxv^Xo, Xv, Yhl, Yhl, Yhl, Yhl, Yhl, Yhl, Yhl, Yhl, Yhl, Yhl, Yhl, Yhl, Yhl, Yhl^Xp, Ss^Xo, Xos^Xzm/, Uu^Uf, Uu^Uf, Yhl^Xp, Yhl^Xp, Yhl^Xp, Yhl^Xp, Yhl^Xp, Yhl^Uf, Yhl^Xp, Ss, Yhl^Kov, Yhl^Kov, Yhl^Uf, Yhl^Uf, Yhl^Kov, Yhl^Kov, Yhl^Uf, Xos, Yhl^Xp, Ss, Yhl^Xp, Yhl^Xp, Xos, Yhl^Xp, Ss, Ss^Xo, Ss, Xos, Xos, Ss^Xo, Ss^Xo, Xos, Yhl, Yhl^Xp, Ss, Ss
Re^Uf, Uu^Uf, Cud, Cud, Dd, Qxv, Qxv, Hd, Hd, Dd, Dd, Dd, Dd, Uzw, Dd, Dd, Dd, Yhs, Dd, Cud, Uzw, Dd, Dd, Dd^Xo, Qxv^Xo, Xos, Yhl, Xos, Yhl, Xos, Yhl, Xos, Yhl, Xos, Yhl, Xos, Xos, Yhl^Xp, Xos, Yhl^Xo, Yhl^Xp, Yhl^Xp, Uu^Uf, Uu, Yhl, Yhl, Yhl, Yhl^Xp, Ss, Yhl^Kov, Yhl^Kov, Yhl^Kov, Yhl^Uf, Yhl^Xp, Xos, Xos, Xos, Yhl^Kov, Yhl^Kov, Yhl^Kov, Yhl^Kov, Yhl^Kov, Yhl^Kov, Yhl^Xp, Xos, Yhl^Xp, Xos, Xos, Ss^Xo, Ss^Xo, Ss, Ss, Ss, Xos, Yhl^Xp, Yhl^Em, Ss, Ss
Uu^Uf, Uu^Uf, Uu^Uf, Dd, Dd, Qxv, Qxv, Qxv, Qxv, Cud, Cud, Dd, Yhs, Uzw, Dd, Dd, Dd, Dd, Dd, Dd, Uh, Hd, Hd, Hd^Xo, Dd^Xo, Xos, Yhl^Xp, Xos, Yhl^Xp, Xos, Yhl^Xp, Xos, Yhl^Xp, Xos, Yhl^Xp, Xos, Xos, Xos^Xzm/, Yhl, Yhl^Xp, Ss, Yhl^Xp, Ss^Uf, Yhl^Xp, Yhl, Yhl^Uf, Yhl^Xp, Yhl^Xp, Yhl^Kov, Yhl^Kov, Yhl^Kov, Yhl^Kov, Yhl^Kov, Yhl^Kov, Xos, 7 Xos, Xos, Yhl^Kov, Yhl^Kov, Yhl^Kov, Yhl^Kov, Yhl^Kov, Yhl^Kov, Yhl^Xp, Yhl^Xp, Yhl^Xp, Ss, Ss^Xo, Xos, Ss, Ss, Yhl^Uf, Yhl^Uf, Xos, Yhl, Yhl, Xos, Xos
Re^Xo, Yhs^Xp, Yhs, Uu^Uf, Dd, Dd, Dd, Dd, Dd, Cud, Yhs^Xp, Uh, Yhs^Xp, Uzw, Dd, Dd, Dd, Dd, Uzw, Dd, Dd, Hd, Md, Hd^Xo, Hd^Xo, Xos, Xos, Xos, Xos, Xos, Xos, Xos, Xos, Xos, Xos, Xos, Yhl, Yhl, Xos, Ss, Xos, Ss, Yhl^Uf, Ss, Yhl^Xp, Yhl, Ss, Yhl^Xp, Yhl^Kov, Yhl^Kov, Yhl^Uf, Yhl^Kov, Yhl^Kov, Yhl^Kov, Yhl^Xp, Xos, Yhl^Kov, Yhl^Xp, Yhl^Kov, Yhl^Kov, Yhl^Uf, Yhl^Kov, Yhl^Uf, Ss, Uu^Uf, Yhl^Xp, Xos, Xos, Uu^Uf, Ss, Yhl^Uf, Xos, Yhl^Em, Yhl, Yhl^Xp, Yhl^Xp, Xos, Xos
Hd^Xo, Re^Xo, Yhs^Xo, Yhs^Xp, Hd, Hd, Dd, Dd, Dd, Yhs, Yhs, Uzw, Yhs, Dd, Hd, Dd, Dd, Dd, Uzw, Uzw, Dd, Hd, Hd, Md^Xo, Md^Xo, Xos, Xos, Xos, Xos, Xos, Xos, Xos, Xos, Xos, Yhl^Xp, Yhl, Xos, Xos, Xos, Xos, Yhl, Yhl, Ss, Ss, Yhl, Yhl, Ss, Ss^Uf, Uu^Uf, Uu, Ss, Yhl^Xp, Yhl^Kov, Yhl^Kov, Yhl^Kov, Yhl^Kov, Yhl^Kov, Yhl^Xp, Ss, Yhl^Kov, Yhl^Kov, Yhl^Kov, Yhl^Xp, Yhl^Xp, Uu^Uf, Xos, Uh, Uu^Uf, Yhl^Xp, Yhl^Xp, Yhl^Em, Yhl, Yhl^Uf, Yhl^Xp, Uu^Uf, Uu^Uf, Ss, Xos^Xzm\
Hd^Xo, Yhs^Xo, Yhs^Xo, Yhs^Xo, Hd^Xo, Uzw, Dd, Dd, Dd, Uzw, Uh, Yhs^Xp, Uzw, Hd, Uzw, Dd, Dd, Dd, Dd, Uzw, Dd, Hd, Hd, Md^Xo, Md^Xo, Xos, Xu, Xos, Xos, Xos, Xos, Xos, Xos, Xos, Xos, Xos, Xos, Xos, Yhl, Yhl, Xos, Ss, Xos, Xos, Yhl, Ss, Uu, Ss^Uf, Ss^Uf, Ss, Yhl^Uf, Yhl^Xp, Yhl^Uf, Yhl^Kov, Ss, Yhl^Kov, Yhl^Kov, Yhl^Kov, Yhl^Kov, Yhl^Kov, Yhl^Kov, Ss, Ss, Yhl^Xp, Uh, Xos, Uh, Yhl^Xp, Xos, Yhl^Em, Yhl, Uu^Uf, Ss, Xos, Ss^Xo, Ss, Ss^Xo, Ss^Xo
Dd^Xo, Hd^Xo, Yhs^Xo, Hd^Xo, Yhs^Xo, Uzw^Xo, Dd^Xo, Dd, Hd, Uh, Uh, Uzw, Uzw, Uzw, Dd, Uzw, Dd, Dd, Dd, Hd, Hd, Hd, Hd, Md^Xo, Xu, Xu, Xu, Xu, Xos, Xos, Xos, Xos, Xos, Xos, Ss, Xos, Xos, Yhl^Xp, Xos, Xos, Xos, Xos, Yhl, Yhl, Ss, Ss, Xos, Yhl^Uf, Ss, Ss, Uu^Uf, Yhl, Yhl^Xp, Yhl^Xp, Yhl^Xp, Yhl^Kov, Yhl^Uf, Ss, Uu^Uf, Yhl^Xp, Yhl^Kov, Ss^Uf, Ss, Uu^Uf, Uh, Xos, Xos, Xos^Xzm/, Yhl, Yhl, Ss, Ss, Ss^Xo, Ss^Xo, Ss, Ss^Xo, Ss, Ss
Dd^Xo, Dd^Xo, Dd^Xo, Yhs^Xo, Yhs^Xo, Hd^Xo, Dd^Xo, Dd^Xo, Hd^Xo, Uh, Hd, Dd, Dd, Dd, Dd, Dd, Hd, Hd, Hd, Hd, Md, Hd, Rd, Xu, Xu, Xu, Yhr^Xp, Xu, Xos, Xos, Xos, Xos, Ss, Ss, Ss, Ss, Xos, Xos, Xos, Xos, Yhl^Xp, Yhl, Xos, Xos, Xos, Xos, Ss, Ss, Xos, Ss, Uh, Yhl^Xp, Yhl, Yhl, Ss, Yhl^Xp, Yhl^Uf, Ss^Uf, Ss, Yhl^Xp, Uu^Uf, Uu^Uf, Ss, Uu, Xos, Xos^Xzm/, Yhl, Yhl, Ss, Ss, Ss^Xo, Ss^Xo, Yhl^Xp, Xos, Yhl, Xos, Xos, Ss
Dd^Xo, Dd^Xo, Dd^Xo, Dd^Xo, Dd^Xo, Hd^Xo, Hd^Xo, Dd^Xo, Hd^Xo, Hd^Xo, Hd^Xo, Yhs^Xp, Dd, Dd, Dd, Hd, Md, Md, Md, Md, Xu, Xu, Uu^Em, Rd, Rd^Em, Uu^Uf, Uu^Uf, Yhr^Xp, Xos, Xos, Ss^Xo, Ss, Ss, Ss, Xos, Xos, Xos, Xos, Xos, Xos, Xos, Xos, Xos, Xos, Ss^Xo, Ss, Xos, Xos, Ss, Ss, Yhl, Yhl, Yhl^Xp, Yhl^Uf, Ss, Uu^Uf, Uu, Uu^Uf, Ss, Yhl^Xp, Xos, Xos, Ss, Xos, Xos, Xos, Yhl^Xp, Yhl, Ss^Xo, Ss^Xo, Xos, Xos, Yhl, Xos, Yhl, Xos, Xos, Xos
Dd^Xo, Dd^Xo, Dd^Xo, Dd^Xo, Dd^Xo, Hd^Xo, Yhs^Xo, Dd^Xo, Dd^Xo, Hd^Xo, Dd^Xo, Yhs^Xo, Yhs^Xo, Dd, Hd, Hd, Md, Md, Xu, Xu, Xos, Xu, Uh, Uu^Uf, Yhr, Rd^Es, Rd^Es, Yhr^Xp, Uu^Uf, Ss, Ss^Xo, Ss, Xos, Xos, Xos, Xos, Xos, Xos, Xos, Xos, Xos, Xos, Xos, Ss, Xos, Xos, Xos, Xos, Yhl, Yhl, Xos, Xos, Ss, Ss, Xu, Xu, Xu, Ss, Ss, Xos, Xos, Xos, Xos, Ss^Xo, Xos, Xos, Yhl, Yhl, Xos, Yhl, Yhl^Xp, Xos, Yhl, Xos, Yhl^Xp, Xos, Xos, Xos
Hd^Xo, Hd^Xo, Hd^Xo, Dd^Xo, Dd^Xo, Dd^Xo, Yhs^Xo, Yhs^Xo, Yhs^Xo, Yhs^Xo, Yhs, Yhs^Xo, Hd^Xo, Hd^Xo, Md^Xo, Md, Xu, Xu, Xos, Xos, Xos, Xu, Xu, Yhr^Xp, Yhr, Uh, Uh, Ss, Uu^Uf, Xos, Ss^Xo, Xos, Xos, Xos, Xos, Xos, Xos, Xos, Xos, Xos, Xos, Xos, Xos, Xos, Xu, Xos, Yhl^Xo, Yhl^Xo, Xos, Xos, Xos, Xos, Ss, Xu, Xu, Xu, Xu, Xu, Xu, Xos, Xos, Xos, Ss, Ss, Xos, Xos, Yhl, Yhl, Yhl, Xos, Yhl, Yhl, Yhl, Yhl, Yhl, Yhl, Yhl, Xos
Xos, Xos, Xos, Xos, Xos, Xos, Xos, Xos, Xos, Xos, Xos, Xos, Xos, Xos, Xos, Xu, Xos, Xos, Xos, Xos, Xos, Xos, Xos, Yhr^Xp, Xu, Uu^Uf, Ss, Uu^Uf, Yhr^Xp, Xos, Ss, Xos, Xos, Xos, Xu, Xos, Xos, Xos, Xos, Xos, Xos, Xos, Xu, Xu, Xu, Xu, Xu, Xos, Xos, Xos, Ss, Ss^Xo, Xos, Xos, Xos, Xos, Qxu, Xu, Xu, Xu, Xos, Xos, Ss, Xos, Ss^Xo, Ss, Xos, Yhl, Yhl^Xp, Yhl, Yhl, Yhl, Xos, Xos, Yhl, Yhl, Yhl^Xp, Xos
Xos, Xos, Xos, Xos, Xos, Xos, Xos, Xos, Xos, Xos, Xos, Xos, Xos, Xos, Xos, Xos, Xos, Xos, Xos, Xos, Xos, Xos, Xos, Xos, Uu^Uf, Uu^Uf, Ss, Yhr, Ss, Ss, Yhr^Xp, Xos, Xu, Xu, Xu, Xu, Xu, Xos, Xos, Xos, Xos, Xu, Xu, Xu, Xu, Xu, Uh, Xu, Xu, Xol, Xol, Xos, Xos, Xos, Xos, Qxu, Qxu, Qxu, Xu, Xu, Xos, Xos, Xos, Ss, Ss, Ss^Xo, Ss, Xos, Ss, Yhl, Yhl^Xp, Yhl, Uu^Ii, Yhl^Xp, Yhl, Yhl, Xos, Xos
Xos, Xos, Xos, Xos, Xos, Xos, Xos, Xos, Xos, Xos, Xos, Xos, Xos, Xos, Xos, Xos, Xos, Xos, Xos, Xos, Xos, Xos, Xos, Xos, Ss, Ss, Uu^Uf, Yhr, Yhr, Yhr, Yhr^Xp, Xos, Xu, Xu, Xu, Xu, Xu, Xu, Yhl^Xp, Xos, Xos, Xu, Xu, Xu, Uu, Uu^Uf, Uu, Uu^Es, Uu, Uu, Uu^Es, Xol, Uh, Xol, Xol, Xol, Uh, Xu, Xu, Xu, Xu, Xos, Xos, Xos, Ss^Xo, Xos, Ss^Xo, Ss^Xo, Xos, Ss, Ss, Yhl, Yhl, Yhl, Ss, Xos, Ss, Ss
Xos, Xos, Xos, Xos, Xos, Xos, Xos, Xos, Xos, Xos, Xos, Xos, Xos, Xos, Xos, Xos, Xos, Xos, Xos, Xos, Xos, Xos, Ss, Ss^Xo, Xos, Xos, Xos, Xos, Yhl, Yhr, Yhr, Xos, Xu, Xu, Xu, Xu, Yhl^Uf, Yhl, Xu, Xos, Xu, Xu, Yhl^Uf, Uh, Yhl, Uu^Uf, Xu, Xu, Xu, Uh, Uh, Uu, Uu, Uh, Uu, Uh, Uu^Emf, Uu^Em, Uh, Xu, Xu, Xu, Xu, Ss^Xo, Ss, Ss, Ss, Xos, Xos^Xzm\, Yhl, Yhl, Yhl, Yhl, Ss, Ss, Ss^Xo, Xos, Xos
Xos, Xos, Xos, Xos, Xos, Xos, Xos, Xos, Xos, Xos, Xos, Xos, Xos, Xos, Xos, Xos, Xos, Xos, Xos, Xos, Xos, Ss, Xos, Xos, Xos, Xu, Yhr^Xp, Xos, Yhl^Xp, Yhr, Yhl, Xos, Xu, Xu, Xu, Yhl^Uf, Uu^Uf, Yhl, Yhl, Xu, Yhl^Z\, Yhl^Uf, Xu, Yhl^Xp, Yhl^Uf, Yhl, Yhl^Xp, Xu, Xu, Xol, Xol, Uu^Uf, Uu^Uf, Uu^Es, Uu, Uu^Uf, Yhl^Uf, Yhl^Xp, Yhl^Es, Xu, Xu, Xu, Xu, Xu, Xol, Yhl, Yhl, Yhl, Yhl, Xos^Xzm\, Ss, Yhl, Yhl, Yhl, Ss, Ss, Ss^Xo, Ss
Xos, Xos, Xos, Xos, Xos, Xos, Xos, Xos, Xos, Xos, Xos, Xos, Xos, Xos, Xos, Xos, Xos, Xos, Xos, Xos, Xos, Ss, Xos, Xos, Xos, Yhr^Xp, Yhr^Uf, Yhr, Yhr, Yhr, Yhr, Xos, Xos^Xzm\, Xu, Xu, Uu, Uu, Xu, Xu, Yhl, Yhl^Xp, Xu, Xu, Xu, Xu, Yhl, Yhl, Yhl, Yhl, Xu, Xu, Xol, Xol, Xol, Uu^Z\, Uu, Yhl, Yhl, Yhl, Yhl, Yhl^Z/, Xu, Xu, Xu, Yhl^Xo, Xol, Xos, Yhl, Yhl, Xos, Xos, Ss, Yhl, Yhl, Ss, Ss, Xos, Xos
Xos, Xos, Xos, Xos, Xos, Xos, Xos, Xos, Xos, Xos, Xos, Xos, Xos, Xos, Xos, Xos, Xos, Xos, Xos, Xos, Xos, Ss, Xos, Xos, Xos, Yhr^Xp, Xu, Xu, Xos, Yhr, Uu^Uf, Yhr^Em, Uu^Es, Xu, Uu, Uu, Yhr^Xp, Xu, Xu, Xu, Xos, Xos, Xu, Xu, Xu, Xu, Xu, Yhl^Xp, Yhl^Z/, Yhl^Z/, Yhl, Uh, Yhl^Xp, Yhl, Yhl, Yhl^Z\, Xu, Xu, Xu, Yhl^Z/, Yhl, Yhl, Yhl, Yhl^Xp, Xu, Xu, Xu, Yhl, Yhl, Xos, Yhl, Yhl, Ss, Ss, Ss, Yhl, Xos, Xos
Xos, Xos, Xos, Xos, Xos, Xos, Xos, Xos, Xos, Xos, Xos, Xos, Xos, Xos, Xos, Xos, Xos, Xos, Xos, Xos, Ss, Ss^Xo, Ss, Xos, Xos, Xu, Xu, Xu, Xos, Xos, Xos, Uu^Em, Uu^Uf, Uu, Yhr, Yhr, Yhr, Yhr, Yhr, Xu, Xos, Xos, Xu, Xu, Xu, Xu, Xu, Xu, Xu, Yhl^Es, Yhl^Uf, Yhl, Cud, Cud, Cud, Yhl, Uh, Uu^Uf, Xu, Xu, Yhl, Yhl, Yhl, Xu, Xu, Xu, Xu, Yhl, Yhl, Yhl, Yhl, Yhl, Xos, Xos, Xos, Ss^Xo, Ss, Xos
Xos, Xos, Xos, Xos, Xos, Xos, Xos, Xos, Xos, Xos, Xos, Xos, Xos, Xos, Xos, Xos, Xos, Xos, Ss, Ss, Xos, Xos, Xu, Ss, Ss, Xu, Uu^Uf, Xu, Ss^Uf, Xos, Xos, Xos, Xos, Uh, Xos, Xos, Xos, Yhr, Yhr, Yhr^Xp, Xos, Xos, Xos, Xu, Xu, Xu, Xu, Xu, Uu^Uf, Uh, Yhl, Yhl, Cud, 2 Kud, Cud, Yhl^Xp, Uu^Uf, Uu^Uf, Xu, Xu, Yhl^Xp, Yhl, Yhl, Yhl, Yhl, Xu, Yhl, Yhl, Yhl, Yhl, Xu, Xu, Xu, Xos, Xos, Xos, Xos, Ss
Xos, Xos, Xos, Xos, Xos, Xos, Xos, Xos, Xos, Xos, Xos, Xos, Xos, Xos, Xos, Xos, Xos, Xos, Ss, Xos, Xos, Xu, Xu, Xu, Uu^Em, Ss, Ss, Uh, Uu^Em, Uu^Uf, Uh, Xos, Xos, Xos, Xos, Xos^Xzm/, Yhr^Xp, Yhr, Yhr, Xu, Xu, Xos, Xos, Xos, Xos, Xu, Xu, Xu, Yhl^Uf, Yhl^Uf, Yhl, Yhl, Yhl, Cud, Yhl, Yhl, Uu^Uf, Xu, Xos, Yhl^Xo, Xu, Xu, Xu, Yhl, Yhl, Yhl, Yhl, Yhl, Xu, Yhl^Xp, Yhl^Xo, Xu, Xu, Xu, Xu, Xos, Xos, Xos
Xos, Xos, Xos, Xos, Xos, Xos, Xos, Xos, Xos, Xos, Xos, Xos, Xos, Xos, Xos, Xos, Ss, Ss, Xos, Xos, Xos, Uh, Uu^Uf, Yhr^Uf, Yhr^Xp, Ss, Yhr^Xp, Yhr^Uf, Yhr^Xp, Uh, Uh, Xos, Xos^Xzm\, Xos^Xzm/, Yhr, Yhr, Xos, Yhr, Yhr, Xu, Xos, Xos, Xos, Xos, Xos, Xos, Xos, Xu, Yhl, Yhl^Xp, Yhl, Yhl^Uf, Yhl, Yhl, Yhl^Uf, Yhl^Uf, Uu^Uf, Xu, Xos, Xos, Xos, Xu, Yhl^Xp, Yhl, Xu, Yhl, Xu, Xu, Xu, Xu, Xu, Yhl, Xu, Xu, Xu, Xu, Xu, Xos
Xos, Xos, Xos, Xos, Xos, Xos, Xos, Xos, Xos, Xos, Xos, Xos, Xos, Xos, Ss^Xo, Ss, Xos, Xos, Xos, Xos, Cud, Ss, Uu^Uf, Uu^Uf, Yhr^Xp, Uu^Em, Uu^Em, Yhr^Xp, Yhr^Xp, Yhr^Xp, Yhr^Xp, Yhr, Uu, Xos, Yhr, Xos, Xos, Yhr, Uue^Ii, Uue^Uf, Xos, Xos, Xos, Xos, Xos, Xos, Xu, Xos, Xos, Yhl, Yhr, Xos, Yhr, Yhl, Xos, Uu^Uf, Xos, Xos, Xos, Xos, Xos, Yhl^Xo, Xu, Xu, Xu, Xu, Xu, Xu, Xu, Xu, Xu, Xu, Xu, Xu, Xu, Xu, Xu, Xu
Xos, Xos, Xos, Xos, Xos, Xos, Xos, Xos, Xos, Xos, Xos, Xos, Ss, Ss, Xos, Xos, Xos, Xos, Xu, Cud, Cud, Cud, Xos, Yhr^Uf, Uu^Uf, Uu^Uf, Uu^Uf, Yhr^Uf, Yhr^Uf, Uu^Uf, Xos, Yhr, Uu, Uu, Yhr, Xos, Xos, Yhr, Uh, Uue^Em, Xos, Xos, Xos, Xos, Xu, Xu, Xu, Xu, Uh, Xos, Yhr, Yhr^Xp, Yhr, Xos, Uu^Es, Xos, Xu, Xos, Xos, Xos, Xos, Xu, Xu, Xu, Xu, Xu, Xu, Xu, Xu, Xu, Xu, Xu, Xu, Xu, Xu, Xu, Xu, Xu
Xos, Xos, Xos, Xos, Xos, Xos, Xos, Xos, Xos, Xos, Ss, Ss, Ss, Xos, Uu^Ii, Xos, Xu, Xu, Xos, Cud, Xos, Xos, Xos, Xos, Xos, Uh, Uh, Ss^Uf, Xos, Xos, Xos, Xos, Xos, Uu, Yhr, Yhr, Yhr, Yhr^Es, Uu^Uf, Uh, Xos, Xos, Xu, Xu, Xu, Xu, Uh, Cud, Uu, Uu, Cud, Yhr, Yhr^Xp, Yhr^Es, Uu, Uh, Uh, Xu, Xu, Xos, Xos, Xos, Xos, Xu, Xu, Xu, Xu, Xu, Xu, Xu, Xu, Xu, Xu, Xu, Xu, Xu, Xu, Xu
Xos, Xos, Xos, Xos, Xos, Xos, Xos, Xos, Xos, Xos, Ss, Ss, Yhr, Yhr, Yhr, Xos, Xos^Xzm/, Xos^Xzm/, Yhr, Yhr, Xos, Xos, Xos, Xos, Xos, Xos, Xos, Xos, Xos, Xos, Uh, Xos, Xos, Xos, Xos, Yhr, Yhr, Uu^Es, Xu, Xu, Xos, Xos, Xu, Xu, Xu, Xu, Uu^Ii, Yhr, Yhr, Uu^Uf, Yhr, Yhr, Yhr^Es, Yhr, Uu^Uf, Uu^Uf, Uh, Xu, Xu, Xu, Xos, Xos, Xos, Xos, Xos, Xu, Xu, Xu, Xu, Xu, Xu, Xu, Xu, Xu, Xu, Xu, Xu, Xu
Xos, Xos, Xos, Xos, Xos, Xos, Xos, Xos, Xos, Xos, Ss, Yhr, Xos, Xos, Yhr, Xos^Xzm/, Yhr, Yhr, Yhr, Yhr, Xos, Xos, Xos, Xos, Xos, Xos, Xos, Xos, Uh, Uh, Uu^Uf, Uu^Uf, Xos, Xos, Yhr^Xp, Yhr^Z\, Xu, Xu, Xu, Xu, Xos, Xos, Xu, Xu, Uh, Uu, Yhr, Yhr^Xp, Yhr, Yhr^Xp, Yhr, Yhr, Uu, Cud, Uu^Uf, Uh^Uf, Uh, Uu^Ii, Xu, Xu, Xos, Xos, Xos, Xos, Xos, Xos, Xos, Xu, Xu, Xu, Xu, Xu, Xu, Xu, Xu, Xu, Xu, Xu
Xos, Xos, Xos, Xos, Xos, Xos, Xu, Xu, Ss, Ss, Ss, Yhr, Xos, Xos, Yhr, Yhr, Yhr, Yhr, Xos, Xos, Xos, Xos, Yhr^Z\, Yhr^Xp, Yhr^Xp, Xos^Xzm\, Xos, Xos, Uu^Ii, Yhr, Yhr, Yhr^Xp, Yhr, Yhr, Xu, Xu, Yhr^Xp, Xu, Xu, Xu, Xos, Xos, Yhr^Xp, Uh, Yhr, Yhr, Xu, Xu, Xu, Uu, Uu^Uf, Yhr, Yhr^Xp, Uu, Yhr^Xp, Uu, Yhr^Xp, Uh, Xu, Xu, Xos, Xos, Xos, Xos, Xos, Xos, Xos, Xos, Xos, Xu, Xu, Xu, Xu, Xu, Xu, Xu, Xu, Xu
Xos, Xos, Xos, Xos, Xu, Xu, Ss, Ss^Xo, Xos, Xos, Ss, Yhr, Xos, Xos, Xos, Yhr, Xos^Xzm/, Xos, Yhr^Xp, Xos^Xzm/, Yhr^Xp, Yhr, Yhr, Xos, Xos, Yhr^Z/, Yhr, Xos^Xzm\, Yhr, Yhr, Yhr, Yhr, Yhr, Yhr, Yhr, Yhr, Xu, Xu, Uh, Xos, Xos, Xos, Yhr, Yhr, Xos, Xos, Xu, Xu, Yhr, Uh, Yhr^Uf, Yhr^Uf, Uu^Em, Yhr, Uu^Es, Cud, Uh, Uu, Xu, Xu, Xu, Xos, Xos, Xos, Xos, Xos, Xos, Xos, Xos, Xos, Xos, Xu, Xu, Xu, Xu, Xu, Xu, Xu
Xos, Xos, Xos, Xu, Ss, Ss, Ss, Xos, Xos, Xos, Ss, Yhr, Yhr, Ss, Ss, Xos^Xzm\, Yhr, Yhr, Yhr, Yhr, Yhr, Yhr, Yhr^Xp, Xos, Xos^Xzm/, Xos, Yhr^Xp, Yhr, Yhr, Yhr^Xp, Xu, Yhr, Yhr, Yhr, Yhr, Yhr, Yhr, Uu, Uu^Uf, Uu^Uf, Yhr, Xos^Xzm\, Yhr, Yhr, Xos^Xzm/, Xos, Yhr, Yhr, Uu^Uf, Yhr, Uh, Uu^Emf, Uu^Em, Uu, Uh, Uh, Xu, Xu, Xu, Xu, Xos, Xos, Xos, Xos, Xos, Xos, Xos, Xos, Xos, Xos, Xos, Xos, Xos, Xu, Xu, Xu, Xu, Xu
Xos, Xos, Ss, Ss, Xu, Xu, Ss, Xos, Xos, Xos, Xos, Yhr, Yhr, Yhr, Yhr, Yhr, Ss, Yhr, Xos, Yhr, Yhr, Yhr^Xp, Xos, Xos, Ss, Yhr, Yhr^Xp, Yhr, Yhr, Xu, Xu, Xu, Yhr, Yhr, Xu, Yhr, Yhr, Yhr, Yhr, Yhr, Yhr, Yhr, Yhr, Yhr^Xp, Yhr, Yhr, Yhr, Yhr, Xu, Xu, Xu, Xu, Xu, Xu, Xu, Xu, Xu, Xu, Xos, Xos, Xos, Xos, Xos, Xos, Xos, Xos, Xos, Xos, Xos, Xos, Xos, Xos, Xos, Xos, Xos, Xu, Xu, Xu
Xu, Ss^Xo, Xos, Xos, Xu, Xu, Ss, Xos, Xos, Xos, Xos, Xos, Xos, Ss, Ss, Ss, Xos, Xos, Xos, Yhr^Xp, Yhr^Xp, Xos, Xos^Xzm\, Ss, Ss, Ss, Xos, Yhr, Yhr, Xu, Xu, Yhr^Xp, Xu, Xu, Xu, Uu^Uf, Yhr, Xos, Yhr, Yhr, Uh, Yhr, Yhr, Yhr, Yhr, Yhr, Yhr, Uh, Xos, Xu, Xu, Xu, Xu, Xu, Xu, Xu, Xos, Xos, Xos, Xos, Xos, Xos, Xos, Xos, Xos, Xos, Xos, Xos, Xos, Xos, Xos, Xos, Xos, Xos, Xos, Xos, Xos, Xu
Xos, Xos, Xos, Xos, Xos, Xu, Xu, Ss, Ss, Ss, Ss, Xos, Ss^Xo, Ss, Xos, Xos, Xos, Xos, Xos, Yhr, Yhr, Yhr, Yhr, Xos, Xos^Xzm\, Xos^Xzm/, Yhr, Yhr, Yhr, Xu, Xu, Xu, Xu, Xu, Xos, Xos, Yhr^Xp, Yhr, Yhr, Xos, Uu^Uf, Uu^Uf, Uu, Xos, Xos, Yhr, Yhr^Xp, Yhr^Xp, Xos, Xos, Xos, Xu, Xu, Xu, Xos, Xos, Xos, Xos, Xos, Xos, Xos, Xos, Xos, Xos, Xos, Xos, Xos, Xos, Xos, Xos, Xos, Xos, Xos, Xos, Xos, Xos, Xos, Xos
Xos, Xos, Xos, Xos, Xos, Xos, Xos, Xu, Xu, Xu, Xu, Ss, Xos, Ss^Xo, Ss, Xos, Xos, Xos, Xos, Xos, Xos, Yhr, Yhr, Yhr, Yhr, Yhr, Yhr, Yhr, Yhr^Xp, Xos, Xos, Xu, Xos, Xos, Xos, Xos, Xos, Yhr^Xp, Xos, Uh, Uh, Uu^Uf, Uu^Uf, Uh, Xos, Xos, Xos, Xos, Xos, Xos, Xos, Xos, Xos, Xos, Xos, Xos, Xos, Xos, Xos, Xos, Xos, Xos, Xos, Xos, Xos, Xos, Xos, Xos, Xos, Xos, Xos, Xos, Xos, Xos, Xos, Xos, Xos, Xos
Xos, Xos, Xos, Xos, Xos, Xos, Xos, Xos, Xos, Xu, Xos, Xos, Xos, Xos, Ss^Xo, Xos, Xos, Xos, Xos, Xos, Xos, Yhr^Xp, Yhr^Xp, Yhr, Yhr, Yhr, Xos, Yhr^Xp, Yhr^Xp, Yhr^Xp, Xos, Xos, Xos, Xos, Xos, Xos, Xos, Xos, Xos, Xos, Xos, Uh, Xos, Xos, Xos, Xos, Xos, Xos, Xos, Xos, Xos, Xos, Xos, Xos, Xos, Xos, Xos, Xos, Xos, Xos, Xos, Xos, Xos, Xos, Xos, Xos, Xos, Xos, Xos, Xos, Xos, Xos, Xos, Xos, Xos, Xos, Xos, Xos
Xos, Xos, Xos, Xos, Xos, Xos, Xos, Xos, Xos, Xos, Xos, Xos, Xos, Xos, Ss, Xos, Xos, Xos, Xos, Xos, Xos, Xos, Xos, Xos, Xos, Xos, Xos, Xos, Xos, Xos, Xos, Xos, Xos, Xos, Xos, Xos, Xos, Xos, Xos, Xos, Xos, Xos, Xos, Xos, Xos, Xos, Xos, Xos, Xos, Xos, Xos, Xos, Xos, Xos, Xos, Xos, Xos, Xos, Xos, Xos, Xos, Xos, Xos, Xos, Xos, Xos, Xos, Xos, Xos, Xos, Xos, Xos, Xos, Xos, Xos, Xos, Xos, Xos
