border_size=1
usage=map

Qxe         , Dd          , Hd          , Md^Xm       , Md^Xm       , Md          , Md^Xm       , Md^Xm       , Md          , Uhe         , Uhe         , Uue         , Qxe         , Yhs         , Hd          , Hd          , Hd          , Hd          , Hd          , Hd          , Hd          , Hd          , Hd          , Dd          , Rr          , Hd          , Hd          , Ds          , Ds          , Hd          , Md          , Md          , Md^Xm       , Md^Xm       , Md^Xm       , Md          , Md^Xm       , Md^Xm       
Dd          , Qxe         , Qxe         , Hd          , Md^Xm       , Md^Xm       , Hd          , Ds          , Hd          , Uhe         , Uue         , Uue         , Qxe         , Hd          , Dd          , Hd          , Co          , Dd          , Dd^Vda      , Hd          , Dd          , Dd          , Dd          , Dd^Vda      , Rr          , Hd          , Ds          , Ds^Dr       , Rb          , Ds          , Ds          , Hd          , Md          , Md^Xm       , Md^Xm       , Md          , Uhe         , Md          
Co          , Dd          , Hd          , Qxe         , Md          , Qxe         , Qxe         , Qxe         , Qxe         , Qxe         , Qxe         , Qxe         , Hd          , Dd          , Co          , Co          , Dd          , Rr          , Rr          , Dd          , Co          , Co          , Co          , Rr          , Rr          , Dd^Vdt      , Ds          , Ds          , Dd          , Rb          , Ds          , Ds          , Hd          , Md^Xm       , Md          , Md          , Uhe         , Uhe         
Dd          , Hd          , Hd          , Md          , Hd          , Md          , Hd          , Dd^Es       , Dd          , Dd          , Dd          , Hd          , Ds          , Ds^Edpp     , Ds          , Dd          , Co          , Co          , Co          , Co          , Co          , 4 Ko        , Co          , Rr          , Rr          , Ds          , Dd          , Co          , Co          , Dd          , Hd          , Hd          , Uhe         , Md          , Uhe         , Uue         , Uue         , Md          
Dd          , Hd          , Md^Xm       , Md          , Hd          , Hd          , Co          , Dd          , Rr          , Co          , Co          , Dd          , Dd          , Ds          , Ds          , Dd          , Dd          , Dd          , Dd          , Rr          , Rr          , Co          , Rd          , Co          , Co          , Co          , Rr          , Dd          , Co          , Dd          , Hd          , Zw          , Uue         , Yhs         , Qxe         , Uhe         , Yhs         , Md          
Hd          , Hd          , Dd          , Dd^Es       , Dd^Dr       , Dd          , Dd          , Co          , Rr          , Rr          , Dd          , Ds          , Co          , Dd^Edpp     , Ds          , Dd^Vdt      , Rd          , Dd          , Dd^Vda      , Rr          , Rr          , Ds          , Ds          , Ds          , Dd          , Dd          , Dd          , Rr          , Rr          , Dd          , Ds          , Zw          , Zw          , Uue         , Qxe         , Yhs         , Uhe         , Hd          
Md          , Hd          , Hhd         , Dd          , Hd          , Hd          , Dd          , Dd          , Rr          , Dd          , Dd          , Ds          , Co          , Dd          , Dd          , Dd          , Dd          , Rd          , Rr          , Rr          , Dd          , Dd^Vdt      , Ds          , Ds^Es       , Dd          , Dd^Vda      , Dd          , Dd          , Dd          , Rd          , Rd          , Ds^Es       , Qxe         , Qxe         , Dd          , Zw          , Dd          , Dd          
Md^Xm       , Md^Xm       , Hhd         , Dd          , Dd          , Dd          , Ds          , Rr          , Ds          , Dd          , Dd          , Dd          , Dd          , Co          , Co          , Ds          , Co          , Dd          , Dd          , Dd          , Co          , Dd          , Ds          , Ds          , Co          , Dd          , Dd          , Dd          , Dd          , Dd^Es       , Dd          , Rd          , Ds          , Dd          , Dd          , Dd          , Dd          , Dd          
Hhd         , Md^Xm       , Md^Xm       , Hd          , Hd          , Ds          , Ds          , Re          , Ds          , Hd          , Hd          , Dd          , Ds          , Dd          , Dd          , Dd          , Dd          , Co          , Co          , Rr          , Rr          , Co          , Ds          , Co          , Ds          , Hd          , Co          , Co          , Dd          , Dd^Es       , Co          , Rd          , Ds          , Ds          , Co          , Ds          , Ds          , Dd          
Hhd         , Hhd         , Hhd         , Md          , Hd          , Yhs         , Yhs^Xp      , Ds          , Ds          , Hd          , Dd          , Hd          , Dd          , Ds          , Dd^Es       , Dd          , Dd          , Dd          , Dd          , Rd          , Rd          , Dd          , Ds          , Ds          , Ds          , Ds          , Dd          , Dd          , Dd          , Co          , Re          , Re          , Co          , Co          , Dd          , Re          , Co          , Dd          
Hd          , Hd          , Yhs         , Md          , Uue^Uf      , Uue         , Qxe         , Yhs^Xp      , Qxe         , Dd          , Dd          , Dd          , Dd          , Dd          , Dd^Es       , Dd          , Dd^Vdt      , Dd          , Dd          , Dd          , Ds          , Ds          , Ds          , Dd          , Rd          , Rd          , Ds          , Hd          , Dd          , Ds          , Re          , Ds          , Dd          , Dd          , Dd          , Re          , Ds          , Co          
Dd          , Uue         , Yhs         , Yhs^Xp      , Yhs         , Uue         , Uhe         , Qxe         , Hd          , Qxe         , Qxe         , Dd          , Dd          , Ds^Es       , Ds          , Ds          , Ds          , Dd          , Ds^Es       , Rd          , Ds^Es       , Ds^Es       , Ds          , Rd          , Rd          , Ds          , Dd          , Qxe         , Qxe         , Dd          , Dd          , Ds          , Hd          , Dd          , Dd^Edpp     , Ds          , Dd^Es       , Dd          
Md          , Uue         , Uhe         , Yhs         , Yhs^Xp      , Yhs^Xp      , Hd          , Hd          , Hd          , Uhe         , Uhe         , Dd          , Dd          , Dd          , Hd          , Ds          , Ds          , Ds          , Ds          , Ds          , Ds          , Ds          , Ds          , Rd          , Ds          , Dd          , Dd          , Dd          , Qxe         , Qxe         , Qxe         , Hd          , Dd          , Dd          , Dd          , Rd          , Rd          , Re          
Hhd         , Md          , Hd          , Uhe         , Uue         , Yhs         , Uue^Uf      , Uhe         , Dd          , Ds          , Ds          , Dd          , Rd          , Dd          , Qxe         , Hd          , Dd          , Ds          , Dd          , Dd          , Ds          , Ds          , Dd          , Ds^Es       , Ds          , Ds          , Dd          , Qxe         , Dd          , Dd          , Qxe         , Ds          , Ds          , Hd          , Hd          , Rd          , Rd          , Re          
Hd          , Hhd         , Hd          , Uhe         , Yhs^Xp      , Uue^Uf      , Uhe         , Uhe         , Hd          , Ds          , Dd          , Dd          , Dd          , Dd          , Qxe         , Dd          , Hd          , Dd          , Ds          , Ds^Es       , Ds          , Dd^Vdt      , Dd          , Rd          , Dd          , Dd          , Dd          , Qxe         , Dd          , Ds          , Ds          , Qxe         , Dd          , Ds          , Hd          , Hd          , Hd          , Rd          
Hd          , Hd          , Yhs         , Yhs^Xp      , Hd          , Uue         , Hd          , Uhe         , Md          , Hd          , Ds          , Dd          , Dd          , Qxe         , Qxe         , Dd          , Hd          , Dd          , Ds          , Ds          , Dd          , Dd          , Dd          , Rd          , Qxe         , Dd          , Dd          , Re          , Rd          , Rd          , Dd^Es       , Hd          , Dd          , Hd          , Dd^Edpp     , Hd          , Hd          , Hd          
Ds          , Ds          , Uue         , Uue^Uf      , Dd          , Dd          , Hd          , Hd          , Dd          , Dd          , Ds          , Dd          , Dd          , Qxe         , Dd          , Dd          , Dd          , Hd          , Dd          , Rd          , Rd          , Re          , Dd          , Dd          , Qxe         , Dd          , Dd          , Re          , Rd          , Rd          , Dd          , Dd          , Qxe         , Qxe         , Dd          , Dd^Dr       , Hd          , Dd          
Ds          , Ds          , Dd          , Dd          , Ds          , Dd          , Dd          , Hd          , Dd          , Dd          , Ds          , Hd          , Dd          , Dd          , Dd          , Dd^Vdt      , Dd          , Dd^Edp      , Rd          , Dd          , Re          , Re          , Rd          , Qxe         , Dd          , Dd          , Ds          , Dd          , Hd          , Rd          , Rd          , Dd          , Qxe         , Dd          , Re          , Dd          , Dd          , Dd          
Cdr         , Dd          , Hd          , Dd          , Ds          , Dd          , Dd          , Dd          , Ds          , Dd^Dr       , Ds^Es       , Dd          , Dd          , Dd          , Rd          , Rd          , Dd          , Rd          , Rd          , Rd          , Re          , Rd          , Rd          , Dd          , Dd^Vdt      , Dd          , Dd          , Dd          , Hd          , Rd          , Ds          , Hd          , Qxe         , Rd          , Re          , Dd          , Dd          , Dd          
Cdr         , Hd          , Hd          , Dd          , Dd          , Dd          , Ds          , Ds^Es       , Rd          , Ds          , Ds          , Hd          , Hd          , Dd          , Cdr         , Rd          , Dd          , Rd          , Dd          , Rd          , Rd          , Rd          , Dd          , Dd          , Dd          , Dd          , Dd          , Cdr         , Hd          , Ds          , Ds^Dr       , Qxe         , Dd          , Rd          , Rd          , Re          , Rd          , Dd          
Dd          , Hd          , Kdr         , Dd          , Cdr         , Cdr         , Cdr         , Ds^Es       , Rd          , Rd          , Ds          , Hd          , Hd          , Dd          , Hd          , Cdr         , Dd          , Hd          , Dd          , Cdr         , Cdr         , Dd          , Hd          , Dd          , Hd          , Ds          , Dd          , Dd          , Rd          , Rd          , Dd^Es       , Dd          , Dd          , Rd          , Dd^Es       , Rd          , Dd          , Dd          
Hhd         , Hd          , Md          , Md          , Hd          , Qxe         , Qxe         , Ds          , Ds          , Ds          , Dd          , Dd          , Dd^Vdt      , Dd          , Dd          , Cdr         , Dd          , Dd          , Rr          , Rd          , Dd          , Hd          , Dd          , Ds          , Dd          , Hd          , Dd          , Dd^Es       , Rd          , Rd          , Rd          , Dd^Edp      , Rd          , Rd          , Ds          , Dd^Dr       , Re          , Re          
Hd          , Hd          , Md          , Md          , Hd          , Qxe         , Hd          , Dd^Edp      , Hd          , Hd          , Hd          , Dd          , Dd          , Dd          , Dd          , Hd          , Ds          , Rd          , Re          , Ds          , Dd          , Dd^Edp      , Dd          , Dd          , Hd          , Dd          , Dd^Vdt      , Rd          , Rd          , Ds          , Dd          , Ds          , Ds          , Ds          , Dd          , Dd^Es       , Re          , Re          
Hd          , Hd          , Md          , Hd          , Hhd         , Qxe         , Dd          , Hd          , Dd^Edp      , Dd          , Hd          , Dd          , Ds          , Rd          , Dd          , Dd          , Rd          , Rd          , Rr          , Rd          , Dd          , Dd          , Dd          , Hd          , Hd          , Hd          , Rd          , Rd          , Dd          , Dd          , Hd          , Ds          , Dd          , Hd          , Dd          , Re          , Hd          , Hd          
Hd          , Hd          , Hd          , Hhd         , Qxe         , Qxe         , Dd          , Dd          , Dd^Edp      , Dd          , Dd          , Hd          , Rd          , Rd          , Rd          , Dd^Es       , Dd^Edp      , Dd          , Rr          , Rd          , Dd          , Dd          , Ds          , Ds          , Rd          , Dd          , Dd          , Hd          , Hd          , Hd          , Hhd         , Dd          , Md          , Hd          , Hd          , Dd          , Hd          , Dd          
Hhd         , Hd          , Hd          , Qxe         , Dd          , Dd^Dr       , Dd          , Ds          , Dd          , Dd          , Dd          , Dd          , Rd          , Rd          , Dd          , Dd^Dr       , Rd          , Dd^Vdt      , Rr          , Dd          , Dd^Vdt      , Dd          , Ds          , Rd          , Ds^Edpp     , Dd          , Dd          , Hd          , Hd          , Hd          , Md          , Md          , Md^Xm       , Dd          , Hd          , Hd          , Hhd         , Hhd         
Md          , Hhd         , Hd          , Dd          , Dd          , Ds          , Dd^Vdt      , Dd          , Hd          , Hd          , Hd          , Dd^Vdt      , Dd          , Dd          , Dd^Dr       , Dd          , Cdr         , Dd          , Cdr         , Dd          , Rd          , Rd          , Dd^Dr       , Ds          , Ds          , Dd          , Dd          , Dd          , Md          , Md          , Hd          , Md          , Md          , Md          , Hd          , Hhd         , Md^Xm       , Md^Xm       
Md^Xm       , Md          , Hhd         , Hd          , Hd          , Dd          , Hd          , Hd          , Hd          , Md          , Hd          , Hd          , Hd          , Dd          , Dd^Dr       , Dd^Dr       , Dd          , Cdr         , 1 Ke        , Cdr         , Dd          , Dd^Dr       , Dd          , Ds          , Dd          , Dd          , Hd          , Hd          , Hd          , Hd          , Md^Xm       , Md          , Md          , Hd          , Hd          , Hd          , Md^Xm       , Md^Xm       
Md          , Md^Xm       , Md          , Md          , Cdr         , Md          , Hd          , Hd          , Hd          , Md          , Hhd         , Md          , Hd          , Dd          , Dd^Dr       , Dd^Vdt      , Rd          , Cdr         , Cdr         , Cdr         , Dd          , Dd^Vdt      , Dd          , Dd          , Hd          , Dd^Edpp     , Dd          , Hd          , Hd          , Md          , Md^Xm       , Md^Xm       , Hhd         , Hhd         , Md          , Hhd         , Md          , Md^Xm       
Hhd         , Hhd         , Md          , Hd          , Hd          , Kdr         , Hd          , Hhd         , Md          , Hhd         , Cdr         , Md          , Dd          , Dd          , Rd          , Rd          , Dd          , Cdr         , Rd          , Dd          , Dd^Dr       , Dd          , Dd          , Dd          , Hd          , Dd          , Dd          , Hd          , Hd          , Md          , Hhd         , Md          , Md          , Md          , Md^Xm       , Md          , Md          , Md          
Hd          , Hd          , Hhd         , Hd          , Hd          , Md          , Hhd         , Hhd         , Md          , Cdr         , Hd          , Hd          , Hd          , Dd^Dr       , Rd          , Rd          , Dd^Vdt      , Rr          , Rr          , Dd^Dr       , Dd          , Hd          , Hd          , Hd          , Md          , Dd          , Dd          , Hd          , Md          , Hd          , Md          , Hd          , Hd          , Md          , Md          , Md          , Hd          , Hd          
Hd          , Hd          , Hhd         , Hd          , Hd          , Md          , Md          , Md          , Cdr         , Cdr         , Md          , Hd          , Dd          , Dd          , Dd          , Dd          , Rd          , Rr          , Dd          , Dd          , Dd          , Hd          , Hhd         , Cdr         , Md          , Md          , Hd          , Hd          , Hd          , Hd          , Hd          , Hd          , Hhd         , Hhd         , Hd          , Hd          , Hd          , Hd          
Dd          , Dd          , Hd          , Hd          , Hd          , Hd          , Hhd         , Cdr         , Md          , Md          , Hhd         , Hd          , Dd          , Rd          , Rd          , Dd          , Dd          , Dd          , Dd          , Dd^Vdt      , Hd          , Hd          , Md          , Md          , Md          , Hhd         , Dd          , Hd          , Hd          , Hd          , Dd          , Hd          , Hd          , Md          , Md          , Md^Xm       , Hd          , Hd          
Dd          , Dd          , Dd          , Dd^Dr       , Hd          , Hd          , Hhd         , Dd          , Md          , Dd          , Dd          , Dd          , Dd          , Dd^Vdt      , Rr          , Rr          , Hd          , Hd          , Hd          , Hd          , Hd          , Md          , Hhd         , Rb          , Hhd         , Hhd         , Hd          , Kdr         , Dd^Dr       , Hd          , Dd          , Dd          , Hd          , Hd          , Hd          , Hd          , Hd          , Hd          
Hd          , Dd^Edp      , Dd          , Ds^Es       , Rb^Es       , Dd          , Hd          , Hd          , Dd          , Dd          , Rd          , Rd          , Dd          , Rd          , Rr          , Re          , Dd          , Dd          , Dd          , Dd          , Dd          , Cdr         , Md          , Rb          , Rd          , Rb          , Cdr         , Cdr         , Hd          , Hd          , Hd          , Dd          , Hd          , Hd          , Hd          , Hd          , Md^Xm       , Md          
Hd          , Hd          , Ds          , Ds          , Rb^Es       , Rb          , Rb          , Hd          , Dd          , Dd^Dr       , Rd          , Rd          , Hd          , Dd          , Rd          , Dd          , Rd          , Dd^Es       , Dd^Edpp     , Dd          , Dd          , Hd          , Hd          , Hhd         , Rd          , Rd          , Hd          , Hd          , Hd          , Dd          , Hd          , Md          , Hd          , Hd          , Hd          , Hd          , Md^Xm       , Md          
Dd          , Dd          , Hd          , Rb          , Zw          , Zw          , Rb          , Zw          , Hd          , Rb          , Rb          , Rd          , Dd          , Dd          , Dd          , Dd          , Re          , Dd          , Dd          , Dd          , Dd^Vdt      , Dd          , Dd          , Dd          , Hd          , Hd          , Dd          , Hd          , Dd          , Rd          , Hd          , Hd          , Dd          , Md          , Md          , Md^Xm       , Md^Xm       , Md^Xm       
Hd          , Hd          , Cdr         , Hd          , Rb          , Rb^Es       , Rb          , Rb          , Dd^Es       , Zw          , Rb          , Rb          , Zw^Es       , Zw^Es       , Zw          , Dd          , Re          , Dd          , Dd          , Dd          , Dd          , Dd          , Zw          , Hd          , Hd          , Dd          , Dd^Edpp     , Dd^Dr       , Dd          , Dd          , Dd          , Dd          , Hd          , Md          , Md          , Mv          , Md          , Md          
Hhd         , Hd          , Hhd         , Ds          , Ds          , Ds          , Ds^Es       , Dd          , Re^Es       , Ds          , Ds          , Rb          , Rb          , Rb          , Re          , Re          , Dd          , Dd          , Zw          , Dd          , Dd          , Rb          , Rb          , Dd          , Rb          , Dd          , Dd^Edp      , Dd          , Hd          , Cdr         , Hhd         , Rb          , Hd          , Hd          , Md          , Md          , Md          , Md          
Md          , Md          , Hd          , Hd          , Md          , Dd          , Ds^Edp      , Dd^Es       , Ds          , Ds          , Ds^Es       , Rd          , Cdr         , Dd^Es       , Dd          , Dd^Vdt      , Rb          , Dd^Dr       , Rb          , Zw          , Zw          , Zw^Es       , Rb          , Rb          , Dd          , Dd          , Dd^Es       , Dd^Vdt      , Hd          , Cdr         , Hhd         , Rb          , Rd          , Hd          , Hd          , Md          , Hd          , Md          
Md          , Md          , Md          , Hd          , Hd          , Hd          , Ds          , Ds          , Rd^Vct      , Rd          , Ds          , Re          , Ds          , Re          , Dd          , Dd          , Dd^Edp      , Rb          , Ds          , Rb^Es       , Rb^Es       , Zw          , Rb          , Rd          , Rd          , Rb^Es       , Zw^Es       , Hd          , Hd          , Hd          , Hd          , Hd          , Hd          , Hd          , Hd          , Hd          , Hd          , Md          
Hd          , Hhd         , Hd          , Hd          , Hd          , Hhd         , Ce          , Ds          , Ds          , Re          , Rd          , Ds^Es       , Re          , Rr          , Dd^Edpp     , Dd          , Rd          , Ds          , Ds          , Rb          , Ds          , Rb          , Dd          , Rd          , Rd          , Rb          , Rb^Es       , Zw          , Hd          , Hd          , Dd          , Hd          , Dd^Vdt      , Hd          , Hd          , Hd          , Hhd         , Hd          
Hd          , Cdr         , Hd          , Hd          , Hd          , Ce          , 3 Ke        , Ce          , Ds          , Re          , Rr          , Rr          , Cdr         , Dd          , Dd          , Dd          , Rd          , Dd          , Ds          , Ds          , Ds          , Ds^Es       , Ds          , Dd^Vdt      , Dd          , Rb^Es       , Hd          , Zw          , Dd          , Dd^Edp      , Dd          , Dd          , Dd          , Dd          , Ce          , Ce          , Ce          , Md          
Cdr         , Cdr         , Hhd         , Re^Vct      , Hd          , Hhd         , Ce          , Ce          , Hd          , Re          , Rd          , Hd          , Dd          , Dd          , Dd          , Hd          , Rd          , Dd          , Dd          , Dd^Edpp     , Dd          , Rd          , Rd          , Dd          , Rd          , Rd^Es       , Dd          , Hd          , Rb          , Dd          , Rb          , Rb          , Re^Vct      , Dd          , Ce          , 2 Ke        , Hhd         , Hhd         
Hhd         , Hhd         , Md^Xm       , Md          , Md          , Hd          , Hhd         , Hd          , Dd          , Rd^Vct      , Hd          , Hd          , Hd          , Hd          , Dd          , Hd          , Dd          , Rd          , Dd          , Dd          , Hhd         , Rd          , Rd          , Hhd         , Hhd         , Rd          , Dd          , Dd^Edpp     , Rb          , Rb          , Zw          , Zw          , Rb          , Dd          , Dd          , Ce          , Hd          , Hhd         
Hhd         , Md          , Md^Xm       , Hhd         , Md          , Hhd         , Md          , Hd          , Rr          , Rd          , Hhd         , Hd          , Hd          , Hd          , Hd          , Hd          , Hd          , Hd          , Cdr         , Hhd         , Md          , Md          , Md          , Hhd         , Hhd         , Hhd         , Dd          , Dd          , Dd          , Dd          , Dd          , Zw          , Zw          , Re^Vct      , Zw          , Dd          , Hd          , Dd          
Md          , Md          , Hhd         , Md^Xm       , Md^Xm       , Md          , Md          , Rr          , Hhd         , Hhd         , Hhd         , Hd          , Hd          , Hd          , Hd          , Hd          , Hd          , Hd          , Cdr         , Hhd         , Hhd         , Md          , Md          , Hhd         , Md          , Hhd         , Cdr         , Dd          , Hhd         , Dd          , Dd          , Zw          , Dd          , Rb          , Rb          , Dd          , Zw          , Dd          
Hhd         , Hhd         , Hhd         , Md          , Md          , Md          , Rr          , Rr          , Md          , Md          , Md          , Md          , Hhd         , Hd          , Hd          , Hd          , Dd          , Hd          , Hhd         , Cdr         , Kdr         , Md          , Md          , Md          , Md          , Md          , Hhd         , Hhd         , Hhd         , Hhd         , Hd          , Hd          , Hd          , Hd          , Dd          , Rb          , Zw          , Zw          
