Xuc, Xuc, Xuc, Qxv, Qxv, Qxv, Xu, Xu, Xu, Xu, Xu, Xuc, Xu, Xuc, Xuc, Xuc, Xuc, Xuc, Xuc, Xuc, Xuc, Xuc, Xuc, Xuc, Xuc, Xuc, Xuc, Xuc, Xuc, Xuc, Xuc, Xuc, Xuc, Xuc, Xuc, Xuc, Xuc, Xuc, Xu, Xuc, Yhr, Yhr, Yhr, Xu, Xuc, Xuc, Xuc, Xuc, Xuc, Xuc, Xuc, Xos, Xos, Xos, Xos, Xos, Xos, Xos, Yhl, Yhl, Yhl, Yhl, Xos, Xos, Xos, Xos, Xos, Xos, Xos, Xos, Xos, Xos, Xos, Xos, Xos, Xos, Xos, Xos, Xos, Xos, Xos, Xos
Xos, Xuc, Xuc, Xuc, Xuc, Qxv, Qxv, Xu, Xu, Xu, Xu, Xu, Xu, Xuc, Xuc, Xuc, Xuc, Xuc, Xuc, Xuc, Xuc, Xuc, Xuc, Xuc, Xuc, Xuc, Xuc, Xuc, Xuc, Xuc, Xu, Xu, Xu, Xu, Xu, Xu, Xu, Xu, Xu, Xu, Yhr, Yhr, Yhr^Xp, Xu, Xuc, Xuc, Xuc, Xuc, Xuc, Xuc, Xuc, Xos, Xos, Xos, Xos, Xos, Yhl, Yhl, Yhl, Yhl, Xos, Xos, Xos, Xos, Xos, Xos, Xos, Xos, Xos, Xos, Xos, Xos, Xos, Xos, Xos, Xos, Xos, Xos, Xos, Xos, Xos, Xos
Yhr, Xos, Xom, Xuc, Xuc, Xuc, Qxv, Qxv, Xu, Xu, Xu, Xu, Xuc, Xuc, Xuc, Xuc, Xuc, Xuc, Xuc, Xuc, Xuc, Xuc, Xuc, Xuc, Xuc, Xuc, Xuc, Xuc, Xuc, Xuc, Xu, Xu, Xu, Xu, Xuc, Xu, Xuc, Xuc, Xu, Xu, Yhr^Xp, Yhr^Xp, Yhr^Pr/, Xu, Xuc, Xuc, Xuc, Xuc, Xuc, Xuc, Xuc, Xos, Xos, Xos, Yhl, Yhl, Yhl, Yhl^Xp, Xos, Xos, Xos, Xos, Xos, Xos, Xos, Xos, Xos, Xos, Xos, Xos, Xos, Xos, Xos, Xos, Xos, Xos, Xos, Xos, Xos, Xos, Xos, Xos
Yhr, Yhr, Cud, Xom, Xom, Xuc, Xuc, Qxv, Qxv, Xuc, Xu, Xuc, Xuc, Xuc, Xuc, Xuc, Xuc, Xuc, Xuc, Xuc, Xuc, Xuc, Xuc, Xuc, Xuc, Xuc, Xuc, Xuc, Xuc, Xuc, Xu, Xu, Xu, Xuc, Xu, Xuc, Xuc, Xu, Xu, Xu, Yhr^Pr/, Yhr^Pr/, Yhr, Xuc, Xuc, Xuc, Xu, Xuc, Xuc, Xom, Xom, Xos, Yhl, Yhl^Xp, Yhl, Yhl, Xos, Xos, Xos, Xos, Xos, Xos, Xos, Xos, Xos, Xos, Xos, Xos, Xos, Xos, Xos, Xos, Xos, Xos, Xos, Xos, Xos, Xos, Xos, Xos, Xos, Xos
Xos, Cud, Yhr, Yhr^Xp, Yhr^Pr/, Xuc, Xuc, Qxv, Qxv, Xu, Xu, Xuc, Xuc, Xuc, Xuc, Xuc, Xuc, Xuc, Xuc, Xuc, Xuc, Xuc, Xuc, Xuc, Xuc, Xuc, Xuc, Xuc, Xuc, Xuc, Xu, Xu, Xu, Xu, Xu, Yhr, Yhr, Xuc, Yhr, Xuc, Yhr^Xp, Yhr, Yhr, Xuc, Xu, Xu, Xu, Xu, Xuc, Xom, Yhl^Pw\, Yhl, Yhl^Xp, Yhl, Xos, Xos, Xos, Xos, Xos, Xos, Xos, Xos, Xos, Xos, Xos, Xos, Xos, Xos, Xos, Xos, Xos, Xos, Xos, Xos, Xos, Xos, Xos, Xos, Xos, Xos, Xos, Xos
Xuc, Xos, Xos, Yhr^Pr/, Yhr, Yhr, Yhr, Qxv, Qxv, Qxv, Qxv, Xuc, Xuc, Xuc, Xu, Xuc, Xuc, Xuc, Xuc, Xuc, Xuc, Xuc, Xuc, Xuc, Xuc, Xuc, Xuc, Xuc, Xuc, Xuc, Xuc, Xu, Xuc, Xu, Yhr, Yhr^Xp, Yhr, Yhr, Yhr^Xp, Yhr, Yhr^Uf, Yhr^Xp, Yhr, Uh, Xu, Xu, Uh, Xuc, Yhl^Xp, Yhl^Xp, Yhl^Xp, Yhl^Pw\, Xos, Xos, Xos, Yhl, Xos, Xos, Xos, Xos, Xos, Xos, Xos, Xos, Xos, Xos, Xos, Xos, Xos, Xos, Xos, Xos, Xos, Xos, Xos, Xos, Xos, Xos, Xos, Xos, Xos, Xos
Xuc, Xuc, Xuc, Xuc, Yhr^Xp, Yhr, Yhr, Yhr, Yhr^Xp, Qxv, Qxv, Qxv, Qxv, Xu, Xu, Xuc, Xu, Xu, Xuc, Qxv, Xuc, Xuc, Xuc, Xuc, Xuc, Xuc, Xuc, Xuc, Xuc, Xuc, Xu, Xuc, Xu, Xuc, Yhr^Xp, Yhr^Xp, Xuc, Yhr, Uu^Uf, Yhr^Efs, Uu^Uf, Uu^Uf, Uu^Uf, Uh, Uu^Uf, Uh, Yhl, Yhl, Yhl, Yhl, Xuc, Xos, Xos, Xos, Xos, Yhl^Xo, Xos, Xos, Xos, Xos, Xos, Xos, Xos, Xos, Xos, Xos, Xos, Xos, Xos, Xos, Xos, Xos, Xos, Xos, Xos, Xos, Xos, Xos, Xos, Xos, Xos, Xos
Xuc, Xuc, Xuc, Xuc, Xom, Xuc, Xuc, Yhr, Yhr, Yhr^Xp, Yhr, Xom, Xuc, Qxv, Xuc, Xuc, Xu, Xu, Qxv, Qxv, Xu, Xu, Xuc, Xuc, Xuc, Xuc, Xuc, Xuc, Xuc, Xuc, Xu, Xu, Yhr, Yhr, Yhr, Yhr, Uh, Xuc, Uu^Uf, Uu^Vu, Re, Uu, Uu, Uh, Uu^Uf, Uh^Uf, Uh, Yhl^Xp, Uh, Xuc, Xuc, Xos, Xos, Xos, Xos, Yhl^Xp, Xos, Xos, Xos, Xos, Xos, Xos, Xos, Xos, Xos, Xos, Xos, Xos, Xos, Xos, Xos, Xos, Xos, Xos, Xos, Xos, Xos, Xos, Xos, Xos, Xos, Xos
Xuc, Xuc, Xom, Xom, Qxv, Xuc, Qxv, Qxv, Xuc, Yhr, Yhr, Xom, Xuc, Qxv, Xuc, Xu, Qxv, Qxv, Xu, Xu, Xuc, Xuc, Xu, Xuc, Xuc, Xuc, Xu, Xuc, Xuc, Xuc, Yhr^Pr\, Yhr, Yhr, Yhr^Xp, Yhr^Efs, Yhr, Uh, Uu^Uf, Re, Re, Re, Uh, Uu, Re, Re, Yhl^Xp, Yhl^Xp, Uh, Xom^Efs, Xuc, Xuc, Xos, Xos, Xos, Xos, Xos, Xos, Xos, Xos, Xos, Xos, Xos, Xos, Xos, Xos, Xos, Xos, Xos, Xos, Xos, Xos, Xos, Xos, Xos, Xos, Xos, Xos, Xos, Xos, Xos, Xos, Xos
Xuc, Xom, Xuc, Qxv, Qxv, Qxv, Xuc, Xuc, Xuc, Yhr, Yhr, Xu, Xuc, Qxv, Qxv, Qxv, Xu, Xu, Xu, Xuc, Yhr^Xp, Xos, Xos, Xuc, Xu, Xu, Xu, Xuc, Yhr, Yhr, Yhr, Yhr^Pr\, Yhr^Pr\, Yhr^Xp, Uh, Uh, Ss, Uu, Re, Re, Uh, Uu^Uf, Uu^Uf, Re, Uu, Yhl^Xp, Yhl, Yhl, Yhl, Xom^Efs, Xos, Xos, Xos, Xos, Xos^Efs, Uh, Xos^Efs, Xos, Xos, Xos, Xos, Xos, Yhl^Xo, Yhl, Xos, Xos, Xos, Xos, Xos, Xos, Xos, Xos, Xos, Xos, Xos, Xos, Xos, Xos, Xos, Xos, Xos, Xos
Xuc, Xom, Qxv, Qxv, Xuc, Xom, Xom, Xom, Yhr, Yhr^Xp, Yhr, Xu, Qxv, Qxv, Qxv, Xuc, Xu, Xuc, Xu, Xuc, Yhr^Xp, Yhr, Yhr, Xuc, Yhr, Xu, Yhr^Xp, Yhr^Xp, Yhr, Yhr, Yhr, Yhr, Xuc, Xuc, Uh, Ss, Uu, Uu, Uu, Uu^Uf, Uu^Uf, Xuc, Xuc, Uh, Yhl, Re, Xuc, Xuc, Xos, Yhl^Xp, Xos, Xos, Xos^Efs, Xos^Efs, Urb, Urb, Urb, Xos^Efs, Xos^Efs, Xos, Xos, Yhl^Xp, Xos, Xos, Xos, Xos, Xos, Xos, Xos, Xos, Xos, Xos, Xos, Xos, Xos, Xos, Xos, Xos, Xos, Xos, Xos, Xos
Xuc, Xom, Qxv, Qxv, Xom, Xom, Yhr, Yhr^Pw\, Xuc, Cud, Cud, Yhr, Yhr, Qxv, Xuc, Xuc, Xuc, Xuc, Yhr, Xuc, Xuc, Xuc, Xu, Yhr, Yhr, Yhr, Yhr, Yhr, Yhr, Yhr, Xuc, Xuc, Xu, Ss, Ss, Ss, Uu, Re, Re, Uh, Uu^Uf, Uh, Xuc, Xuc, Xuc, Xuc, Xuc, Xuc, Xos, Xos, Xos, Uh, Urb, Urb, Wog, Wog, Wog, Urb, Urb, Uh, Xos, Xos, Xos, Xos, Xos, Xos, Xos, Xos, Xos, Xos, Xos, Xos, Xos, Xos, Xos, Xos, Xos, Xos, Xos, Xos, Xos, Xos
Xuc, Xuc, Xuc, Qxv, Yhr, Yhr^Pw\, Xuc, Xuc, Xuc, Xuc, Yhr^Xp, Yhr, Xom, Yhr, Yhr, Xom, Yhr, Yhr, Xom, Yhr, Yhr^Pw/, Xu, Yhr, Yhr^Pr\, Yhr^Pr\, Yhr, Yhr, Yhr, Xuc, Xuc, Xu, Xuc, Xuc, Xu, Xu, Uu^Uf, Uu^Uf, Uu, Re, Uu^Vu, Uh, Xom, Xuc, Xuc, Xuc, Xos, Xos, Xos, Xos, Xos, Xos, Xos, Urb, Urb, Wog, Uu^Ii, Wog, Urb, Urb, Xos, Xos, Xos, Xos, Xos, Xos, Xos, Xos, Xos, Xos, Xos, Xos, Xos, Xos, Xos, Xos, Xos, Xos, Xos, Xos, Xos, Xos, Xos
Xuc, Xuc, Yhr, Yhr, Yhr^Xp, Xuc, Xuc, Xuc, Xuc, Xom, Yhr^Xp, Yhr, Xom, Xom, Xom, Yhr, Xom, Xom, Xuc, Xuc, Yhr, Yhr, Yhr, Yhr, Xuc, Xuc, Xuc, Xuc, Xuc, Xuc, Wwb, Xu, Xom, Xuc, Xu, Uh, Uu^Em, Uu^Em, Uu, Uu, Uh, Xom, Xuc, Xuc, Xos, Xos, Xos, Xos, Xos, Xos, Xos, Xos, Urb, Urb, Urb, Wwg^Bw|, Urb, Urb, Urb, Xos, Xos^Xzm\, Xos, Xos, Xos, Xos, Xos, Xos, Xos, Xos, Xos, Xos, Xos, Wog, Xos, Xos, Xos, Xos, Xos, Xos, Xos, Xos, Xos
Yhr, Cud, Xom, Yhr, Yhr, Xom, Xuc, Xuc, Xom, Xom, Yhr, Yhr, Xom, Xuc, Xom, Xom, Xuc, Xuc, Xom, Xom, Yhr, Yhr, Xuc, Xuc, Ql, Xuc, Xom, Xuc, Yhl, Wwb, Wwb, Wwb, Wwb, Xom, Xu, Uh, Uh, Uu^Em, Re, Uu, Yhl^Xp, Xuc, Xuc, Xos, Xos, Xos, Xos, Xos, Xos, Xos, Xos, Uh, Xos, Urb, Urb, Urb, Urb, Urb, Xos, Uh, Xos, Xos, Xos, Xos, Xos, Xos, Xos, Xos, Xos, Xos, Wog, Wog, Xos, Xos, Xos, Xos, Xos, Xos, Xos, Xos, Xos, Xos
Xuc, Xuc, Xom, Xom, Yhr, Xom, Xom, Xom, Yhr, Cud, Yhr, Yhr, Xuc, Xom, Xuc, Xuc, Xuc, Xuc, Xom, Yhr^Xp, Yhr, Yhr^Xp, Xuc, Xuc, Cud, Cud, Yhl, Yhl, Yhl, Yhl, Yhl, Wwb, Wwb, Wwb, Wwb^Xo, Uh, Uh, Uu^Es, Re, Re^Efs, Uu, Yhl, Yhl, Uh, Uh, Xos, Xos, Xos, Yhl^Xo, Yhl^Xp, Xos, Xos, Xos, Xos, Xos, Urb, Xos, Xos, Xos, Xos, Xos, Yhl^Xp, Yhl^Xo, Xos, Xos, Xos, Xos, Xos, Wog, Wog, Xos, Xos, Xos, Xos, Xos, Xos, Xos, Xos, Xos, Xos, Xos, Xos
Xuc, Xuc, Xuc, Xom, Yhr, Cud, Yhr, Cud, Yhr, Yhr, Xuc, Yhr^Xp, Yhr^Xp, Xuc, Xuc, Xuc, Xuc, Xuc, Xom, Yhr^Xp, Yhr, Yhr, Yhr^Pw/, Xuc, Yhl, Yhl, Yhl, Yhl, Yhl, Xos, Wwb, Yhl^Xp, Yhl, Wwb, Wwb, Wwb^Xo, Wwb^Xo, Uh, Uh, Ur, Ur, Uh, Uh, Yhl^Xp, Yhl^Xp, Xos, Xos^Xzm\, Yhl, Xos^Xzm/, Xos, Uh^Xo, Uu, Xos, Xos, Uh, Ur, Xos^Xzm/, Xos, Uu^Uf, Uh, Uu^Uf, Xos, Xos, Yhl, Xos, Xos, Wog, Wog, Xos, Xos, Xos, Xos, Xos, Xos, Xos, Xos, Xos, Xos, Xos, Xos, Xuc, Xuc
Xuc, Xuc, Xuc, Xuc, Yhr^Xp, Yhr, Yhr, Yhr, Xuc, Yhr^Xp, Yhr^Xp, Xuc, Xuc, Yhr^Xp, Xuc, Xuc, Xuc, Xom, Ql, Xom, Xom, Yhr^Pw/, Yhl, Yhl, Yhl, Yhl, Yhl, Xos, Wwb, Yhl^Xp, Yhl, Wwb, Wwb, Yhl^Xp, Yhl, Wwb, Wwb, Wwb^Xo, Wwb^Xo, Xu, Xu, Ur, Ur, Uu^Uf, Uu^Vu, Yhl^Xp, Yhl^Xp, Xos^Xzm\, Uu^Emf, Uu^Uf, Uh^Xo, Ur^Br/, Xos, Uh, Uu, Ur, Ur, Ur, Rb, Uh, Uu^Emf, Xuc, Xuc, Xos, Wog, Wog^Xo, Xos, Yhl^Xo, Yhl^Xp, Xos, Xos, Xos, Xos, Xos, Xos, Xos, Xos, Xos, Xuc, Xuc, Xuc, Xuc
Xuc, Xuc, Xuc, Xuc, Xuc, Yhr^Xp, Xuc, Yhr^Xp, Yhr^Xp, Xuc, Xuc, Yhr^Xp, Xuc, Xuc, Xuc, Xuc, Xuc, Xuc, Cud, Cud, Yhl, Yhl, Yhl, Yhl, Yhl, Xos, Wwb, Yhl^Xp, Yhl, Wwb, Wwb, Yhl^Xp, Yhl, Wwb, Wwb, Yhl^Xp, Yhl, Wwb, Wwb, Wwb, Wwb^Xo, Uu^Uf, Uu^Uf, Ur, Yhl, Uh, Ur^Br/, Ur^Br/, Uu^Br\, Ur^Br/, Uu, Uh^Xo, Xos, Uh, Xos, Uu, Xuc, Uh, Uu^Vu, Rb, Uu^Em, Xuc, Wog^Es, Wog, Cud, Xos, Yhl, Xos, Xos, Uh, Uh, Xos, Xos, Xos, Xos, Xos, Xuc, Xuc, Xuc, Xuc, Xuc, Xuc
Xuc, Xuc, Xuc, Xuc, Xuc, Xuc, Xuc, Xuc, Xuc, Yhr^Xp, Xuc, Xuc, Xuc, Xuc, Xuc, Ql, Cud, Xuc, Yhl, Yhl, Yhl, Yhl, Yhl, Xos, Wwb, Yhl^Xp, Yhl^Ii, Wwb, Wwb, Yhl^Xp, Yhl, Wwb, Wwb, Yhl^Xp, Yhl^Ii, Wwb, Wwb, Yhl^Xp, Yhl^Xp, Wwb^Ii, Wwb^Xo, Wwb^Xo, Wwb^Pr/, Uu^Vu, Ur, Ur, Uu^Em, Uu^Em, Uu^Ii, Uu^Em, Yhl, Uh^Xo, Xos, Xos, Xos, Uh, Xos, Xuc, Xuc, Rb, Wwg^Bw\, Wwg, Uu^Es, Cud, Uh, Xos, Xos, Yhl, Yhl^Xo, Xos, Uu^Vu, Uh, Xos, Xos, Xu, Xu, Xu, Xuc, Xuc, Xuc, Xuc, Xuc
Xuc, Xuc, Xuc, Xuc, Xuc, Xuc, Xuc, Xuc, Xuc, Xuc, Xuc, Xuc, Ql, Xuc, Xuc, Cud, Yhl, Yhl, Yhl, Yhl, Yhl, Xos, Wwb, Yhl^Xp, Yhl, Wwb, Wwb, Yhl^Xp, Yhl, Wwb, Wwb, Yhl^Xp, Yhl, Wwb, Wwb, Yhl^Xp, Yhl^Xp, Wwb, Wwb^Xo, Wwb^Xo, Wwb^Pr/, Wwb^Pr/, Urb, Urb, Urb, Ur, Uu^Vu, Uu^Em, Yhl^Xp, Uh, Xos, Yhl^Xp, Yhl, Xos, Xos, Xos, Xos, Xuc, Wwg, Wwg^Es, Uu^Em, Uu, Ur^Em, Uh, Urb, Uh, Xos, Xos, Xos, Yhl^Xp, Ur^Br|, Uh, Xuc, Xu, Yhl^Xo, Yhl, Xu, Xuc, Xuc, Xuc, Xuc, Xuc
Wog, Xuc, Xuc, Xuc, Xu, Xuc, Xuc, Xuc, Xuc, Xuc, Xuc, Xuc, Cud, Cud, Yhl, Yhl, Yhl, Yhl, Yhl, Xos, Wwb, Yhl^Xp, Yhl, Wwb, Wwb, Yhl^Xp, Yhl, Wwb, Wwb, Yhl^Xp, Yhl, Wwb, Wwb, Yhl^Xp, Yhl^Xp, Wwb, Wwb^Xo, Wwb^Xo, Wwb^Pr/, Wwb^Pr/, Urb, Urb, Urb, Urb, Wwb^Pr/, Wwb^Pr/, Wwb^Xo, Xos, Xos, Yhl, Yhl, Xos, Xos, Yhl, Xos, Xos, Wog^Xo, Wog, Xos, Cud, Uu, Ur^Es, Ur^Br/, Ur, Uh, Urb, Rb, Uu^Vu, Urb, Uh, Ur^Br/, Uh, Yhl^Xp, Yhl, Xu, Xu, Xuc, Xuc, Xuc, Xuc, Xuc, Xuc
Wog, Wog, Wwb, Xu, Xu, Xu, Xuc, Xuc, Xuc, Xuc, Xu, Xuc, Yhl, Yhl, Yhl, Yhl, Yhl^Ii, Xos, Wwb, Yhl^Xp, Yhl, Wwb, Wwb, Yhl^Xp, Yhl, Wwb, Wwb, Yhl^Xp, Yhl, Wwb, Wwb, Yhl^Xp, Yhl^Xp, Wwb, Wwb^Xo, Wwb^Xo, Wwb^Pr/, Wwb^Pr/, Urb, Urb, Urb, Urb, Wwb^Pr/, Wwb^Pr/, Wwb^Xo, Wwb^Xo, Wwb, Wwb, Wwb, Xos, Xos, Yhl, Xos, Xos, Wog, Wog, Xos, Xos, Xos, Xos, Ur^Br/, Ur^Br/, Uu^Uf, Uh, Uu^Uf, Urb^Efs, Rb^Br\, Uu^Em, Ur^Br\, Ur^Br|, Uh, Uh^Ii, Xuc, Uh, Xuc, Xuc, Xuc, Xuc, Xuc, Xuc, Xuc, Xuc
Wog, Wog, Wog, Wwb, Wog, Xu, Xuc, Xuc, Xu, Xu, Wwb, Wwb, Wwb, Yhl, Yhl, Xos, Wwb, Yhl^Xp, Yhl, Wwb, Wwb, Yhl^Xp, Yhl^Ii, Wwb, Wwb, Yhl^Xp, Yhl, Wwb, Wwb, Yhl^Xp, Yhl^Xp, Wwb, Wwb, Wwb^Xo, Wwb^Xo, Wwb^Xo, Wwb^Pr\, Urb, Urb, Urb, Wwb^Pr/, Wwb^Pr/, Wwb^Xo, Wwb^Xo, Wwb^Ii, Yhl^Xp, Yhl^Xp, Xuc, Xuc, Wwb, Xos, Xos, Wog, Wog, Xos, Xos, Xos, Xos, Xos, Ur^Br|, Xos, Xos, Uu, Uh^Uf, Uh, Rb^Ufi, Rb^Uf, Ur^Br\, Ur^Br\, Ur^Br|, Uu^Em, Xuc, Uh, Xuc, Xuc, Xuc, Xuc, Xuc, Xuc, Xuc, Xuc, Xuc
Wog, Wog, Wog, Wwb, Wwb, Wwb, Wwb^Pr/, Xuc, Wwb, Wwb, Wwb, Wwb, Wwb, Wwb, Wwb, Yhl^Xp, Yhl, Wwb, Wwb, Yhl^Xp, Yhl, Wwb, Wwb, Yhl^Xp, Yhl, Wwb, Wwb, Yhl^Xp, Yhl^Xp, Wwb, Wwb, Wwb, Wwb, Wwb, Wwb, Wwb^Xo, Wwb^Xo, Wwb^Pr\, Wwb^Xo, Wwb^Pr/, Wwb^Xo, Wwb^Xo, Wwb, Yhl^Xp, Yhl^Xp, Xuc, Xuc, Yhl, Xuc, Xos, Wog, Wog, Xos, Xos, Xos, Xos, Xos, Xos, Ur^Br/, Ur^Xo, Xos, Xos, Uu, Uh, Uu^Ii, Uu^Uf, Uue^Em, Uue^Efs, Uue, Ur^Br\, Ur^Br\, Uu, Uh, Xom, Xom, Xuc, Xuc, Xuc, Xuc, Xuc, Xom, Xuc
Xuc, Wwb, Wwb, Wwb, Wwb^Pr/, Wwb^Pr/, Wwb, Wwb, Xos^Efs, Xos, Wwb, Wwb, Wwb, Wwb, Wwb, Wwb, Wwb, Yhl^Xp, Yhl, Wwb, Wwb, Yhl^Xp, Yhl, Wwb, Wwb, Yhl^Xp, Yhl^Xp, Wwb, Wwb, Wwb, Wwb, Wwb^Ii, Wwb, Wwb, Wwb, Wwb, Wwb, Wwb^Xo, Wwb^Xo, Wwb^Xo, Wwb, Yhl^Xp, Yhl^Xp, Xuc, Xuc, Yhl, Xuc, Xuc, Xuc, Xos, Xos, Xos, Xos, Xos, Xos, Xos, Xos, Uu^Br/, Xos, Xos, Yhl, Yhl^Xp, Uh, Uu^Vu, Urb, Urb^Em, Uue, Uue^Ii, Uhe, Uu^Es, Uu^Ii, Ur^Br\, Uh, Uh, Uu^Em, Xuc, Xuc, Xuc, Xuc, Xom, Qxu, Xuc
Xu, Xuc, Xuc, Wwb^Pr/, Wwb, Wwb, Xos, Wwb, Wwb, Wwb, Wwb^Ii, Wwb, Wwb, Xos, Wwb, Wwb, Wwb, Wwb, Wwb, Yhl^Xp, Yhl, Wwb, Wwb, Yhl^Xp, Yhl^Xp, Wwb, Wwb, Wwb, Wwb, Wwb, Wwb, Wwb, Wwb, Wwb, Wwb, Wwb, Wwb, Wwb^Ii, Wwb, Yhl^Xp, Yhl^Xp, Xuc, Xuc, Yhl, Xuc, Xuc, Xuc, Xuc, Xuc, Xuc, Xuc, Xos, Xos, Xos, Xos, Xos, Xos, Xos, Yhl, Yhl^Xo, Xos, Uh, Xos, Uh, Urb, Uue^Em, Uue, Uhe^Ii, Xuce, Xuce, Xu, Uu^Ii, Uu, Ur^Br\, 1 Ur^Br\, Uu, Uu, Xu, Xom, Qxu, Qxu, Xuc
Xu, Xu, Wwb, Wwb, Xos, Wwb, Wwb, Wwb, Wwb, Wwb, Wwb, Wwb, Wwb, Wwb, Wwb, Wwb, Wwb, Wwb, Wwb, Wwb, Wwb, Yhl^Xp, Yhl^Xp, Wwb, Wwb, Wwb, Wwb, Wwb, Wwb, Wwb, Wwb, Wwb, Wwb, Wwb, Wwb, Wwb, Wwb, Yhl^Xp, Yhl^Xp, Xuc, Xuc, Yhl, Xuc, Xuc, Xuc, Xuc, Xuc, Xuc, Xuc, Xuc, Xuc, Xuc, Xuc, Xos, Xos, Xos, Yhl, Yhl, Xos, Qxe, Qxe, Xos, Qxe, Urb, Uue, Uue, Uhe, Uhe, Xuce, Xuce, Xuc, Xu, Xom, Uu, Uu, Ur^Br\, Ur^Br\, Uu, Uu, Qxu, Xuc, Xuc
Wwb, Wwb, Wwb, Xos^Efs, Wwb, Wwb, Wwb, Wwb, Xos, Wwb, Wwb, Wwb, Xos, Wwb, Xos, Wwb, Wwb, Wwb, Xos, Wwb, Wwb, Wwb, Wwb, Wwb, Wwb, Wwb, Wwb, Wwb, Wwb, Wwb, Wwb, Wwb, Wwb, Wwb, Wwb, Yhl^Xp, Yhl^Xp, Xuc, Xuc, Yhl, Xuc, Xuc, Xuc, Xuc, Xuc, Xuc, Xuc, Xuc, Xuc, Xuc, Xuc, Xuc, Xuc, Xos, Xos, Yhl, Xos, Xos, Xos, Qxe, Qxe, Qxe, Qxe, Qxe, Qxe, Xos, Xos, Xuce, Xuce, Xuce, Xuce, Xu, Xuc, Xom, Xom, Uu, Uu, Ur^Br\, Ur^Br\, Uu^Em, Uu^Em, Xuc
Wwb, Wwb, Wwb, Wwb, Wwb, Wwb, Wwb, Wwb, Wwb, Wwb, Wwb, Xos^Efs, Wwb^Ii, Wwb^Ii, Wwb^Ii, Xos^Efs, Wwb, Wwb, Wwb, Wwb, Wwb, Wwb, Wwb, Wwb, Wwb, Wwb, Wwb, Wwb, Wwb, Wwb, Wwb, Wwb, Wwb, Yhl^Xp, Yhl^Xp, Xuc, Xuc, Yhl, Xuc, Xuc, Xuc, Xuc, Xuc, Xuc, Xuc, Xuc, Xuc, Xuc, Xuc, Xuc, Xuc, Xuc, Xos, Xos, Xos, Xos, Qxe, Xos, Qxe, Qxe, Qxe, Xos, Xos, Qxe, Qxe, Xos, Xos, Xuce, Xuce, Xuce, Xuc, Xuc, Xuc, Xuc, Xuc, Xom, Xom, Uu, Ur^Es, Ur^Br\, Ur^Br\, Uu
Wwb, Wwb, Wwb, Wwb, Wwb, Wwb, Wwb, Wwb^Ii, Wwb, Wwb, Xos, Wwb^Ii, Urb^Ii, Urb^Ii, Urb^Ii, Wwb^Ii, Xos, Wwb, Wwb, Wwb, Wwb, Wwb, Wwb, Wwb, Wwb, Wwb, Wwb, Wwb, Wwb, Wwb, Wwb, Yhl^Xp, Yhl^Xp, Xuc, Xuc, Yhl, Xuc, Xuc, Xuc, Xuc, Xuc, Xuc, Xuc, Xuc, Xuc, Xuc, Xuc, Xuc, Xuc, Xuc, Xos, Xos, Xos, Xos, Qxe, Qxe, Qxe, Qxe, Qxe, Qxe, Qxe, Xos, Xos, Qxe, Qxe, Xos, Xos, Xuce, Xuce, Xuce, Xuc, Xuc, Xuc, Xuc, Xom, Xuc, Xom, Qxu, Xom, Uu^Ii, Uu, Ur^Br\
Wwb, Wwb, Xos, Wwb, Wwb, Wwb, Wwb, Wwb, Wwb, Wwb, Xos^Efs, Wwb^Ii, 2 Urb^Ii, Ur^Ii, Urb^Ii, Wwb^Ii, Xos^Efs, Wwb, Wwb, Wwb^Ii, Wwb, Wwb, Wwb, Wwb, Wwb, Wwb, Wwb, Wwb, Wwb, Yhl^Xp, Yhl^Xp, Xuc, Xuc, Yhl, Xuc, Xuc, Xuc, Xuc, Xuc, Xuc, Xuc, Xuc, Xuc, Xuc, Xuc, Xuc, Xuc, Xuc, Xos, Xos, Xos, Xos, Qxe, Qxe, Qxe, Qxe, Qxe, Qxe, Qxe, Qxe, Qxe, Qxe, Qxe, Qxe, Qxe, Xos, Xos, Xos, Xuce, Xuce, Xuc, Xuc, Xos, Xom, Xom, Xom, Xom, Xom, Xom, Xom, Xom, Uu^Ii
Xos, Xos, Xos, Xos, Xos, Wwb, Wwb, Wwb, Cud, Cud, Urb, Urb^Ii, Wwb^Ii, Urb^Ii, Wwb^Ii, Wwb^Ii, Wwb, Wwb, Wwb, Wwb, Wwb^Ii, Wwb, Wwb, Wwb, Wwb, Wwb, Wwb, Yhl^Xp, Yhl^Xp, Xuc, Xuc, Yhl, Xuc, Xuc, Xuc, Xuc, Xuc, Xuc, Xuc, Xuc, Xuc, Xuc, Xuc, Xuc, Xuc, Xuc, Xuc, Xuc, Xuc, Xuc, Xuc, Qxe, Qxe, Qxe, Qxe, Qxe, Qxe, Qxe, Qxe, Qxe, Qxe, Qxe, Qxe, Qxe, Qxe, Xuc, Xuc, Xuc, Xuc, Xuc, Xuc, Xuc, Xuc, Xuc, Xuc, Xuc, Xuc, Xuc, Xuc, Xuc, Xuc, Xuc
Xos, Xos, Xos, Xos, Xos, Wwb, Cud, Cud, Urb, Urb, Cud, Xos, Xos^Efs, Wwb^Ii, Xos^Efs, Xos, Wwb, Wwb, Xos, Wwb, Wwb, Wwb, Wwb, Wwb, Wwb, Yhl^Xp, Yhl^Xp, Xuc, Xuc, Yhl, Xuc, Xuc, Xuc, Xuc, Xuc, Xuc, Xuc, Xuc, Xuc, Xuc, Xuc, Xuc, Xuc, Xuc, Xuc, Xuc, Xuc, Xuc, Xuc, Xuc, Xuc, Qxe, Qxe, Qxe, Qxe, Qxe, Qxe, Qxe, Qxe, Qxe, Qxe, Qxe, Qxe, Qxe, Qxe, Qxe, Qxe, Xuc, Xuc, Xuc, Xuc, Xuc, Xuc, Xuc, Xuc, Xuc, Xuc, Xuc, Xuc, Xuc, Xuc, Xuc
Xos, Xos, Xos, Xos, Xos^Efs, Cud, Urb, Urb, Cud^Ii, Cud, Wwb, Wwb, Wwb, Wwb, Wwb, Wwb, Wwb, Wwb, Wwb, Wwb, Wwb, Wwb, Xuc, Yhl^Xp, Yhl^Xp, Xuc, Xuc, Yhl, Xuc, Xuc, Xuc, Xuc, Xuc, Xuc, Xuc, Xuc, Xuc, Xuc, Xuc, Xuc, Xuc, Xuc, Xuc, Xuc, Xuc, Xuc, Xuc, Xuc, Xuc, Xos, Xos, Qxe, Qxe, Qxe, Qxe, Qxe, Qxe, Qxe, Qxe, Qxe, Qxe, Qxe, Qxe, Qxe, Qxe, Qxe, Qxe, Xuc, Xuc, Xuc, Xuc, Xuc, Xuc, Xuc, Xuc, Xuc, Xuc, Xuc, Xuc, Xuc, Xuc, Xuc
Xos, Xos, Xos^Efs, Xos^Efs, Urb, Urb, Cud, Cud, Wwb, Wwb, Wwb, Wwb, Wwb, Wwb, Wwb, Wwb, Wwb^Ii, Wwb, Wwb, Wwb, Wwb, Wwb, Wwb, Xuc, Xuc, Yhl, Xuc, Xuc, Xuc, Xuc, Xuc, Xuc, Xuc, Xuc, Xuc, Xuc, Xuc, Xuc, Xuc, Xuc, Xuc, Xuc, Xuc, Xuc, Xuc, Xuc, Xuc, Xuc, Xuc, Xuc, Xuc, Xos, Qxe, Qxe, Qxe, Qxe, Qxe, Qxe, Qxe, Qxe, Qxe, Qxe, Qxe, Qxe, Qxe, Qxe, Qxe, Qxe, Xuc, Xuc, Xuc, Xuc, Xuc, Xuc, Xuc, Xuc, Xuc, Xuc, Xuc, Xuc, Xuc, Xuc
Xos^Efs, Xos^Efs, Urb, Urb, Xuc, Xuc, Xuc, Wwb, Wwb, Wwb, Wwb, Wwb, Wwb, Xos, Wwb, Wwb, Wwb, Wwb, Wwb, Wwb, Wwb, Wwb, Wwb, Wwb, Wwb, Xuc, Xu, Xuc, Xu, Xuc, Xu, Xuc, Xuc, Xuc, Xuc, Xuc, Xuc, Xuc, Xuc, Xuc, Xuc, Xuc, Xuc, Xuc, Xuc, Xuc, Xuc, Xuc, Xuc, Xuc, Xuc, Xos, Qxe, Qxe, Qxe, Qxe, Qxe, Qxe, Qxe, Qxe, Qxe, Qxe, Qxe, Qxe, Qxe, Qxe, Qxe, Xuc, Xuc, Xuc, Xuc, Xuc, Xuc, Xuc, Xuc, Xuc, Xuc, Xuc, Xuc, Xuc, Xuc, Xuc
Urb, 3 Urb, Uu, Uu, Uu, Xuc, Xuc, Xuc, Uu, Wwb, Uu, Wwb, Wwb, Wwb, Wwb, Wwb, Wwb, Wwb, Wwb, Wwb, Wwb, Wwb, Wwb, Wwb, Wwb, Xu, Xu, Xu, Xu, Xu, Xu, Xu, Xu, Xu, Xu, Xuc, Xu, Xuc, Xu, Xuc, Xuc, Xuc, Xuc, Xuc, Xuc, Xuc, Xuc, Xuc, Xuc, Xuc, Xuc, Xos, Xos, Qxe, Qxe, Qxe, Qxe, Qxe, Qxe, Qxe, Qxe, Qxe, Qxe, Qxe, Xuc, Qxe, Xuc, Xuc, Xuc, Xuc, Xuc, Xuc, Xuc, Xuc, Xuc, Xuc, Xuc, Xuc, Xuc, Xuc, Xuc, Xuc
Xos, Xos, Xos, Uh, Uu^Uf, Uue^Uf, Uue, Xuc, Xuc, Uu, Uu^Ii, Uu, Uu^Uf, Wwb, Wwb, Wwb, Wwb, Wwb, Wwb, Wwb, Wwb, Wwb, Wwb, Xuc, Xu, Wwb, Wwb^Pr/, Xu, Xom, Xu, Xom, Xu, Xu, Xu, Xu, Xu, Xu, Xu, Xu, Xu, Xu, Xuc, Xu, Xuc, Xuc, Xuc, Xuc, Xuc, Xuc, Xuc, Xuc, Xuc, Xuc, Xos, Xos, Qxe, Qxe, Qxe, Xos, Qxe, Qxe, Qxe, Qxe, Xuc, Xuc, Xuc, Xuc, Xuc, Xuc, Xuc, Xuc, Xuc, Xuc, Xuc, Xuc, Xuc, Xuc, Xuc, Xuc, Xuc, Xuc, Xuc
Yhr^Xp, Xos^Xzm\, Xos^Xzm\, Uh, Uh, Uu, Uue, Uue, Uue^Uf, Uue, Uu^Uf, Uu, Xuc, Xos, Xos, Xos, Xos, Wwb, Xos, Wwb, Wwb, Xuc, Xuc, Wwb, Wwb^Pr/, Xuc, Xom, Wog, Wog, Xom, Xuc, Xu, Xu, Xu, Xu, Xu, Xu, Xu, Xu, Xu, Xu, Xu, Xu, Xu, Xu, Xuc, Xuc, Xuc, Xuc, Xuc, Xuc, Xuc, Xuc, Xos, Xos, Xos, Xos, Xos, Xos, Xos, Xos, Qxe, Xuc, Xuc, Xuc, Xuc, Xuc, Xuc, Xuc, Xuc, Xuc, Xuc, Xuc, Xuc, Xuc, Xuc, Xuc, Xuc, Xuc, Xuc, Xuc, Xuc
Yhr, Yhr^Xp, Yhr^Xp, Xos^Xzm\, Xos, Xos, Xos, Uh, Uh, Uh, Uh, Xuc, Xuc, Xos, Qxu, Xos, Xos, Xos, Xos, Xos, Xos, Wwb, Wwb^Pr/, Xu, Xu, Wwb, Wwb, Xom, Xu, Wog, Wog, Xu, Xuc, Xu, Xuc, Xu, Xu, Xu, Xu, Xu, Xu, Xu, Xu, Xu, Xu, Xu, Xu, Xuc, Xuc, Xuc, Xuc, Xuc, Xuc, Xuc, Xuc, Xos, Xos, Xos, Xos, Xos, Xos, Xos, Xos, Xuc, Xos, Xuc, Xuc, Xuc, Xuc, Xuc, Xuc, Xuc, Xuc, Xuc, Xuc, Xuc, Xuc, Xuc, Xuc, Xuc, Xuc, Xuc
Xos, Yhr, Yhr, Yhr^Xp, Yhr^Xp, Xos^Xzm\, Xos, Uh, Xuc, Uh, Yhr, Yhr, Yhr^Xp, Xuc, Qxu, Qxu, Qxu, Xos, Xos, Xos, Xos, Xuc, Xuc, Wwb, Wog, Xu, Xuc, Wog, Wog, Xu, Xuc, Wog, Wog, Xuc, Wog, Xu, Xuc, Xuc, Xu, Xu, Xu, Xu, Xu, Xu, Xu, Xu, Xu, Xu, Xu, Xuc, Xuc, Xuc, Xuc, Xuc, Xuc, Xuc, Xuc, Xos, Xos, Xos, Xos, Xos, Xos, Xos, Xos, Xos, Xuc, Xuc, Xuc, Xuc, Xuc, Xuc, Xuc, Xuc, Xuc, Xuc, Xuc, Xuc, Xuc, Xuc, Xuc, Xuc
Xos, Xos, Xos, Yhr, Yhr^Pr/, Xos, Xos^Xzm\, Xuc, Xuc, Xuc, Xuc, Yhr, Yhr, Qxu, Qxu, Qxu, Qxu, Xuc, Xuc, Xos, Xuc, Xuc, Xuc, Xu, Xu, Wog, Wog, Xuc, Xuc, Wog, Wog, Xu, Wog, Wog, Wog, Wog, Wog, Xuc, Wog, Xu, Wog, Xu, Xu, Xu, Xu, Xu, Xu, Xu, Xu, Xu, Xu, Xuc, Xuc, Xuc, Xuc, Xuc, Xuc, Xuc, Xuc, Xuc, Xuc, Xuc, Xuc, Xuc, Xuc, Xuc, Xuc, Xuc, Xuc, Xuc, Xuc, Xuc, Xuc, Xuc, Xuc, Xuc, Xuc, Xuc, Xuc, Xuc, Xuc, Xuc
Xos, Xos, Xos, Xos, Yhr, Yhr, Yhr^Xp, Xos^Xzm\, Xuc, Xuc, Xuc, Yhr^Xp, Yhr, Qxu, Qxu, Qxu, Qxu, Xuc, Xos, Xuc, Xuc, Qxv, Qxv, Xu, Xu, Xuc, Xuc, Wog, Wog, Xuc, Wog, Wog, Wog, Wog, Wog, Wog, Wog, Wog, Wog, Wog, Wog, Wog, Wog, Wog, Wog, Xu, Xu, Xu, Xu, Xu, Xu, Xu, Xu, Xuc, Xuc, Xuc, Xuc, Xuc, Xuc, Xuc, Xuc, Xuc, Xuc, Xuc, Xuc, Xuc, Xuc, Xuc, Xuc, Xuc, Xuc, Xuc, Xuc, Xuc, Xuc, Xuc, Xuc, Xuc, Xuc, Xuc, Xuc, Xuc
Xos, Xos, Xos, Xos, Yhr, Yhr^Xp, Yhr^Xp, Xos, Xuc, Xuc, Yhr^Pr\, Yhr, Yhr, Qxu, Qxu, Qxu, Xos, Xos, Xos, Xu, Xuc, Xuc, Xuc, Qxv, Xuc, Xuc, Xuc, Xuc, Wog, Wog, Wog, Wog, Wog, Wog, Wog, Wog, Xu, Wog, Xu, Wog, Xu, Wog, Wog, Wog, Wog, Wog, Wog, Xu, Xu, Xu, Xu, Xu, Xu, Xu, Xuc, Xuc, Xuc, Xuc, Xuc, Xuc, Xuc, Xuc, Xuc, Xuc, Xuc, Xuc, Xuc, Xuc, Xuc, Xuc, Xuc, Xuc, Xuc, Xuc, Xuc, Xuc, Xuc, Xuc, Xuc, Xuc, Xuc, Xuc
Xos, Xos, Xos, Xos, Yhr, Yhr, Xos, Xos, Xuc, Yhr, Yhr, Yhr^Pr\, Xuc, Yhr^Xp, Yhr^Xp, Xuc, Xos, Xos, Xu, Xu, Xu, Xu, Qxv, Qxv, Xuc, Xuc, Xuc, Xuc, Xuc, Wog, Wog, Wog, Wog, Wog, Xu, Xu, Xu, Xu, Xu, Xu, Xu, Xu, Xu, Xu, Xu, Xu, Xu, Wog, Wog, Xu, Xu, Xu, Xu, Xu, Xuc, Xuc, Xuc, Xuc, Xuc, Xuc, Xuc, Xuc, Xuc, Xuc, Xuc, Xuc, Xuc, Xuc, Xuc, Xuc, Xuc, Xuc, Xuc, Xuc, Xuc, Xuc, Xuc, Xuc, Xuc, Xuc, Xuc, Xuc
Xos, Xos, Xos, Xos, Yhr, Yhr, Xos^Efs, Xos, Yhr^Xp, Yhr, Yhr, Xuc, Xuc, Xuc, Xos, Xos, Xos, Xos, Xuc, Xuc, Qxv, Qxv, Yhl, Yhl^Xp, Yhl^Xp, Xu, Xu, Xuc, Xuc, Xuc, Wog, Wog, Xu, Xu, Xu, Xu, Xu, Xu, Xu, Xu, Xu, Xu, Xu, Xu, Xu, Xu, Xu, Xu, Xu, Wog, Xu, Xu, Xu, Xu, Xuc, Xuc, Xuc, Xuc, Xuc, Xuc, Xuc, Xuc, Xuc, Xuc, Xuc, Xuc, Xuc, Xuc, Xuc, Xuc, Xuc, Xuc, Xuc, Xuc, Xuc, Xuc, Xuc, Xuc, Xuc, Xuc, Xuc, Xuc
Yhr^Pr/, Xos, Yhr, Yhr, Yhr, Yhr, Yhr, Xos^Efs, Xos, Yhr, Yhr, Xuc, Xuc, Xos, Xos, Xos, Xuc, Xuc, Xuc, Qxv, Yhl^Xp, Yhl^Xp, Xuc, Yhl, Yhl, Yhl^Xp, Yhl^Xp, Xuc, Xuc, Xuc, Wog, Wog, Xu, Xu, Xu, Xu, Xu, Xu, Xu, Xu, Xu, Xu, Xu, Xu, Xu, Xu, Xu, Xu, Xu, Xu, Xu, Xu, Xu, Xu, Xuc, Xuc, Xuc, Xuc, Xuc, Xuc, Xuc, Xuc, Xuc, Xuc, Xuc, Xuc, Xuc, Xuc, Xuc, Xuc, Xuc, Xuc, Xuc, Xuc, Xuc, Xuc, Xuc, Xuc, Xuc, Xuc, Xuc, Xuc
Xos, Yhr, Xos, Yhr, Xos, Yhr^Xp, Yhr^Pr/, Yhr^Pr/, Yhr, Yhr, Yhr, Yhr, Yhr^Xp, Xuc, Xuc, Xuc, Xu, Xu, Xuc, Qxv, Xuc, Xuc, Yhl^Xp, Yhl^Xp, Xuc, Yhl, Yhl, Yhl^Xp, Yhl, Wog, Wog, Wog, Xu, Xu, Xu, Xu, Xu, Xu, Xu, Xu, Xu, Xu, Xuc, Xu, Xuc, Xu, Xu, Xu, Xu, Xu, Xu, Xu, Xu, Xuc, Xuc, Xuc, Xuc, Xuc, Xuc, Xuc, Xuc, Xuc, Xuc, Xuc, Xuc, Xuc, Xuc, Xuc, Xuc, Xuc, Xuc, Xuc, Xuc, Xuc, Xuc, Xuc, Xuc, Xuc, Xuc, Xuc, Xuc, Xuc
Xos, Xos, Xos, Xos, Xos, Xos, Xos, Yhr, Yhr^Xp, Yhr, Yhr, Yhr^Xp, Xuc, Xuc, Xuc, Xuc, Xuc, Xu, Xu, Qxv, Xuc, Xuc, Xuc, Xuc, Yhl^Xp, Yhl^Xp, Xuc, Yhl, Yhl, Yhl, Yhl, Yhl, Yhl^Pw/, Xuc, Xuc, Xu, Xu, Xu, Xu, Xu, Xu, Xu, Xu, Xuc, Xuc, Xuc, Xuc, Xu, Xuc, Xu, Xuc, Xu, Xuc, Xuc, Xuc, Xuc, Xuc, Xuc, Xuc, Xuc, Xuc, Xuc, Xuc, Xuc, Xuc, Xuc, Xuc, Xuc, Xuc, Xuc, Xuc, Xuc, Xuc, Xuc, Xuc, Xuc, Xuc, Xuc, Xuc, Xuc, Xuc, Xuc
Xos, Xos, Xos, Xos, Xos, Xos, Xos, Xos, Xos, Xos, Xos, Xuc, Xuc, Xuc, Xuc, Xuc, Xuc, Xu, Qxv, Qxv, Xuc, Xuc, Xuc, Xuc, Xuc, Xuc, Xuc, Xuc, Wog, Wog, Wog, Xuc, Xuc, Yhl, Yhl, Xu, Xu, Xu, Xu, Xu, Xu, Xu, Xu, Xu, Xuc, Xuc, Xuc, Xuc, Xuc, Xuc, Xuc, Xuc, Xuc, Xuc, Xuc, Xuc, Xuc, Xuc, Xuc, Xuc, Xuc, Xuc, Xuc, Xuc, Xuc, Xuc, Xuc, Xuc, Xuc, Xuc, Xuc, Xuc, Xuc, Xuc, Xuc, Xuc, Xuc, Xuc, Xuc, Xuc, Xuc, Xuc
Xos, Xos, Xos, Xos, Xos, Xos, Xos, Xos, Xos, Xos, Xos, Xos, Xuc, Xuc, Xuc, Xuc, Xuc, Qxv, Qxv, Qxv, Xuc, Xuc, Xuc, Xuc, Xuc, Xuc, Wog, Wog, Wog, Wog, Xuc, Xuc, Xuc, Xuc, Xuc, Yhl, Yhl, Xu, Xu, Xu, Xu, Xu, Xu, Xu, Xu, Xuc, Xuc, Xuc, Xuc, Xuc, Xuc, Xuc, Xuc, Xuc, Xuc, Xuc, Xuc, Xuc, Xuc, Xuc, Xuc, Xuc, Xuc, Xuc, Xuc, Xuc, Xuc, Xuc, Xuc, Xuc, Xuc, Xuc, Xuc, Xuc, Xuc, Xuc, Xuc, Xuc, Xuc, Xuc, Xuc, Xuc
