border_size=1
usage=map

Mm          , Mm          , Mm          , Mm          , Mm          , Mm          , Hh          , Gs^Fp       , Gs^Fp       , Gs          , Rd          , Gs          , Hh          , Gs          , Gs^Fp       , Hh          , Hh          , Hh          , Mm          , Mm          , Mm          , Mm          , Mm          , Mm          , Mm          , Mm          , Mm          
Mm          , Mm          , Hh          , Mm^Vhh      , Gg          , Hh          , Gg          , Gg          , Gs^Vht      , Gs^Fp       , Rd          , Gg          , Hh          , Hh          , Hh          , Gs^Fp       , Gs^Fp       , Hh          , Hh          , Mm          , Mm^Vhh      , Mm          , Mm          , Mm          , Mm          , Mm          , Mm          
Mm          , Hh          , Gs^Fp       , Hh          , Gg          , Gg          , Ch          , Ch          , Ch          , Gs          , Rd          , Gg          , Gg          , Gg          , Hh          , Gs^Fp       , Gs^Fp       , Gs          , Gs^Fp       , Hh          , Hh          , Mm          , Mm          , Mm          , Mm          , Mm          , Mm          
Mm          , Hh          , Hh          , Gs^Fp       , Gg          , Ch          , Ch          , 3 Kh        , Ch          , Gs          , Rd          , Gs          , Gs^Vht      , Gg          , Gs^Fp       , Hh          , Mm          , Gs          , Hh          , Hh          , Mm          , Mm          , Mm          , Mm          , Mm          , Mm          , Mm          
Mm          , Hh          , Hh          , Gs^Fp       , Gs^Vht      , Gg          , Gg          , Ch          , Gs          , Gs          , Gs^Vht      , Rd          , Rd          , Gg          , Gg          , Hh          , Mm          , Mm          , Hh          , Hh          , Hh          , Mm          , Mm          , Hh          , Mm          , Mm          , Mm          
Mm          , Mm          , Mm          , Hh          , Mm          , Hh          , Mm          , Hh          , Mm          , Mm          , Mm          , Gg          , Gg          , Rd          , Hh          , Hh          , Mm          , Mm          , Mm          , Mm          , Hh          , Mm          , Mm          , Hh          , Mm          , Mm          , Mm          
Mm          , Mm          , Mm          , Mm          , Mm          , Hh          , Mm          , Mm          , Mm          , Hh          , Hh          , Hh          , Gg          , Rd          , Gs          , Hh          , Mm          , Mm          , Mm          , Mm          , Mm          , Mm          , Mm          , Mm          , Mm          , Hh          , Mm          
Mm          , Mm          , Mm          , Hh          , Hh          , Mm          , Hh          , Hh          , Gs^Fp       , Hh          , Hh          , Hh          , Gg          , Rd          , Gs^Fp       , Hh          , Mm          , Mm          , Mm          , Mm          , Mm          , Mm          , Mm          , Mm          , Mm          , Mm          , Mm          
Mm          , Hh          , Hh          , Mm          , Mm          , Mm          , Mm          , Hh          , Gs^Fp       , Mm          , Gg          , Gg          , Rd          , Rd          , Gs          , Hh          , Hh          , Hh          , Mm          , Mm          , Mm          , Mm          , Mm          , Mm          , Mm          , Mm          , Mm          
Mm          , Hh          , Mm          , Hh          , Mm          , Mm          , Mm          , Mm          , Hh          , Gs^Fp       , Gg          , Gg          , Gs          , Gs          , Hh          , Hh          , Mm          , Hh          , Mm          , Mm          , Mm          , Mm          , Mm          , Mm          , Mm          , Mm          , Mm          
Mm          , Mm          , Mm          , Mm          , Mm          , Hh          , Hh          , Hh          , Gs          , Gs          , Gs^Vht      , Gg          , Gg          , Hh          , Hh          , Hh          , Hh          , Mm          , Mm          , Mm          , Mm          , Mm          , Mm          , Mm          , Mm          , Mm          , Mm          
Mm          , Mm          , Mm          , Mm          , Mm          , Hh          , Gs^Fp       , Gs^Fp       , Gs^Fp       , Gs^Fp       , Gs^Fp       , Rd          , Gg          , Hh          , Gs^Fp       , Gs          , Gs^Fp       , Hh          , Mm          , Mm          , Gs^Fp       , Hh          , Hh          , Mm          , Hh          , Mm          , Mm          
Mm          , Mm          , Mm          , Mm          , Hh          , Hh          , Gs^Fp       , Gs^Fp       , Gs          , Gs          , Gs          , Rd          , Gg          , Gs          , Gs^Fp       , Gs^Fp       , Gs^Fp       , Gs          , Gs          , Hh          , Gs^Fp       , Gs^Fp       , Gs          , Mm          , Mm          , Hh          , Mm          
Mm          , Mm          , Mm          , Hh          , Hh          , Gs          , Gs^Fp       , Gg          , Gs^Fp       , Gg          , Gg          , Rd          , Gg          , Gs^Vht      , Gs^Fp       , Gs^Fp       , Ss          , Ss          , Gs^Fp       , Gs^Fp       , Hh          , Gg^Vh       , Gs^Fp       , Mm          , Hh          , Hh          , Hh          
Mm          , Mm          , Mm          , Hh          , Gs          , Gs^Fp       , Gs^Fp       , Gs^Fp       , Re^Gvs      , Re^Gvs      , Gg          , Rd          , Gs^Fp       , Gg          , Re^Gvs      , Gs^Fp       , Ss          , Ss          , Gg          , Gg          , Gg          , Gs^Fp       , Gs^Fp       , Hh          , Gs          , Gs^Fp       , Gs^Fp       
Mm          , Mm          , Mm          , Mm          , Mm          , Hh          , Gg          , Re^Gvs      , Gg          , Gg^Wm       , Re^Gvs      , Gg          , Rd          , Re^Gvs      , Gg          , Gg^Wm       , Gg          , Ss          , Gg          , Gg          , Gg          , Ss          , Ss          , Gs          , Gs^Fp       , Gs          , Gs          
Mm          , Mm          , Mm          , Mm          , Hh          , Hh          , Gg          , Gg          , Re^Gvs      , Re^Gvs      , Gg          , Gg          , Rd          , Gg          , Re^Gvs      , Re^Gvs      , Gg          , Gg          , Gs^Fp       , Gs^Fp       , Gs^Fp       , Ss          , Ss          , Ss          , Gs^Fp       , Gs^Fp       , Gs          
Mm          , Mm          , Mm          , Mm          , Mm          , Mm          , Hh          , Gg          , Gg          , Gg^Vh       , Re^Gvs      , Re^Gvs      , Rd          , Gg          , Gg          , Gg          , Gs          , Ss          , Ss          , Gs^Fp       , Gg          , Gg          , Gs^Fp       , Ss          , Gs^Fp       , Gs^Fp       , Hh          
Mm          , Hh          , Hh          , Mm          , Gs          , Hh          , Gs^Fp       , Gs^Fp       , Gg          , Re^Gvs      , Gg          , Gg          , Gs          , Rr          , Rr          , Gs          , Ce          , Gs          , Gg          , Gg          , Gg          , Ss          , Ss          , Gs^Fp       , Hh          , Hh          , Hh          
Mm          , Hh          , Hh          , Gs          , Hh          , Gs^Fp       , Gs^Fp       , Gs^Fp       , Gg          , Gg          , Gg          , Gs          , Ce          , Gs          , Rr          , Ce          , Gs^Fp       , Gs^Fp       , Gg          , Ce          , Ce          , Ss          , Gg          , Gs^Fp       , Hh          , Gs^Fp       , Gs^Fp       
Mm          , Mm          , Hh          , Hh          , Gs^Fp       , Hh          , Hh          , Hh          , Gg          , Gg          , Ce          , Ce          , Gs^Fp       , Gs          , Rp          , Gg          , Gg^Vh       , Gs^Fp       , Gg          , Gg          , Gg          , Ce          , Gg          , Gg          , Gg          , Gg          , Gs^Fp       
Mm          , Mm          , Mm          , Hh          , Hh          , Gs^Fp       , Hh          , Hh          , Hh          , Hh          , Ce          , Gs^Fp       , Gs^Fp       , Gs          , Rp          , Gg          , Rr          , Gs^Fp       , Rp          , Gg^Vh       , Rr          , Gg          , Gs          , Gg          , Gg          , Gg          , Gg          
Hh          , Hh          , Hh          , Hh          , Hh          , Gg          , Hh          , Mm          , Mm          , Hh          , Gs^Fp       , Gs^Fp       , Gg^Vh       , Gs          , Rr          , Rr          , Rp          , Rp          , Rp          , Rp          , Gs^Fp       , Rr          , Rr          , Ce          , Gg          , Gs^Fp       , Gs^Fp       
Gg          , Hh          , Dd          , Gg          , Gs^Fp       , Gs^Fp       , Mm          , Mm          , Mm          , Gs^Fp       , Gs^Fp       , Gs^Fp       , Gg          , Gg          , Rr          , Gs^Fp       , Gg^Fet      , Chr         , 2 Kh        , Chr         , Gs^Fp       , Gg^Vh       , Rp          , Gg          , Gs          , Gs          , Gs^Fp       
Ds          , Ds          , Ds          , Ds          , Gg          , Gs^Fp       , Hh          , Mm          , Gs^Fp       , Hh          , Ce          , Gs^Fp       , Gg          , Gg          , Rp          , Gs^Fp       , Gs^Fp       , Chr         , Wwf         , Chr         , Gs^Fp       , Gs^Fp       , Rp          , Gs          , Hh          , Gs^Fp       , Gs^Fp       
Ds          , Ds          , Ds          , Ds          , Gs^Fp       , Hh          , Gg          , Hh          , Gs          , Ds          , Ce          , Gs^Fp       , Gg          , Gg^Vh       , Gg          , Rp          , Rr          , Wwf         , Wwf         , Wwf         , Rr          , Rr          , Gg^Vh       , Ce          , Hh          , Gs          , Gs^Fp       
Dd          , Dd          , Gs^Fp       , Gs^Fp       , Ds          , Gg          , Gs^Fp       , Gs^Fp       , Gs^Fp       , Gs          , Gs          , Ce          , Ce          , Gg          , Rp          , Rr          , Gg^Vh       , Rp          , Rp          , Rr          , Gs^Fp       , Gg          , Gg          , Ce          , Gg          , Gs          , Gg          
Ds          , Gs          , Gs          , Gs^Fp       , Ds          , Ds          , Dd          , Gs^Fp       , Ds          , Gs          , Gs          , Gg          , Rr          , Rp          , Gg          , Gg          , Gg          , Gg          , Gg          , Gg^Vh       , Gs^Fp       , Gg          , Gs^Fp       , Ce          , Gg          , Mm          , Hh          
Gg          , Ds          , Gs          , Gg          , Gs          , Ds          , Gs          , Gs^Fp       , Gs          , Gs          , Rd          , Rd          , Gg          , Gg          , Gg          , Ce          , Ce          , Gg          , Ce          , Gg          , Ce          , Gs^Fp       , Gs^Fp       , Gg          , Hh          , Hh          , Mm          
Gg          , Gg          , Gs          , Gs          , Gg          , Ds          , Gg          , Gs          , Rd          , 1 Rd        , Ds          , Dd          , Gg          , Gg          , Ds          , Gg          , Gg          , Ce          , Gg          , Ce          , Hh          , Hh          , Gs^Fp       , Gs^Fp       , Hh          , Mm          , Mm          
Ds          , Ds          , Ds          , Dd          , Ds          , Ds          , Rd          , Gg          , Dd          , Ds          , Ds          , Gg          , Dd          , Gs          , Gs^Fp       , Dd          , Gs^Fp       , Gg          , Gs^Fp       , Gs          , Hh          , Hh          , Hh          , Hh          , Mm          , Mm          , Mm          
Dd          , Ds          , Dd          , Ds          , Dd          , Rd          , Gs          , Gs          , Ds          , Ds          , Ds          , Gs          , Gs          , Ds          , Ds          , Gs^Fp       , Dd          , Dd          , Ds          , Gg          , Gg          , Hh          , Mm          , Mm          , Mm          , Mm          , Mm          
