border_size=1
usage=map

Sm          , Sm          , Ss          , Sm          , Sm          , Sm          , Sm          , Gs^Fmw      , Gs^Fmw      , Gs^Fmw      , Rd          , Gs^Fmw      , Hh          , Gs^Fmw      , Gs^Fmw      , Hh          , Hh          , Hh          , Mm          , Mm          , Mm          , Mm^Xm       , Mm^Xm       , Mm^Xm       , Mm^Xm       , Mm^Xm       , Mm^Xm       , Gg          , Mm          , Mm          , Wo          , Wo          , Mm^Xm       , Mm^Xm       , Mm^Xm       , Mm^Xm       , Mm^Xm       , Mm^Xm       , Mm^Xm       , Mm^Xm       , Mm^Xm       , Mm          
Ss          , Ss          , Ss          , Ss          , Ss^Vhs      , Sm          , Ss          , Gs^Fdw      , Ss          , Gs^Fmw      , Rd          , Gs^Fmw      , Gs^Fmw      , Hh          , Hh          , Gs^Fmw      , Gs^Fp       , Hh          , Hh          , Mm          , Mm^Vhh      , Mm          , Mm^Xm       , Mm^Xm       , Mm^Xm       , Mm^Xm       , Mm^Xm       , Mm          , Mm          , Wo          , Mm^Xm       , Mm          , Mm^Xm       , Mm^Xm       , Mm^Xm       , Mm^Xm       , Mm^Xm       , Mm^Xm       , Mm^Xm       , Mm^Xm       , Mm^Xm       , Mm          
Ss          , Ss          , Gs^Fp       , Ss          , Ss          , Ss          , Chs         , Chs         , Chr         , Gs^Fmw      , Rd          , Gs^Fmw      , Gg          , Gs^Fmf      , Hh          , Gs^Fmw      , Gs^Fmw      , Gs^Es       , Gs^Fp       , Hh          , Hh          , Mm          , Mm^Xm       , Mm^Xm       , Mm^Xm       , Mm^Xm       , Mm^Xm       , Mm          , Wo          , Wo          , Mm^Xm       , Mm^Xm       , Mm^Xm       , Mm^Xm       , Mm^Xm       , Mm^Xm       , Mm^Xm       , Mm^Xm       , Mm^Xm       , Mm^Xm       , Mm^Xm       , Mm          
Sm          , Sm          , Gs^Vct      , Gs^Fp       , Ss          , Chs         , Chs         , 3 Khr       , Chr         , Ss          , Rd          , Gs^Es       , Gg          , Gg          , Gs^Fp       , Hh          , Mm          , Gs          , Hh          , Hh          , Mm          , Mm^Xm       , Mm          , Mm          , Mm^Xm       , Mm^Xm       , Mm^Xm       , Wo          , Mm^Xm       , Mm^Xm       , Mm^Xm       , Mm^Xm       , Mm^Xm       , Mm^Xm       , Mm^Xm       , Mm^Xm       , Mm^Xm       , Mm^Xm       , Mm^Xm       , Mm^Xm       , Mm^Xm       , Mm^Xm       
Ss          , Sm          , Ss          , Ss          , Mm          , Ss          , Ss          , Chr         , Ss          , Ss          , Gs          , Re          , Rd          , Gg^Es       , Gg          , Hh          , Mm          , Mm          , Hh          , Hh          , Hh          , Mm          , Mm          , Hh          , Mm          , Mm          , Mm^Xm       , Wo          , Mm^Xm       , Mm^Xm       , Mm^Xm       , Mm^Xm       , Mm^Xm       , Mm^Xm       , Mm^Xm       , Mm^Xm       , Mm^Xm       , Mm^Xm       , Mm^Xm       , Mm^Xm       , Mm^Xm       , Mm^Xm       
Mm^Xm       , Mm          , Mm          , Hh          , Mm          , Hh          , Gs^Vct      , Ss          , Ss^Vhs      , Sm          , Sm          , Gg          , Gg          , Re          , Hh          , Mm          , Mm          , Mm^Xm       , Mm^Xm       , Mm          , Hh          , Mm^Xm       , Mm          , Hh          , Mm          , Mm^Xm       , Wo          , Wo          , Mm^Xm       , Mm^Xm       , Mm^Xm       , Mm^Xm       , Mm^Xm       , Mm^Xm       , Mm^Xm       , Mm^Xm       , Mm^Xm       , Mm^Xm       , Mm^Xm       , Mm^Xm       , Mm^Xm       , Mm^Xm       
Mm^Xm       , Mm^Xm       , Mm^Xm       , Mm          , Mm          , Hh          , Hh          , Hh          , Sm          , Sm          , Mm          , Hh          , Gs          , Re          , Gs          , Hh          , Mm          , Mm          , Mm^Xm       , Mm^Xm       , Mm          , Mm          , Mm^Xm       , Mm          , Wo          , Wo          , Mm^Xm       , Mm^Xm       , Mm^Xm       , Mm^Xm       , Mm^Xm       , Mm^Xm       , Mm          , Mm^Xm       , Mm^Xm       , Mm^Xm       , Mm^Xm       , Mm^Xm       , Mm^Xm       , Mm^Xm       , Mm^Xm       , Mm^Xm       
Mm^Xm       , Mm^Xm       , Mm^Xm       , Mm^Xm       , Mm          , Hh          , Hh          , Mm          , Gs^Fp       , Hh          , Hh          , Hh          , Gs          , Rd          , Gs^Fp       , Hh          , Mm          , Mm          , Mm          , Mm^Xm       , Mm^Xm       , Mm^Xm       , Mm^Xm       , Mm^Xm       , Wo          , Mm^Xm       , Mm^Xm       , Mm          , Mm          , Mm^Xm       , Mm^Xm       , Mm^Xm       , Mm          , Mm^Xm       , Mm          , Mm^Xm       , Mm^Xm       , Mm^Xm       , Mm^Xm       , Mm^Xm       , Mm          , Mm^Xm       
Mm          , Hh          , Mm          , Mm          , Hh          , Hh          , Mm          , Hh          , Gs^Fp       , Mm          , Gs^Fmf      , Gs          , Rd          , Rd          , Gs^Fmf      , Hh          , Hh          , Hh          , Mm          , Mm^Xm       , Mm          , Mm^Xm       , Mm^Xm       , Mm^Xm       , Wo          , Mm^Xm       , Mm^Xm       , Mm          , Mm          , Mm^Xm       , Mm          , Mm          , Mm          , Mm          , Mm          , Mm^Xm       , Mm          , Mm          , Mm^Xm       , Mm^Xm       , Mm          , Gll^Fp      
Mm          , Hh          , Mm          , Mm          , Hh          , Hh          , Mm          , Mm          , Hh          , Gs^Fp       , Gs          , Gs          , Gs          , Gs          , Hh          , Hh          , Mm          , Hh          , Mm^Xm       , Mm          , Mm          , Mm^Xm       , Mm^Xm       , Mm          , Mm^Xm       , Wo          , Mm^Xm       , Mm          , Mm          , Mm          , Mm          , Mm          , Mm          , Mm          , Mm          , Mm          , Mm          , Mm          , Mm          , Gll^Fp      , Mm          , Mm          
Mm^Xm       , Mm          , Mm^Xm       , Mm^Xm       , Mm          , Hh          , Hh          , Hh          , Gs^Fmf      , Gs          , Gs          , Gs          , Gs          , Hh          , Hh          , Hh          , Hh          , Mm          , Mm          , Mm          , Mm          , Mm^Xm       , Mm          , Mm          , Wo          , Wo          , Mm^Xm       , Mm          , Hh          , Mm          , Mm          , Mm          , Mm          , Mm          , Hh^Fp       , Mm          , Hh          , Mm          , Gll^Fp      , Mm          , Mm          , Mm          
Mm^Xm       , Mm^Xm       , Mm          , Mm          , Mm          , Hh          , Gs^Fp       , Gs^Fmf      , Gs^Fmf      , Gs^Fp       , Gs^Fp       , Re          , Gs          , Hh          , Gs^Fp       , Gs          , Gs^Fp       , Hh          , Mm          , Mm          , Gs^Fp       , Hh          , Hh          , Mm          , Ww          , Mm^Xm       , Mm^Xm       , Mm          , Hh          , Hh          , Hh^Fp       , Hh          , Hh          , Mm          , Hh          , Hh          , Hh^Fp       , Hh^Fp       , Hh^Fp       , Mm          , Hh          , Mm          
Mm^Xm       , Mm^Xm       , Mm          , Mm          , Hh          , Gs^Fmf      , Gs^Fp       , Gs^Fp       , Gs          , Gs          , Gs^Es       , Re          , Gg          , Gs          , Gs^Fmf      , Gs^Fmf      , Gs^Fp       , Gs          , Gs          , Hh          , Gs^Fmf      , Gs^Fp       , Gs^Es       , Mm          , Mm          , Wo          , Mm          , Hh^Fp       , Hh^Fp       , Hh          , Hh          , Hh          , Hh          , Mm          , Hh          , Hh          , Hh          , Hh          , Hh^Fp       , Hh^Fp       , Hh          , Hh          
Mm^Xm       , Mm^Xm       , Mm          , Hh          , Hh          , Gs^Fmf      , Gs^Fp       , Gg          , Gs^Fp       , Gg          , Gg          , Re          , Gg          , Gg^Vl       , Gs^Fp       , Gs^Fmf      , Wwf         , Wwf         , Gs^Fp       , Gs^Fmf      , Hh          , Hh^Fmf      , Gs^Fp       , Mm          , Wo          , Wo          , Hh          , Gll^Fp      , Hh          , Hh          , Hh^Fp       , Hh^Fmf      , Hh          , Hh          , Hh          , Gll^Fp      , Gll^Fp      , Hh          , Hh^Fp       , Hh^Fp       , Hh^Fmf      , Hh          
Mm^Xm       , Mm          , Mm          , Hh          , Hh          , Gs^Fp       , Gs^Fp       , Gs^Fp       , Re^Gvs      , Re^Gvs      , Gg          , Rp          , Re          , Gg          , Re^Gvs      , Gs^Fp       , Wwf         , Ww          , Wwf         , Gg          , Ww          , Gs^Fmf      , Gs^Fdf      , Hh          , Ww          , Gs^Fmw      , Gs^Fmf      , Gg          , Hh^Fp       , Gg          , Gll^Fmf     , Hh          , Hh          , Gll^Fmf     , Gll^Fmf     , Gll^Fp      , Gll^Fmf     , Gs          , Gll^Fp      , Hh^Fmf      , Gll^Fmf     , Gll^Fp      
Mm^Xm       , Mm^Xm       , Mm^Xm       , Mm          , Mm          , Hh          , Wwf         , Re^Gvs      , Gg          , Gg^Wm       , Re^Gvs      , Gg          , Re          , Re^Gvs      , Wwf         , Wwf         , Gg          , Ww          , Ww          , Ww          , Gg^Es       , Ww          , Ww          , Ww          , Gll^Fmf     , Gll^Fmf     , Gs^Fmf      , Hh^Fp       , Gll^Fp      , Gs          , Gll^Fp      , Gll^Fmf     , Gll^Fp      , Gll^Fmf     , Gll^Fp      , Gll^Fp      , Gll^Fmf     , Gll^Fmf     , Gll^Fmf     , Gll^Fmf     , Gll^Fp      , Gll^Fmf     
Mm^Xm       , Mm^Xm       , Mm          , Mm          , Hh          , Hh          , Gg          , Wwf         , Re^Gvs      , Re^Gvs      , Gg          , Gg          , Rp          , Wwf         , Re^Gvs      , Re^Gvs      , Gg          , Ww          , Wwf         , Gs^Fmf      , Gs^Fmf      , Ww          , Ww          , Ss          , Gll^Fmf     , Gll^Fmf     , Gs^Fmw      , Gll^Fp      , Gll^Fp      , Gll^Fp      , Gll^Fmf     , Gll^Fp      , Gll^Fp      , Gll^Fp      , Gll^Fmf     , Gs^Vl       , Gll^Fp      , Gll^Fp      , Gll^Fp      , Gll^Fp      , Gg          , Gg          
Mm          , Mm          , Mm          , Mm^Xm       , Mm          , Mm          , Hh          , Wwf         , Wwf         , Gg^Vl       , Re^Gvs      , Re^Gvs      , Wwf         , Wwf         , Gg          , Gg^Wm       , Gs          , Wwf         , Gs^Fp       , Ss          , Ss          , Ww          , Ww          , Ss          , Gll^Fmf     , Gll^Fmf     , Gll^Fmf     , Gll^Fmf     , Gll^Fmf     , Gll^Fmf     , Gg          , Gll^Fp      , Gs          , Gll^Fp      , Gll^Fmf     , Gll^Fp      , Gll^Fp      , Gs^Vl       , Rp          , Gg          , Rp          , Rp          
Mm          , Hh          , Hh          , Mm          , Gs^Uf       , Hh          , Gs^Fp       , Gs^Fp       , Wwf         , Re^Gvs      , Wwf         , Wwf         , Gs          , Rr          , Rr          , Gs          , Ch          , Gs^Fmf      , Gs^Fp       , Gs^Fp       , Gs^Fmw      , Ww          , Ww          , Gs^Fdf      , Hh          , Hh          , Gll^Fmf     , Gll^Fp      , Gll^Fmf     , Ch          , Ch          , Gs          , Gs          , Gg^Efm      , Gs          , Gs          , Rp          , Rp          , Rp          , Rp          , Gs          , Gs          
Mm^Xm       , Hh          , Hh          , Gs^Uf       , Hh          , Gs^Fp       , Gs^Fp       , Gs^Fp       , Gg          , Wwf         , Gg          , Gs          , Ch          , Gs^Es       , Rr          , Ch          , Gll^Fmf     , Gs^Fp       , Gs          , Gg          , Gs^Vh       , Ww          , Ww          , Gs^Fp       , Rrc         , Gll^Fmf     , Rrc         , Gg          , Gg          , Kh          , Ch          , Gs          , Gs          , Gg          , Rr          , Rp          , Gs^Efm      , Gs          , Gll^Fp      , Gs          , Gll^Fp      , Gll^Fp      
Mm^Xm       , Mm          , Hh          , Hh          , Gs^Fp       , Hh          , Hh          , Hh          , Gg          , Gg          , Ch          , Ch          , Gll^Fmf     , Gs          , Rrc         , Gs          , Gll^Fmf     , Gll^Fmf     , Gs          , Gs          , Gs          , Gs          , Ww^Bsb/     , Rrc         , Rrc         , Rrc         , Gs^Fp       , Rrc         , Rrc         , Gg          , Gs          , Ch          , Gs          , Gs          , Rr          , Rp          , Gs          , Gs          , Gll^Fmf     , Gll^Fp      , Hh^Fp       , Gll^Fp      
Mm          , Mm          , Mm          , Hh          , Hh^Fp       , Gs^Fp       , Hh          , Hh          , Hh          , Hh          , Ch          , Gll^Fmf     , Gll^Fmf     , Gs          , Rrc         , Gs          , Rrc         , Gll^Fmf     , Rrc         , Rrc         , Rrc         , Rrc         , Ww          , Ww          , Gs          , Gg          , Gs          , Gs          , Rrc         , Gs^Vh       , Gs          , Gs          , Rr          , Rr          , Gg          , Gg^Efm      , Gg          , Gll^Fmf     , Gll^Fp      , Hh^Fmf      , Hh^Fp       , Gll^Fp      
Hh          , Hh          , Hh          , Hh          , Gll^Fp      , Gg^Fp       , Hh          , Mm^Xm       , Mm          , Gll^Fp      , Gll^Fp      , Gll^Fmf     , Gs^Vh       , Gs          , Gs          , Rrc         , Rrc         , Rrc         , Gs          , Gs          , Ch          , Ch          , Gg^Fet      , Ww          , Ww          , Gg          , Gs          , Gs          , Gg          , Rrc         , Rrc         , Rr          , Gg          , Ch          , Gll^Fp      , Gg          , Hh          , Hh          , Hh^Fp       , Hh^Fp       , Hh          , Hh          
Gg          , Hh          , Gd          , Gll^Fp      , Gll^Fp      , Gll^Fp      , Mm          , Mm^Xm       , Mm          , Gll^Fp      , Gll^Fp      , Gll^Fmf     , Gg          , Gg^Efm      , Gs          , Gs          , Rrc         , Rrc         , Gs          , Gll^Fmf     , Ch          , 2 Kh        , Ch          , Ch          , Gg          , Ww          , Ww          , Gg          , Rrc         , Rrc         , Gs          , Gs          , Kh          , Ch          , Gg          , Gll^Fp      , Hh^Fp       , Hh^Fp       , Mm          , Hh^Fp       , Hh          , Mm          
Gd          , Gd^Es       , Gd          , Gll^Fp      , Gll^Fp      , Gll^Fp      , Hh          , Mm          , Gs^Fp       , Hh          , Ch          , Gll^Fmf     , Gg          , Gg          , Gs^Efm      , Gs          , Rrc         , Rrc         , Gll^Fp      , Gll^Fp      , Gll^Fp      , Gll^Fp      , Gll^Fp      , Gs          , Gg          , Gg          , Rrc         , Ww^Bsb/     , Ww          , Gg          , Gs          , Gs          , Ch          , Ch          , Gll^Fp      , Gll^Fp      , Hh          , Mm          , Mm          , Mm          , Md          , Md          
Gd          , Gd          , Gd          , Gd          , Gll^Fp      , Hh          , Gll^Fp      , Hh          , Gs          , Ds          , Ch          , Gll^Fmf     , Gs          , Gs          , Gs          , Gs          , Rrc         , Rrc         , Rrc         , Gll^Fp      , Gs          , Gll^Fp      , Gs          , Gs          , Rrc         , Rrc         , Gs^Vh       , Gg          , Ww          , Gs          , Hh          , Ch          , Hh          , Gll^Fp      , Hh^Fp       , Hh^Fp       , Mm          , Mm          , Mm          , Md          , Md          , Md          
Gd          , Gd^Es       , Gd^Fdf      , Gll^Fmf     , Gd          , Gll^Fmf     , Gll^Fmf     , Gll^Fp      , Gs^Fmf      , Gs          , Gs          , Ch          , Ch          , Gs          , Rr          , Rrc         , Rrc         , Rrc         , Gg          , Rrc         , Rrc         , Rrc         , Rrc         , Rrc         , Gg^Efm      , Gs          , Gs          , Gs          , Ww          , Mm          , Mm          , Hh^Fp       , Hh          , Hh^Fp       , Hh          , Mm          , Mm          , Mm          , Md          , Md          , Md          , Md          
Gd          , Gs          , Gs          , Gll^Fmf     , Gd          , Gd          , Dd          , Gd^Fdf      , Gs^Fmf      , Gd^Fdf      , Gs          , Gg          , Rr          , Rp          , Rr          , Rrc         , Gs          , Gs^Es       , Gs          , Gs^Vh       , Gs^Fmf      , Gs^Fmf      , Gs^Fp       , Gg          , Gg          , Gs          , Hh          , Gg          , Md          , Ww          , Ww          , Hh          , Mm          , Mm          , Mm          , Mm          , Md^Xm       , Md          , Md          , Md^Xm       , Md^Xm       , Md          
Gg          , Gd          , Gs^Es       , Gd^Fdf      , Gs          , Gd          , Gs          , Gd^Fdf      , Gs          , Gs          , Rd          , Rp          , Rp          , Rr          , Gs          , Ch          , Ch          , Kh          , Ch          , Gs          , Ch          , Gs^Fp       , Gs^Fp       , Gg          , Hh          , Hh^Fp       , Mm          , Md          , Md          , Md          , Md          , Ww          , Ww          , Md          , Md          , Mm          , Md          , Md^Xm       , Md^Xm       , Md          , Md^Xm       , Md          
Gg          , Gg          , Gs          , Gs          , Gg          , Gd^Es       , Gg          , Gs          , Rd          , 1 Rd        , Gd          , Rp          , Gg          , Gs          , Gd          , Gs          , Gs          , Ch          , Gs          , Ch          , Hh          , Hh          , Gs^Fp       , Gs^Fp       , Hh          , Mm          , Mm^Xm       , Md          , Md^Xm       , Md          , Md          , Ww          , Ww          , Md          , Md          , Md          , Md          , Md^Xm       , Md^Xm       , Md          , Md          , Md^Xm       
Gd^Es       , Gd          , Gd          , Gd          , Gd^Es       , Gd          , Re          , Re          , Gd^Es       , Gd          , Gd          , Gg^Es       , Gd          , Gs^Fmf      , Gs^Fdf      , Gd          , Gs^Fdf      , Gs          , Gs^Fp       , Gs          , Hh          , Hh          , Hh          , Hh          , Mm          , Mm          , Mm^Xm       , Md          , Md          , Md^Xm       , Md          , Md          , Ww          , Ww          , Md          , Md          , Md^Xm       , Md^Xm       , Md^Xm       , Md^Xm       , Md^Xm       , Md^Xm       
Dd          , Gd          , Dd          , Gd          , Dd          , Rd          , Gs          , Gs          , Gd          , Gd          , Gd^Es       , Gs          , Gs          , Gd          , Gd^Es       , Gs^Fmf      , Gd          , Gd          , Gd          , Gs^Fmf      , Gg          , Hh          , Mm          , Mm          , Mm^Xm       , Mm^Xm       , Mm^Xm       , Md^Xm       , Md^Xm       , Md^Xm       , Md^Xm       , Md          , Md          , Ww          , Ww          , Md          , Md          , Md^Xm       , Md^Xm       , Md^Xm       , Md^Xm       , Md^Xm       
