border_size=1
usage=map

Hh          , Hh          , Ss          , Hh          , Ss          , Hh          , Hh          , Gs^Fmw      , Gs^Fmw      , Gs^Fmw      , Rd          , Gs^Fmw      , Hh          , Gs^Fmw      , Gs^Fmw      , Hh          , Hh          , Hh          , Mm          , Mm          , Mm          , Mm^Xm       , Mm^Xm       , Mm^Xm       , Mm^Xm       , Mm^Xm       , Mm^Xm       
Ss          , Ss          , Ss          , Ss          , Ss^Vhs      , Ss          , Ss          , Gs^Fdw      , Ss^Vhs      , Gs^Fmw      , Rd          , Gs^Fmw      , Gs^Fmw      , Hh          , Hh          , Gs^Fmw      , Gs^Fp       , Hh          , Hh          , Mm          , Mm^Vhh      , Mm          , Mm^Xm       , Mm^Xm       , Mm^Xm       , Mm^Xm       , Mm^Xm       
Hh          , Ss          , Gs^Fp       , Ss          , Ss          , Ss          , Chs         , Chs         , Chr         , Gs^Fmw      , Rd          , Gs^Fmw      , Gg          , Gs^Fmf      , Hh          , Gs^Fmw      , Gs^Fmw      , Gs          , Gs^Fp       , Hh          , Hh          , Mm          , Mm^Xm       , Mm^Xm       , Mm^Xm       , Mm^Xm       , Mm^Xm       
Mm          , Hh          , Hh^Vhh      , Gs^Fp       , Gg          , Chs         , Chs         , 3 Khr       , Chr         , Gs          , Rd          , Gs          , Gg          , Gg          , Gs^Fp       , Hh          , Mm          , Gs          , Hh          , Hh          , Mm          , Mm^Xm       , Mm          , Mm          , Mm^Xm       , Mm^Xm       , Mm^Xm       
Mm^Xm       , Hh          , Hh          , Gs^Fp       , Re^Vct      , Gg          , Gg          , Chr         , Gs          , Gs          , Gg^Vl       , Re          , Rd          , Gg          , Gg          , Hh          , Mm          , Mm          , Hh          , Hh          , Hh          , Mm          , Mm          , Hh          , Mm          , Mm          , Mm^Xm       
Mm^Xm       , Mm          , Mm          , Hh          , Mm          , Hh          , Mm^Vhh      , Hh          , Mm          , Hh          , Hh          , Gg          , Gg          , Re          , Hh          , Mm          , Mm          , Mm^Xm       , Mm^Xm       , Mm          , Hh          , Mm^Xm       , Mm          , Hh          , Mm          , Mm^Xm       , Mm          
Mm^Xm       , Mm^Xm       , Mm^Xm       , Mm          , Mm          , Hh          , Hh          , Hh          , Mm^Xm       , Mm^Xm       , Mm^Xm       , Hh          , Gs          , Re          , Gs          , Hh          , Mm          , Mm          , Mm^Xm       , Mm^Xm       , Mm          , Mm          , Mm^Xm       , Mm          , Mm          , Hh          , Mm^Xm       
Mm^Xm       , Mm^Xm       , Mm^Xm       , Mm^Xm       , Mm^Xm       , Mm          , Mm^Xm       , Mm^Xm       , Gs^Fp       , Mm^Xm       , Hh          , Hh          , Gs          , Rd          , Gs^Fp       , Hh          , Mm          , Mm          , Mm          , Mm^Xm       , Mm^Xm       , Mm^Xm       , Mm^Xm       , Mm^Xm       , Mm^Xm       , Mm^Xm       , Mm^Xm       
Mm          , Hh          , Hh          , Mm^Xm       , Mm^Xm       , Mm^Xm       , Mm^Xm       , Hh          , Gs^Fp       , Mm^Xm       , Gs^Fmf      , Gs          , Rd          , Rd          , Gs^Fmf      , Hh          , Hh          , Hh          , Mm          , Mm^Xm       , Mm          , Mm^Xm       , Mm^Xm       , Mm^Xm       , Wo          , Mm^Xm       , Mm^Xm       
Mm          , Hh          , Mm^Xm       , Mm^Xm       , Mm^Xm       , Mm^Xm       , Mm^Xm       , Mm          , Hh          , Gs^Fp       , Gs          , Gs          , Gs          , Gs          , Hh          , Hh          , Mm          , Hh          , Mm^Xm       , Mm          , Mm          , Mm^Xm       , Mm^Xm       , Mm          , Mm^Xm       , Wo          , Mm^Xm       
Mm^Xm       , Mm          , Mm^Xm       , Mm^Xm       , Mm          , Hh          , Hh          , Hh          , Gs^Fmf      , Gs          , Gs          , Gs          , Gs          , Hh          , Hh          , Hh          , Hh          , Mm          , Mm          , Mm          , Mm          , Mm^Xm       , Mm          , Mm          , Wo          , Wo          , Mm^Xm       
Mm^Xm       , Mm^Xm       , Mm          , Mm          , Mm          , Hh          , Gs^Fp       , Gs^Fmf      , Gs^Fmf      , Gs^Fp       , Gs^Fp       , Re          , Gs          , Hh          , Gs^Fp       , Gs          , Gs^Fp       , Hh          , Mm          , Mm          , Gs^Fp       , Hh          , Hh          , Mm          , Ww          , Mm^Xm       , Mm^Xm       
Mm^Xm       , Mm^Xm       , Mm          , Mm          , Hh          , Gs^Fmf      , Gs^Fp       , Gs^Fp       , Gs          , Gs          , Gs          , Re          , Gg          , Gs          , Gs^Fmf      , Gs^Fmf      , Gs^Fp       , Gs          , Gs          , Hh          , Gs^Fmf      , Gs^Fp       , Gs^Uf       , Mm          , Mm          , Wo          , Mm          
Mm^Xm       , Mm^Xm       , Mm          , Hh          , Hh          , Gs^Fmf      , Gs^Fp       , Gg          , Gs^Fp       , Gg          , Gg          , Re          , Gg          , Gg^Vl       , Gs^Fp       , Gs^Fmf      , Wwf         , Wwf         , Gs^Fp       , Gs^Fmf      , Hh          , Hh^Fmf      , Gs^Fp       , Mm          , Wo          , Wo          , Hh          
Mm^Xm       , Mm          , Mm          , Hh          , Hh          , Gs^Fp       , Gs^Fp       , Gs^Fp       , Rd^Gvs      , Rd^Gvs      , Gg          , Rp          , Re          , Gg          , Rd^Gvs      , Gs^Fp       , Wwf         , Ww          , Wwf         , Gg          , Ww          , Gs^Fmf      , Gs^Fdf      , Hh          , Ww          , Gs^Fmw      , Gs^Fmf      
Mm^Xm       , Mm^Xm       , Mm^Xm       , Mm          , Mm          , Hh          , Wwf         , Rd^Gvs      , Gg          , Gg^Wm       , Rd^Gvs      , Gg          , Re          , Rd^Gvs      , Wwf         , Wwf         , Gg          , Ww          , Ww          , Ww          , Gg^Uf       , Ww          , Ww          , Ww          , Gs^Fmf      , Gs^Fmw      , Gs^Fmf      
Mm^Xm       , Mm^Xm       , Mm          , Mm          , Hh          , Hh          , Gg          , Wwf         , Rd^Gvs      , Rd^Gvs      , Gg          , Gg          , Rp          , Wwf         , Rd^Gvs      , Rd^Gvs      , Gg          , Ww          , Wwf         , Gs^Fmf      , Gs^Fmf      , Ww          , Wwf         , Ss          , Gs^Fmf      , Gs^Fdf      , Gs^Fmw      
Mm          , Mm          , Mm          , Mm^Xm       , Mm          , Mm          , Hh          , Wwf         , Wwf         , Gg^Vl       , Rd^Gvs      , Rd^Gvs      , Wwf         , Wwf         , Gg          , Gg^Wm       , Gs          , Wwf         , Gs^Fp       , Ss          , Ss          , Ww          , Wwf         , Ss          , Gs^Fmf      , Gs^Fmw      , Hh          
Mm          , Hh          , Hh          , Mm          , Gs^Uf       , Hh          , Gs^Fp       , Gs^Fp       , Wwf         , Rd^Gvs      , Wwf         , Wwf         , Gs          , Rr          , Rr          , Gs          , Ce          , Gs^Fmf      , Gs^Fp       , Gs^Fp       , Gs^Fmw      , Wwf         , Wwf         , Gs^Fdf      , Hh          , Hh          , Hh          
Mm^Xm       , Hh          , Hh          , Gs^Uf       , Hh          , Gs^Fp       , Gs^Fp       , Gs^Fp       , Gg          , Wwf         , Gg          , Gs          , Ce          , Gs          , Rr          , Ce          , Gs^Fp       , Gs^Fp       , Gg          , Ce          , Ce          , Wwf         , Wwf         , Gs^Fp       , Hh          , Gs^Fp       , Gs^Fp       
Mm^Xm       , Mm          , Hh          , Hh          , Gs^Fp       , Hh          , Hh          , Hh          , Gg          , Gg          , Ce          , Ce          , Gs^Fp       , Gs          , Rp          , Gg          , Gg          , Gs^Fp       , Gg          , Gg          , Gg          , Ce          , Wwf         , Gg          , Gg          , Gg          , Gs^Fp       
Mm          , Mm          , Mm          , Hh          , Hh          , Gs^Fp       , Hh          , Hh          , Hh          , Hh          , Ce          , Gs^Fp       , Gs^Fp       , Gs          , Rp          , Gg          , Rr          , Gs^Fp       , Rp          , Gg^Vh       , Rr          , Wwf         , Gs          , Gg          , Gg          , Gg          , Gg          
Hh          , Hh          , Hh          , Hh          , Hh          , Gg          , Hh          , Mm^Xm       , Mm          , Hh          , Gs^Fp       , Gs^Fmf      , Gg^Vh       , Gs          , Rr          , Rr          , Rp          , Rp          , Rp          , Rp          , Gs^Fp       , Wwf         , Rr          , Ce          , Gg          , Gs^Fp       , Gs^Fp       
Gg          , Hh          , Dd          , Gg          , Gs^Fp       , Gs^Fp       , Mm          , Mm^Xm       , Mm          , Gs^Fp       , Gs^Fp       , Gs^Fmf      , Gg          , Rp          , Rr          , Gs^Fp       , Gg^Fet      , Chr         , 2 Kh        , Chr         , Wwf         , Wwf         , Rp          , Gg          , Gs          , Gs          , Gs^Fp       
Ds          , Ds          , Ds          , Ds          , Gg          , Gs^Fp       , Hh          , Mm          , Gs^Fp       , Hh          , Ce          , Gs^Fp       , Gg          , Gg          , Rp          , Gs^Fms      , Gs^Fp       , Chr         , Wwf         , Chr         , Gs^Fp       , Gs^Fp       , Rp          , Gs          , Hh          , Gs^Fp       , Gs^Fp       
Ds          , Ds          , Ds          , Ds          , Gs^Fp       , Hh          , Gg          , Hh          , Gs          , Ds          , Ce          , Gs^Fp       , Gg          , Gg          , Gg          , Rp          , Rr          , Gs          , Gs          , Gs          , Rr          , Rr          , Gg          , Ce          , Hh          , Gs          , Gs^Fp       
Dd          , Dd          , Gs^Fdf      , Gs^Fmf      , Ds          , Gs^Fmf      , Gs^Fmf      , Gs^Fp       , Gs^Fmf      , Gs          , Gs          , Ce          , Ce          , Gg          , Rp          , Rr          , Gg          , Rp          , Rp          , Rr          , Gs^Fmf      , Gg          , Gg          , Ce          , Gg          , Gs          , Gg          
Ds          , Gs          , Gs          , Gs^Fmf      , Ds          , Ds          , Dd          , Gs^Fdf      , Gs^Fmf      , Gs^Fdf      , Gs          , Gg          , Rr          , Rp          , Gg          , Gg          , Gg          , Gg          , Gg          , Gg^Vh       , Gs^Fmf      , Gs^Fmf      , Gs^Fp       , Ce          , Gg          , Mm          , Hh          
Gg          , Ds          , Gs          , Gs^Fdf      , Gs          , Ds          , Gs          , Gs^Fdf      , Gs          , Gs          , Rd          , Rd          , Gg          , Gg          , Gg          , Ce          , Ce          , Gg          , Ce          , Gg          , Ce          , Gs^Fp       , Gs^Fp       , Gg          , Hh          , Hh          , Mm          
Gg          , Gg          , Gs          , Gs          , Gg          , Ds          , Gg          , Gs          , Rd          , 1 Rd        , Ds          , Dd          , Gg          , Gg          , Ds          , Gg          , Gg          , Ce          , Gg          , Ce          , Hh          , Hh          , Gs^Fp       , Gs^Fp       , Hh          , Mm          , Mm^Xm       
Ds          , Ds          , Ds          , Dd          , Ds          , Ds          , Rd          , Gg          , Dd          , Ds          , Ds          , Gg          , Dd          , Gs^Fmf      , Gs^Fdf      , Dd          , Gs^Fdf      , Gg          , Gs^Fp       , Gs          , Hh          , Hh          , Hh          , Hh          , Mm          , Mm          , Mm^Xm       
Dd          , Ds          , Dd          , Ds          , Dd          , Rd          , Gs          , Gs          , Ds          , Ds          , Ds          , Gs          , Gs          , Ds          , Ds          , Gs^Fmf      , Dd          , Dd          , Ds          , Gs^Fmf      , Gg          , Hh          , Mm          , Mm          , Mm^Xm       , Mm^Xm       , Mm^Xm       
