border_size=1
usage=map

Mm          , Mm          , Mm          , Mm          , Mm          , Mm          , Hh          , Gs^Fp       , Gs^Fp       , Gs          , Rd          , Gs          , Hh          , Gs          , Gs^Fp       , Hh          , Hh          , Hh          , Mm          , Mm          , Mm          , Mm^Xm       , Mm^Xm       , Mm^Xm       , Mm^Xm       , Mm^Xm       , Mm^Xm       
Mm          , Mm          , Hh          , Mm^Vhh      , Gg          , Hh          , Gg          , Gg          , Gs^Vht      , Gs^Fp       , Rd          , Gg          , Hh          , Hh          , Hh          , Gs^Fp       , Gs^Fp       , Hh          , Hh          , Mm          , Mm^Vhh      , Mm          , Mm^Xm       , Mm^Xm       , Mm          , Mm          , Mm          
Mm          , Hh          , Gs^Fp       , Hh          , Gg          , Gg          , Ch          , Ch          , Ch          , Gs          , Rd          , Gg          , Gg          , Gg          , Hh          , Gs^Fp       , Gs^Fp       , Gs          , Gs^Fp       , Hh          , Hh          , Mm          , Mm^Xm       , Mm^Xm       , Mm^Xm       , Mm          , Mm          
Mm          , Hh          , Hh          , Gs^Fp       , Gg          , Ch          , Ch          , 3 Kh        , Ch          , Gs          , Rd          , Gs          , Gs^Vht      , Gg          , Gs^Fp       , Hh          , Mm          , Gs          , Hh          , Hh          , Mm          , Mm^Xm       , Mm          , Mm          , Mm^Xm       , Mm^Xm       , Mm          
Mm^Xm       , Hh          , Hh          , Gs^Fp       , Gs^Vht      , Gg          , Gg          , Ch          , Gs          , Gs          , Gs^Vht      , Re          , Rd          , Gg          , Gg          , Hh          , Mm          , Mm          , Hh          , Hh          , Hh          , Mm          , Mm          , Hh          , Mm          , Mm          , Mm          
Mm^Xm       , Mm          , Mm          , Hh          , Mm          , Hh          , Mm^Vhh      , Hh          , Mm^Xm       , Mm^Xm       , Mm^Xm       , Gg          , Gg          , Re          , Hh          , Mm          , Mm          , Mm^Xm       , Mm^Xm       , Mm          , Hh          , Mm^Xm       , Mm          , Hh          , Mm          , Mm^Xm       , Mm          
Mm^Xm       , Mm^Xm       , Mm^Xm       , Mm^Xm       , Mm^Xm       , Hh          , Mm^Xm       , Mm^Xm       , Mm          , Hh          , Hh          , Hh          , Gg          , Re          , Gs          , Hh          , Mm          , Mm          , Mm^Xm       , Mm^Xm       , Mm          , Mm          , Mm^Xm       , Mm          , Mm          , Hh          , Mm^Xm       
Mm^Xm       , Mm^Xm       , Mm^Xm       , Mm^Xm       , Mm^Xm       , Mm^Xm       , Mm^Xm       , Hh          , Gs^Fp       , Hh          , Hh          , Hh          , Gg          , Rd          , Gs^Fp       , Hh          , Mm          , Mm          , Mm          , Mm^Xm       , Mm^Xm       , Mm^Xm       , Mm^Xm       , Mm^Xm       , Mm^Xm       , Mm^Xm       , Mm^Xm       
Mm          , Hh          , Hh          , Mm^Xm       , Mm^Xm       , Mm^Xm       , Mm^Xm       , Hh          , Gs^Fp       , Mm^Xm       , Gs^Fds      , Gg          , Rd          , Rd          , Gs^Fds      , Hh          , Hh          , Hh          , Mm          , Mm^Xm       , Mm          , Mm^Xm       , Mm^Xm       , Mm^Xm       , Mm^Xm       , Mm^Xm       , Mm^Xm       
Mm          , Hh          , Mm^Xm       , Mm^Xm       , Mm^Xm       , Mm^Xm       , Mm^Xm       , Mm          , Hh          , Gs^Fp       , Gg          , Gg          , Gs          , Gs          , Hh          , Hh          , Mm          , Hh          , Mm^Xm       , Mm          , Mm          , Mm^Xm       , Mm^Xm       , Mm          , Mm^Xm       , Mm^Xm       , Mm^Xm       
Mm          , Mm          , Mm^Xm       , Mm^Xm       , Mm          , Hh          , Hh          , Hh          , Gs^Fds      , Gs          , Gs^Vht      , Gg          , Gg          , Hh          , Hh          , Hh          , Hh          , Mm          , Mm          , Mm          , Mm          , Mm^Xm       , Mm          , Mm          , Mm          , Mm^Xm       , Mm^Xm       
Mm^Xm       , Mm^Xm       , Mm          , Mm          , Mm          , Hh          , Gs^Fp       , Gs^Fds      , Gs^Fds      , Gs^Fp       , Gs^Fp       , Re          , Gg          , Hh          , Gs^Fp       , Gs          , Gs^Fp       , Hh          , Mm          , Mm          , Gs^Fp       , Hh          , Hh          , Mm          , Hh          , Mm^Xm       , Mm^Xm       
Mm^Xm       , Mm^Xm       , Mm          , Mm          , Hh          , Gs^Fds      , Gs^Fp       , Gs^Fp       , Gs          , Gs          , Gs          , Re          , Gg          , Gs          , Gs^Fds      , Gs^Fds      , Gs^Fp       , Gs          , Gs          , Hh          , Gs^Fds      , Gs^Fp       , Gs^Uf       , Mm          , Mm          , Hh          , Mm          
Mm^Xm       , Mm^Xm       , Mm          , Hh          , Hh          , Gs^Fds      , Gs^Fp       , Gg          , Gs^Fp       , Gg          , Gg          , Re          , Gg          , Gs^Vht      , Gs^Fp       , Gs^Fds      , Wwr         , Wwr         , Gs^Fp       , Gs^Fdf      , Hh          , Gg^Vh       , Gs^Fp       , Mm          , Hh          , Hh          , Hh          
Mm^Xm       , Mm          , Mm          , Hh          , Gs          , Gs^Fp       , Gs^Fp       , Gs^Fp       , Rd^Gvs      , Rd^Gvs      , Gg          , Re          , Re          , Gg          , Rd^Gvs      , Gs^Fp       , Wwf         , Ww          , Wwr         , Gg          , Gg^Uf       , Gs^Fdf      , Gs^Fdf      , Hh          , Gs^Uf       , Gs^Fdf      , Gs^Fp       
Mm^Xm       , Mm^Xm       , Mm^Xm       , Mm          , Mm          , Hh          , Gg          , Rd^Gvs      , Gg          , Gg^Wm       , Rd^Gvs      , Gg          , Re          , Rd^Gvs      , Gg          , Gg^Wm       , Gg          , Ww          , Ww          , Gg          , Gg^Uf       , Ss          , Ss          , Gs^Uf       , Gs^Fdf      , Gs          , Gs          
Mm          , Mm^Xm       , Mm          , Mm          , Hh          , Hh          , Gg          , Gg          , Rd^Gvs      , Rd^Gvs      , Gg          , Gg          , Re          , Gg          , Rd^Gvs      , Rd^Gvs      , Gg          , Ww          , Wwr         , Gs^Fds      , Gs^Fdf      , Ss          , Wwr         , Ss          , Gs^Fds      , Gs^Fdf      , Gs          
Mm          , Mm          , Mm          , Mm^Xm       , Mm          , Mm          , Hh          , Gg          , Gg          , Gg^Vh       , Rd^Gvs      , Rd^Gvs      , Re          , Gg          , Gg          , Gg          , Gs          , Wwf         , Wwr         , Gs^Fdf      , Gg          , Gg          , Wwr         , Ss          , Gs^Fds      , Gs^Fp       , Hh          
Mm          , Hh          , Hh          , Mm          , Gs^Uf       , Hh          , Gs^Fp       , Gs^Fp       , Gg          , Rd^Gvs      , Gg          , Gg          , Gs          , Rr          , Rr          , Gs          , Ce          , Gs          , Gg          , Gg          , Gg          , Ww          , Wwf         , Gs^Fdf      , Hh          , Hh          , Hh          
Mm^Xm       , Hh          , Hh          , Gs^Uf       , Hh          , Gs^Fp       , Gs^Fp       , Gs^Fp       , Gg          , Gg          , Gg          , Gs          , Ce          , Gs          , Rr          , Ce          , Gs^Fp       , Gs^Fp       , Gg          , Ce          , Ce          , Ww          , Gg          , Gs^Fp       , Hh          , Gs^Fp       , Gs^Fp       
Mm^Xm       , Mm          , Hh          , Hh          , Gs^Fp       , Hh          , Hh          , Hh          , Gg          , Gg          , Ce          , Ce          , Gs^Fp       , Gs          , Rp          , Gg          , Gg          , Gs^Fp       , Gg          , Gg          , Gg          , Ce          , Gg          , Gg          , Gg          , Gg          , Gs^Fp       
Mm          , Mm          , Mm          , Hh          , Hh          , Gs^Fp       , Hh          , Hh          , Hh          , Hh          , Ce          , Gs^Fp       , Gs^Fp       , Gs          , Rp          , Gg          , Rr          , Gs^Fp       , Rp          , Gg^Vh       , Rr          , Gg          , Gs          , Gg          , Gg          , Gg          , Gg          
Hh          , Hh          , Hh          , Hh          , Hh          , Gg          , Hh          , Mm^Xm       , Mm          , Hh          , Gs^Fp       , Gs^Fds      , Rp^Vhc      , Gs          , Rr          , Rr          , Rp          , Rp          , Rp          , Rp          , Gs^Fp       , Rr          , Rr          , Ce          , Gg          , Gs^Fp       , Gs^Fp       
Gg          , Hh          , Dd          , Gg          , Gs^Fp       , Gs^Fp       , Mm          , Mm^Xm       , Mm          , Gs^Fp       , Gs^Fp       , Gs^Fds      , Gg          , Rp          , Rr          , Gs^Fp       , Gg^Fet      , Chr         , 2 Kh        , Chr         , Gs^Fp       , Wwr         , Rp          , Gg          , Gs          , Gs          , Gs^Fp       
Ds          , Ds          , Ds          , Ds          , Gg          , Gs^Fp       , Hh          , Mm          , Gs^Fp       , Hh          , Ce          , Gs^Fp       , Gg          , Gg          , Rp          , Gs^Fds      , Gs^Fp       , Chr         , Wwr         , Chr         , Gs^Fp       , Gs^Fp       , Rp          , Gs          , Hh          , Gs^Fp       , Gs^Fp       
Ds          , Ds          , Ds          , Ds          , Gs^Fp       , Hh          , Gg          , Hh          , Gs          , Ds          , Ce          , Gs^Fp       , Gg          , Gg          , Gg          , Rp          , Rr          , Gs          , Gs          , Gs          , Rr          , Rr          , Gg          , Ce          , Hh          , Gs          , Gs^Fp       
Dd          , Dd          , Gs^Fdf      , Gs^Fds      , Ds          , Gs^Fds      , Gs^Fds      , Gs^Fp       , Gs^Fds      , Gs          , Gs          , Ce          , Ce          , Gg          , Rp          , Rr          , Rp^Vhc      , Rp          , Rp          , Rr          , Gs^Fds      , Gg          , Gg          , Ce          , Gg          , Gs          , Gg          
Ds          , Gs          , Gs          , Gs^Fds      , Ds          , Ds          , Dd          , Gs^Fdf      , Gs^Fds      , Gs^Fdf      , Gs          , Gg          , Rr          , Rp          , Gg          , Gg          , Gg          , Gg          , Gg          , Gg^Vh       , Gs^Fds      , Gg          , Gs^Fp       , Ce          , Gg          , Mm          , Hh          
Gg          , Ds          , Gs          , Gs^Fdf      , Gs          , Ds          , Gs          , Gs^Fdf      , Gs          , Gs          , Rd          , Rd          , Gg          , Gg          , Gg          , Ce          , Ce          , Gg          , Ce          , Gg          , Ce          , Gs^Fp       , Gs^Fp       , Gg          , Hh          , Hh          , Mm          
Gg          , Gg          , Gs          , Gs          , Gg          , Ds          , Gg          , Gs          , Rd          , 1 Rd        , Ds          , Dd          , Gg          , Gg          , Ds          , Gg          , Gg          , Ce          , Gg          , Ce          , Hh          , Hh          , Gs^Fp       , Gs^Fp       , Hh          , Mm          , Mm          
Ds          , Ds          , Ds          , Dd          , Ds          , Ds          , Rd          , Gg          , Dd          , Ds          , Ds          , Gg          , Dd          , Gs^Fds      , Gs^Fdf      , Dd          , Gs^Fdf      , Gg          , Gs^Fp       , Gs          , Hh          , Hh          , Hh          , Hh          , Mm          , Mm          , Mm          
Dd          , Ds          , Dd          , Ds          , Dd          , Rd          , Gs          , Gs          , Ds          , Ds          , Ds          , Gs          , Gs          , Ds          , Ds          , Gs^Fdf      , Dd          , Dd          , Ds          , Gg          , Gg          , Hh          , Mm          , Mm          , Mm          , Mm          , Mm          
