border_size=1
usage=map

Mm^Xm       , Mm^Xm       , Mm^Xm       , Mm^Xm       , Mm^Xm       , Mm^Xm       , Mm^Xm       , Mm^Xm       , Mm^Xm       , Mm^Xm       , Mm^Xm       , Mm^Xm       , Mm^Xm       , Mm^Xm       , Mm^Xm       , Mm^Xm       , Mm^Xm       , Mm^Xm       , Mm^Xm       , Mm^Xm       , Mm^Xm       , Mm^Xm       , Mm^Xm       , Mm^Xm       , Mm^Xm       , Mm^Xm       , Mm^Xm       , Mm^Xm       , Mm^Xm       , Mm          , Ha          , Ai          , Ai          , Ha          , Ms          , Ms          , Ms          , Ha          , Ha          , Aa          , Aa          , Aa          , Ha          , Ha          , Ms          , Ms          , Ms          
Mm^Xm       , Mm^Xm       , Mm^Xm       , Mm^Xm       , Mm^Xm       , Mm^Xm       , Mm^Xm       , Mm^Xm       , Mm^Xm       , Mm^Xm       , Mm^Xm       , Mm^Xm       , Mm^Xm       , Mm^Xm       , Mm^Xm       , Mm^Xm       , Mm^Xm       , Mm^Xm       , Mm^Xm       , Mm^Xm       , Mm^Xm       , Mm^Xm       , Mm^Xm       , Mm^Xm       , Mm^Xm       , Mm^Xm       , Mm^Xm       , Mm^Xm       , Mm^Xm       , Mm          , Ha          , Ai          , Ai          , Ha          , Mm          , Mm^Xm       , Mm          , Aa^Fpa      , Aa^Fmw      , Aa^Fdw      , Aa^Fdw      , Aa          , Aa          , Ha          , Ms          , Ms          , Ms          
Mm^Xm       , Mm^Xm       , Mm^Xm       , Mm^Xm       , Mm^Xm       , Mm^Xm       , Mm^Xm       , Mm^Xm       , Mm^Xm       , Mm^Xm       , Mm^Xm       , Mm^Xm       , Mm^Xm       , Mm^Xm       , Mm^Xm       , Mm^Xm       , Mm^Xm       , Mm^Xm       , Mm^Xm       , Mm^Xm       , Mm^Xm       , Mm^Xm       , Mm^Xm       , Mm^Xm       , Mm^Xm       , Mm^Xm       , Mm^Xm       , Mm^Xm       , Mm^Xm       , Mm          , Ha          , Ai          , Ai          , Ha          , Ha          , Mm          , Ms          , Ms          , Ha          , Aa^Fdw      , Aa          , Aa          , Aa^Fdw      , Aa^Fpa      , Ha          , Ms          , Ms          
Mm^Xm       , Mm^Xm       , Mm^Xm       , Mm^Xm       , Mm^Xm       , Mm^Xm       , Mm^Xm       , Mm^Xm       , Mm^Xm       , Mm^Xm       , Mm^Xm       , Mm^Xm       , Mm^Xm       , Mm^Xm       , Mm^Xm       , Mm^Xm       , Mm^Xm       , Mm^Xm       , Mm^Xm       , Mm^Xm       , Mm^Xm       , Mm^Xm       , Mm^Xm       , Mm^Xm       , Mm^Xm       , Mm^Xm       , Mm^Xm       , Mm^Xm       , Mm          , Mm          , Aa^Fpa      , Ha          , Ai          , Ai          , Ai          , Ms          , Ha          , Aa          , Aa          , Aa          , Aa          , Aa          , Ha          , Ha          , Ms          , Ha          , Ms          
Mm^Xm       , Mm^Xm       , Mm^Xm       , Mm^Xm       , Mm^Xm       , Mm^Xm       , Mm^Xm       , Mm^Xm       , Mm^Xm       , Mm^Xm       , Mm^Xm       , Mm^Xm       , Mm^Xm       , Mm^Xm       , Mm^Xm       , Mm^Xm       , Mm^Xm       , Mm^Xm       , Mm^Xm       , Mm^Xm       , Mm^Xm       , Mm^Xm       , Mm^Xm       , Mm^Xm       , Mm^Xm       , Mm^Xm       , Mm          , Mm          , Mm          , Mm          , Aa^Fdw      , Aa^Fpa      , Ha          , Ai          , Ai          , Aa^Fpa      , Chr         , Aa          , Chr         , Aa^Fdw      , Chr         , Ha          , Aa^Fdw      , Aa^Vca      , Aa^Fpa      , Ms          , Aa^Fpa      
Mm^Xm       , Mm^Xm       , Mm^Xm       , Mm^Xm       , Mm^Xm       , Mm^Xm       , Mm^Xm       , Mm^Xm       , Mm^Xm       , Mm^Xm       , Mm^Xm       , Mm^Xm       , Mm^Xm       , Mm^Xm       , Mm^Xm       , Mm^Xm       , Mm^Xm       , Mm^Xm       , Mm^Xm       , Mm^Xm       , Mm^Xm       , Mm^Xm       , Mm^Xm       , Mm          , Mm          , Mm          , Ha          , Ha          , Ha          , Ha          , Ha          , Ha          , Aa^Fpa      , Ai          , Ai          , Aa^Fpa      , Aa^Fpa      , Aa          , Aa          , Chr         , 2 Khr       , Chr         , Aa^Fmw      , Aa^Fmw      , Aa^Fpa      , Aa^Fpa      , Aa^Fpa      
Mm^Xm       , Mm^Xm       , Mm^Xm       , Mm^Xm       , Mm^Xm       , Mm^Xm       , Mm^Xm       , Mm^Xm       , Mm^Xm       , Mm^Xm       , Mm^Xm       , Mm^Xm       , Mm^Xm       , Mm^Xm       , Mm^Xm       , Mm^Xm       , Mm^Xm       , Mm^Xm       , Mm^Xm       , Mm^Xm       , Mm^Xm       , Mm^Xm       , Mm          , Mm          , Ha          , Aa^Fpa      , Gs^Fp       , Aa^Fpa      , Aa          , Aa          , Aa^Fdw      , Ha          , Ha          , Ai          , Ai          , Ai          , Ai          , Aa          , Aa          , Chr         , Chr         , Chr         , Ha          , Aa^Vca      , Aa^Fpa      , Aa^Fpa      , Aa^Fpa      
Mm^Xm       , Mm^Xm       , Mm^Xm       , Mm^Xm       , Mm^Xm       , Mm^Xm       , Mm^Xm       , Mm^Xm       , Mm^Xm       , Mm^Xm       , Mm^Xm       , Mm^Xm       , Mm^Xm       , Mm^Xm       , Mm^Xm       , Mm^Xm       , Mm^Xm       , Mm^Xm       , Mm^Xm       , Mm^Xm       , Mm^Xm       , Mm^Xm       , Mm          , Ha          , Ha          , Chr         , Gs          , Gs          , Aa          , Aa          , Aa          , Aa^Fpa      , Ha          , Ha          , Ha^Vca      , Ai          , Ai          , Ai          , Aa^Fpa      , Aa          , Chr         , Ha          , Ha          , Ha          , Ha          , Ms          , Ms          
Mm^Xm       , Mm^Xm       , Mm^Xm       , Mm^Xm       , Mm^Xm       , Mm^Xm       , Mm^Xm       , Mm^Xm       , Mm^Xm       , Mm^Xm       , Mm^Xm       , Mm^Xm       , Mm^Xm       , Mm^Xm       , Mm^Xm       , Mm^Xm       , Mm^Xm       , Mm^Xm       , Mm^Xm       , Mm^Xm       , Mm^Xm       , Mm^Xm       , Mm          , Ha          , Aa^Fpa      , Aa          , Gs          , Aa^Fdw      , Aa^Fpa      , Ha          , Aa^Fpa      , Aa          , Aa          , Aa^Fpa      , Ha          , Ha          , Ai          , Ai          , Ai          , Aa          , Ha          , Ha          , Ha^Vca      , Ha          , Ms          , Ms          , Ms          
Mm^Xm       , Mm^Xm       , Mm^Xm       , Mm^Xm       , Mm^Xm       , Mm^Xm       , Mm^Xm       , Mm^Xm       , Mm^Xm       , Mm^Xm       , Mm^Xm       , Mm^Xm       , Mm^Xm       , Mm          , Mm          , Mm          , Mm          , Mm^Xm       , Mm^Xm       , Mm^Xm       , Mm^Xm       , Mm^Xm       , Mm          , Ha          , Aa          , Aa          , Aa          , Aa^Fpa      , Chr         , Aa^Fdw      , Aa^Fmw      , Aa^Fdw      , Aa^Fpa      , Aa^Fpa      , Aa^Fpa      , Chw         , Ai          , Ai          , Ai          , Ai          , Ai          , Ha          , Ms          , Ms          , Ms          , Ms          , Ms          
Mm^Xm       , Mm^Xm       , Mm^Xm       , Mm^Xm       , Mm^Xm       , Mm^Xm       , Mm^Xm       , Mm^Xm       , Mm^Xm       , Mm^Xm       , Mm^Xm       , Mm^Xm       , Mm^Xm       , Mm          , Mm          , Mm          , Ha          , Mm          , Mm          , Mm^Xm       , Mm          , Mm^Xm       , Mm          , Ha          , Aa^Fdw      , Aa^Fdw      , Aa          , Ha          , Ha          , Aa^Fmw      , Aa^Fdw      , Aa^Fdw      , Aa^Fpa      , Ha          , Ha          , Ha          , Ha          , Ai          , Ha          , Ai          , Ai          , Ai          , Ai          , Ms          , Ms          , Ms          , Ms          
Mm^Xm       , Mm^Xm       , Mm^Xm       , Mm^Xm       , Mm          , Mm^Xm       , Mm          , Mm          , Mm          , Mm          , Mm          , Mm          , Mm          , Mm          , Mm          , Ha          , Ms          , Ha          , Ha          , Mm          , Mm          , Mm          , Mm^Xm       , Ha          , Ha          , Aa^Fmw      , Aa          , Gs          , Aa^Fpa      , Aa^Fmw      , Ms          , Aa^Fpa      , Ha          , Ha          , Ha          , Ms          , Ha          , Ha          , Mm^Xm       , Mm          , Mm          , Ai          , Ai          , Aa^Fpa      , Aa^Fpa      , Ha          , Ha          
Mm          , Mm          , Mm^Xm       , Mm          , Mm          , Mm          , Mm^Xm       , Mm          , Hh          , Hh          , Ha          , Mm          , Ha          , Mm          , Ha          , Ha          , Ha          , Ha          , Ms          , Ha          , Ha          , Mm          , Mm          , Mm          , Ha          , Aa^Fmw      , Re          , Aa          , Aa          , Ha          , Ms          , Ha          , Ha          , Ms          , Ms          , Ms          , Mm^Xm       , Mm^Xm       , Mm          , Mm          , Ha          , Ai          , Ai          , Aa^Fpa      , Ha          , Ha          , Ha          
Mm          , Mm          , Mm          , Mm^Xm       , Mm^Xm       , Hh          , Hh          , Hh          , Gs^Fp       , Hh          , Re          , Ha          , Gs          , Ha          , Gs          , Aa          , Aa          , Ha^Fdw      , Ha          , Ms          , Aa^Fdw      , Ha          , Ha          , Aa^Fpa      , Chr         , Aa          , Aa          , Aa          , Aa^Fpa      , Aa^Fpa      , Ha          , Ha          , Ha          , Ms          , Mm          , Mm^Xm       , Mm^Xm       , Mm          , Mm          , Ha          , Ha          , Ai          , Ai          , Ha          , Aa^Fpa      , Ha          , Ms          
Mm^Xm       , Mm^Xm       , Hh          , Hh          , Hh          , Hh          , Gs^Fp       , Gs          , Re          , Re          , Gs          , Re          , Re          , Re          , Re          , Gs          , Aa          , Ha          , Ha          , Aa^Fpa      , Gs^Fp       , Aa^Fmw      , Ha^Vca      , Ha          , Aa^Fpa      , Aa          , Aa          , Ha^Vca      , Aa^Fdw      , Aa^Fmw      , Aa^Fpa      , Ha          , Ha          , Mm^Xm       , Mm^Xm       , Mm          , Mm          , Mm          , Mm          , Mm          , Ha          , Ai          , Ai          , Ai          , Aa^Fpa      , Aa^Fpa      , Ms          
Hh          , Hh          , Hh          , Hh          , Gs^Fmf      , Gs^Fmf      , Re^Vct      , Re          , Gs^Fmf      , Hh          , Gs          , Gs          , Hh          , Gs          , Gs          , Aa          , Aa          , Gs          , Gs          , Gs          , Gs          , Gs          , Gs          , Gs          , Re          , Aa^Fpa      , Aa          , Ha          , Chr         , Aa^Fmw      , Aa^Fdw      , Ha^Vca      , Aa          , Ha          , Mm^Xm       , Mm^Xm       , Mm^Xm       , Mm          , Mm^Xm       , Mm          , Aa^Fpa      , Aa^Fpa      , Aa^Fpa      , Ai          , Ai          , Ms          , Ms          
Hh          , Gs^Fp       , Gs^Fmf      , Ce          , Ce          , Gs^Fp       , Gs^Fmf      , Re          , Gs^Fp       , Gs^Fmf      , Hh          , Hh          , Mm          , Hh          , Hh          , Aa          , Ha^Fdw      , Re          , Re          , Re          , Aa          , Re          , Re          , Re          , Aa^Fdw      , Aa          , Aa          , Chr         , 3 Khr       , Chr         , Aa^Fpa      , Aa          , Aa          , Ha          , Ha          , Mm^Xm       , Mm^Xm       , Mm          , Mm          , Mm          , Mm^Xm       , Aa^Fpa      , Ha          , Ai          , Ai          , Ai          , Ai          
Gs          , Gs          , Re^Vct      , 1 Ke        , Ce          , Gs^Fp       , Re          , Re          , Gs          , Gs          , Hh          , Mm          , Mm          , Mm          , Ha          , Ha          , Ha          , Gs          , Gs^Fdw      , Gs          , Aa          , Aa          , Ha          , Aa          , Aa^Fmw      , Aa          , Aa          , Chr         , Chr         , Chr         , Ha          , Aa^Fpa      , Aa^Fdw      , Aa          , Ha          , Mm^Xm       , Mm^Xm       , Mm^Xm       , Mm^Xm       , Mm          , Mm          , Mm          , Ha          , Ha          , Aa^Fpa      , Ha          , Ai          
Re          , Re          , Gs^Fp       , Ce          , Re^Vct      , Re          , Gs          , Hh          , Gs^Fmf      , Gs          , Hh          , Hh          , Mm          , Ms          , Ha          , Ha          , Ha          , Aa^Fmw      , Aa^Fdw      , Gs^Fdw      , Aa          , Chr         , Aa^Fmw      , Aa          , Aa          , Ha^Vca      , Aa^Fdw      , Aa          , Aa          , Ha          , Ha^Vca      , Ha          , Aa^Fmw      , Aa^Fmw      , Aa^Fpa      , Ha          , Mm^Xm       , Mm^Xm       , Mm^Xm       , Mm^Xm       , Mm          , Mm          , Mm          , Aa^Fpa      , Mm          , Aa^Fpa      , Mm          
Gs^Fp       , Hh          , Mm          , Gs^Fmf      , Gs          , Gs^Fp       , Gs^Fp       , Hh          , Gs^Fmf      , Gs^Fmf      , Hh          , Hh          , Mm          , Mm          , Mm^Xm       , Ha          , Ms          , Ha          , Ha          , Aa          , Aa^Fpa      , Aa^Fmw      , Ha          , Ha          , Aa^Fdw      , Ha          , Ha          , Aa          , Aa^Fmw      , Aa          , Aa          , Aa^Fpa      , Aa          , Aa^Fpa      , Aa          , Ha          , Mm          , Mm^Xm       , Mm^Xm       , Mm^Xm       , Mm^Xm       , Mm          , Mm^Xm       , Mm^Xm       , Mm^Xm       , Mm^Xm       , Mm^Xm       
Gs^Fp       , Mm          , Hh          , Gs^Fmf      , Hh          , Gs^Fp       , Mm^Xm       , Gs^Fp       , Gs^Fp       , Gs^Fp       , Hh          , Hh          , Mm^Xm       , Mm^Xm       , Mm^Xm       , Mm^Xm       , Mm^Xm       , Ms          , Ms          , Aa^Fpa      , Ha          , Ha          , Ms          , Ha          , Ha          , Ha          , Ha          , Aa          , Aa^Fdw      , Aa^Fdw      , Aa^Fpa      , Aa          , Aa^Fpa      , Aa^Fpa      , Ha          , Ha          , Ha          , Mm          , Mm          , Mm^Xm       , Mm^Xm       , Mm^Xm       , Mm^Xm       , Mm^Xm       , Mm^Xm       , Mm^Xm       , Mm^Xm       
Gs^Fp       , Gs^Fmf      , Hh          , Hh          , Hh          , Mm          , Mm          , Mm          , Hh          , Hh          , Hh          , Mm          , Mm^Xm       , Mm^Xm       , Mm^Xm       , Mm^Xm       , Mm^Xm       , Mm^Xm       , Mm^Xm       , Ms          , Ms          , Ms          , Ms          , Ms          , Ms          , Ms          , Ha          , Ha          , Aa          , Aa^Fmw      , Aa          , Aa          , Ha          , Ha          , Ha          , Ha          , Ha          , Ha          , Mm          , Mm          , Mm^Xm       , Mm^Xm       , Mm^Xm       , Mm^Xm       , Mm^Xm       , Mm^Xm       , Mm^Xm       
