border_size=1
usage=map

Mm^Xm       , Mm^Xm       , Mm^Xm       , Mm^Xm       , Mm^Xm       , Mm^Xm       , Mm^Xm       , Mm^Xm       , Mm^Xm       , Mm^Xm       , Mm^Xm       , Mm^Xm       , Mm^Xm       , Mm^Xm       , Mm^Xm       , Mm^Xm       , Mm^Xm       , Mm^Xm       , Mm^Xm       , Mm^Xm       , Mm^Xm       , Mm^Xm       , Mm^Xm       , Mm^Xm       , Mm^Xm       , Mm^Xm       , Mm^Xm       , Mm^Xm       , Ms          , Ms          , Ha          , Ai          , Ai          , Ha          , Aa^Fda      , Ha          , Aa^Fpa      , Ha          , Ha          , Ha          , Ha          , Aa          , Ha          , Aa^Fma      , Ha          , Ha          , Ha          
Mm^Xm       , Mm^Xm       , Mm^Xm       , Mm^Xm       , Mm^Xm       , Mm^Xm       , Mm^Xm       , Mm^Xm       , Mm^Xm       , Mm^Xm       , Mm^Xm       , Mm^Xm       , Mm^Xm       , Mm^Xm       , Mm^Xm       , Mm^Xm       , Mm^Xm       , Mm^Xm       , Mm^Xm       , Mm^Xm       , Mm^Xm       , Mm^Xm       , Mm^Xm       , Mm^Xm       , Mm^Xm       , Mm^Xm       , Mm^Xm       , Mm^Xm       , Ms          , Ms          , Ha          , Ai          , Ai          , Ha          , Aa^Fma      , Aa^Fda      , Aa^Fdw      , Aa^Fdw      , Aa^Fma      , Aa^Fma      , Ha          , Ha          , Aa          , Aa^Fma      , Aa^Fma      , Ha          , Ha          
Mm^Xm       , Mm^Xm       , Mm^Xm       , Mm^Xm       , Mm^Xm       , Mm^Xm       , Mm^Xm       , Mm^Xm       , Mm^Xm       , Mm^Xm       , Mm^Xm       , Mm^Xm       , Mm^Xm       , Mm^Xm       , Mm^Xm       , Mm^Xm       , Mm^Xm       , Mm^Xm       , Mm^Xm       , Mm^Xm       , Mm^Xm       , Mm^Xm       , Mm^Xm       , Mm^Xm       , Mm^Xm       , Mm^Xm       , Mm^Xm       , Mm^Xm       , Ms          , Ms          , Ha          , Ai          , Ai          , Ha          , Ha          , Chr         , Aa^Fma      , Aa^Fda      , Ha^Fdw      , Aa^Fdw      , Ha^Voa      , Aa          , Aa^Fdw      , Aa^Fpa      , Ha          , Ai          , Ms          
Mm^Xm       , Mm^Xm       , Mm^Xm       , Mm^Xm       , Mm^Xm       , Mm^Xm       , Mm^Xm       , Mm^Xm       , Mm^Xm       , Mm^Xm       , Mm^Xm       , Mm^Xm       , Mm^Xm       , Mm^Xm       , Mm^Xm       , Mm^Xm       , Mm^Xm       , Mm^Xm       , Mm^Xm       , Mm^Xm       , Mm^Xm       , Mm^Xm       , Mm^Xm       , Mm^Xm       , Ms          , Mm^Xm       , Ms          , Ms          , Ms          , Ms          , Aa^Fpa      , Ha          , Ai          , Ai          , Ai          , Aa^Fpa      , Ha          , Aa^Fdw      , Aa          , Aa          , Aa          , Aa          , Ha          , Ha          , Ms          , Ha          , Ms          
Mm^Xm       , Mm^Xm       , Mm^Xm       , Mm^Xm       , Mm^Xm       , Mm^Xm       , Mm^Xm       , Mm^Xm       , Mm^Xm       , Mm^Xm       , Mm^Xm       , Mm^Xm       , Mm^Xm       , Mm^Xm       , Mm^Xm       , Mm^Xm       , Mm^Xm       , Mm^Xm       , Mm^Xm       , Mm^Xm       , Mm^Xm       , Mm^Xm       , Mm^Xm       , Ms          , Ms          , Ms          , Ms          , Ms          , Ms          , Ms          , Aa^Fdw      , Aa^Fpa      , Ha          , Ai          , Ai          , Aa^Fpa      , Chr         , Aa          , Chr         , Aa^Fdw      , Chr         , Ha          , Aa^Fdw      , Aa          , Aa^Fpa      , Ms          , Aa^Fpa      
Mm^Xm       , Mm^Xm       , Mm^Xm       , Mm^Xm       , Mm^Xm       , Mm^Xm       , Mm^Xm       , Mm^Xm       , Mm^Xm       , Mm^Xm       , Mm^Xm       , Mm^Xm       , Mm^Xm       , Mm^Xm       , Mm^Xm       , Mm^Xm       , Mm^Xm       , Mm^Xm       , Mm^Xm       , Mm^Xm       , Mm^Xm       , Mm^Xm       , Ms          , Ms          , Ms          , Ms          , Ms          , Ms          , Ha          , Ha          , Ha          , Ha          , Aa^Fpa      , Ai          , Ai          , Aa^Fpa      , Aa^Fpa      , Aa          , Aa^Vca      , Chr         , 2 Khr       , Chr         , Aa^Fmw      , Aa^Fmw      , Aa^Fpa      , Aa^Fpa      , Aa^Fpa      
Mm^Xm       , Mm^Xm       , Mm^Xm       , Mm^Xm       , Mm^Xm       , Mm^Xm       , Mm^Xm       , Mm^Xm       , Mm^Xm       , Mm^Xm       , Mm^Xm       , Mm^Xm       , Mm^Xm       , Mm^Xm       , Mm^Xm       , Mm^Xm       , Mm^Xm       , Mm^Xm       , Mm^Xm       , Mm^Xm       , Mm^Xm       , Mm^Xm       , Ms          , Ms          , Ha          , Ha          , Aa^Fma      , Aa^Fpa      , Aa          , Aa          , Aa^Fdw      , Ha          , Ha          , Ai          , Ai          , Ai          , Ai          , Aa          , Aa          , Chr         , Chr         , Chr         , Ha          , Aa          , Aa^Fpa      , Aa^Fpa      , Aa^Fpa      
Mm^Xm       , Mm^Xm       , Mm^Xm       , Mm^Xm       , Mm^Xm       , Mm^Xm       , Mm^Xm       , Mm^Xm       , Mm^Xm       , Mm^Xm       , Mm^Xm       , Mm^Xm       , Mm^Xm       , Mm^Xm       , Mm^Xm       , Mm^Xm       , Mm^Xm       , Mm^Xm       , Mm^Xm       , Mm^Xm       , Mm^Xm       , Mm^Xm       , Ms          , Ha          , Ha          , Chr         , Gs          , Gs          , Aa          , Gs          , Aa          , Aa^Fpa      , Gs          , Ha          , Ha^Vhha     , Ai          , Ai          , Ai          , Aa^Fpa      , Aa          , Chr         , Ha          , Ha^Vca      , Ha          , Ha          , Ms          , Ms          
Mm^Xm       , Mm^Xm       , Mm^Xm       , Mm^Xm       , Mm          , Mm^Xm       , Mm^Xm       , Mm^Xm       , Mm^Xm       , Mm^Xm       , Mm^Xm       , Mm^Xm       , Mm^Xm       , Mm^Xm       , Mm^Xm       , Mm^Xm       , Mm^Xm       , Mm^Xm       , Mm^Xm       , Mm^Xm       , Mm^Xm       , Mm^Xm       , Ms          , Ha          , Aa^Fpa      , Aa          , Gs          , Gs          , Aa^Fpa      , Ha          , Aa^Fpa      , Gs          , Gs          , Aa^Fpa      , Ha          , Ha          , Ai          , Ai          , Ai          , Aa          , Ha          , Ha          , Ha          , Ha          , Ms          , Ms          , Ms          
Hh          , Mm^Xm       , Mm^Xm       , Mm^Xm       , Mm          , Mm          , Mm          , Mm^Xm       , Mm^Xm       , Mm^Xm       , Mm^Xm       , Mm^Xm       , Mm^Xm       , Mm          , Mm          , Mm          , Mm          , Mm^Xm       , Mm^Xm       , Mm^Xm       , Mm^Xm       , Mm^Xm       , Ms          , Ms          , Aa          , Aa          , Gs          , Aa          , Chr         , Aa^Fdw      , Gs          , Aa          , Aa^Fpa      , Aa^Fpa      , Aa^Fpa      , Chw         , Ai          , Ai          , Ai          , Ai          , Ai          , Ha          , Ms          , Ms          , Ms          , Ms          , Ms          
Mm          , Mm          , Hh          , Mm          , Mm          , Mm          , Mm          , Hh          , Hh          , Mm^Xm       , Mm^Xm       , Mm^Xm       , Mm^Xm       , Mm          , Mm          , Mm          , Ha          , Mm          , Ms          , Ms          , Ms          , Ms          , Ms          , Ha          , Aa^Fma      , Aa^Fdw      , Aa^Fma      , Aa          , Aa          , Aa          , Aa          , Aa^Fdw      , Aa^Fpa      , Ha          , Ha          , Ha          , Ha          , Ai          , Ha          , Ai          , Ai          , Ai          , Ai          , Ms          , Ms          , Ms          , Ms          
Hh          , Mm          , Hh          , Mm          , Hh          , Mm          , Mm          , Hh          , Hh          , Mm          , Mm          , Mm          , Mm          , Mm          , Mm          , Ha          , Ms          , Ha          , Ha          , Ms          , Ms          , Ms          , Ms          , Ha          , Aa^Fma      , Aa^Fmw      , Aa^Fma      , Gs          , Gs          , Gs          , Ms          , Aa^Fpa      , Ha          , Ha          , Ha          , Ms          , Ms          , Ha          , Aa          , Aa          , Ha          , Ai          , Ai          , Aa^Fpa      , Aa^Fpa      , Ha          , Ha          
Hh^Fmw      , Mm          , Hh^Fmw      , Hh          , Hh^Fmw      , Hh          , Hh          , Hh^Fmw      , Hh^Fmw      , Hh          , Ha^Fma      , Mm          , Ha          , Mm          , Ha          , Ha          , Ha          , Ha          , Ms          , Ha          , Ha          , Ha          , Ha          , Ha          , Ha          , Aa^Fmw      , Re          , Gs          , Aa          , Ha          , Ms          , Ha          , Ha          , Ms          , Ms          , Ms          , Mm^Xm       , Ms          , Ha          , Aa          , Ms          , Ai          , Ai          , Aa^Fpa      , Ha          , Ha          , Ha          
Hh          , Hh          , Gs^Fmw      , Hh^Fmw      , Gs^Fmw      , Hh^Fmw      , Gs^Fmw      , Hh          , Gs^Fp       , Hh^Fmw      , Re          , Ha          , Gs          , Ha          , Gs          , Aa          , Aa          , Ha^Fdw      , Ha          , Ms          , Aa^Fdw      , Ha          , Ha          , Aa^Fpa      , Chr         , Aa          , Aa          , Aa          , Aa^Fpa      , Aa^Fpa      , Ha          , Ha          , Ha          , Ms          , Ms          , Mm^Xm       , Mm^Xm       , Ms          , Ms          , Ha          , Ha          , Ai          , Ai          , Ha          , Aa^Fpa      , Ha          , Ms          
Gs^Fmw      , Gs^Fmw      , Gs^Fdw      , Hh^Fmw      , Gs          , Gs^Fmw      , Gs          , Gs^Fdw      , Re          , Re          , Gs          , Re          , Re          , Re          , Re          , Gs          , Aa          , Ha          , Ha          , Aa^Fpa      , Gs^Fp       , Aa^Fmw      , Ha^Voa      , Ha          , Aa^Fpa      , Aa          , Aa          , Ha^Voa      , Aa^Fdw      , Aa^Fmw      , Aa^Fpa      , Ha          , Ha          , Ms          , Ms          , Ms          , Ms          , Mm^Xm       , Ms          , Ms          , Ha          , Ai          , Ai          , Ai          , Aa^Fpa      , Aa^Fpa      , Ms          
Gs^Fmw      , Gs^Fmw      , Ce          , Ce          , Ce          , Gs          , Re^Vct      , Re          , Gs          , Hh          , Gs          , Gs          , Aa^Fma      , Gs          , Chr         , Aa          , Aa          , Gs          , Gs          , Gs          , Gs          , Gs          , Gs          , Gs          , Re          , Aa^Fpa      , Aa          , Ha          , Chr         , Aa^Fmw      , Aa^Fdw      , Ha^Voa      , Aa          , Ha          , Ms          , Mm^Xm       , Mm^Xm       , Mm^Xm       , Mm^Xm       , Ms          , Aa^Fpa      , Aa^Fpa      , Aa^Fpa      , Ai          , Ai          , Ms          , Ms          
Hh          , Hh          , Gs          , 1 Ke        , Ce          , Gs          , Gs          , Re          , Hh^Fmw      , Hh          , Hh          , Aa^Fda      , Aa^Fma      , Aa^Fda      , Gs          , Aa          , Gs          , Re          , Re          , Re          , Aa          , Re          , Re          , Re          , Aa^Fdw      , Aa          , Aa          , Chr         , 3 Khr       , Chr         , Aa^Fpa      , Aa          , Aa          , Ha          , Ha          , Ms          , Mm^Xm       , Mm          , Mm          , Mm          , Mm^Xm       , Ms          , Ha          , Ai          , Ai          , Ai          , Ai          
Gs          , Gs          , Gs          , Ce          , Gs          , Gs          , Re          , Re^Vct      , Hh^Fmw      , Hh^Fmw      , Hh^Fmw      , Aa^Fma      , Gs          , Gs          , Gs          , Gs          , Gs          , Gs          , Aa^Fma      , Aa^Fma      , Aa          , Aa          , Ha          , Aa          , Aa^Fmw      , Aa          , Aa          , Chr         , Chr         , Chr         , Ha          , Aa^Fpa      , Aa^Fdw      , Aa          , Ha          , Ms          , Ms          , Mm^Xm       , Mm^Xm       , Mm          , Mm          , Ms          , Ha          , Ha          , Aa^Fpa      , Ha          , Ai          
Re          , Re^Vct      , Re          , Gs          , Re          , Re          , Hh^Fdw      , Hh^Fdw      , Hh^Fdw      , Gs          , Gs          , Gs          , Gs^Fda      , Aa^Fda      , Aa^Fda      , Aa          , Gs          , Aa          , Ha          , Ha          , Aa          , Chr         , Aa^Fmw      , Aa          , Aa^Fda      , Ha^Voa      , Aa^Fdw      , Aa          , Aa          , Ha          , Ms^Vhha     , Ha          , Aa^Fmw      , Aa^Fmw      , Aa^Fpa      , Ms          , Ms          , Mm^Xm       , Mm^Xm       , Mm^Xm       , Mm          , Mm          , Mm          , Aa^Fpa      , Ms          , Aa^Fpa      , Ms          
Gs^Fp       , Gs          , Gs          , Re          , Gs^Fmw      , Gs^Fmw      , Gs^Fp       , Gs^Fmw      , Gs^Fmw      , Gs^Fmw      , Hh          , Gs          , Gs^Fdw      , Aa^Fda      , Chr         , Gs          , Gs          , Ha          , Aa^Fma      , Aa^Fma      , Aa^Fpa      , Aa^Fmw      , Ha^Fda      , Aa^Fda      , Aa^Fdw      , Ha          , Ai          , Ai          , Aa^Fmw      , Aa          , Aa          , Aa^Fpa      , Aa          , Aa^Fpa      , Aa          , Ms          , Ms          , Mm^Xm       , Ms          , Mm^Xm       , Mm^Xm       , Mm          , Mm^Xm       , Mm^Xm       , Mm^Xm       , Mm^Xm       , Mm^Xm       
Hh          , Gs^Fmw      , Gs          , Gs^Fdw      , Hh          , Gs^Fp       , Mm^Xm       , Gs^Fp       , Gs^Fmw      , Gs^Fp       , Hh          , Gs^Fdw      , Ha          , Aa^Fda      , Aa          , Ha          , Aa^Fma      , Ha          , Ms          , Aa^Fpa      , Ha          , Ha          , Aa^Fda      , Aa^Fda      , Aa^Fma      , Ai          , Ai          , Ai          , Aa^Fma      , Aa^Fdw      , Aa^Fpa      , Aa          , Aa^Fpa      , Aa^Fpa      , Ha          , Ha          , Ha          , Ms          , Ms          , Ms          , Ms          , Mm^Xm       , Mm^Xm       , Mm^Xm       , Mm^Xm       , Mm^Xm       , Mm^Xm       
Hh          , Gs          , Hh          , Hh          , Hh          , Mm          , Mm          , Mm          , Hh          , Hh          , Hh          , Mm          , Ha          , Ha          , Aa^Fma      , Aa^Fma      , Aa^Fma      , Ha          , Aa^Fma      , Aa          , Aa^Fma      , Aa^Fma      , Ai          , Ai          , Ai          , Ai          , Ai          , Ai          , Ai          , Aa^Fmw      , Aa          , Aa          , Ha          , Ha          , Ha          , Ha          , Ha          , Ha          , Ms          , Ms          , Mm^Xm       , Mm^Xm       , Mm^Xm       , Mm^Xm       , Mm^Xm       , Mm^Xm       , Mm^Xm       
