border_size=1
usage=map

Hd          , Hd          , Hd          , Hd          , Hd          , Hd          , Hd          , Ds          , Ds          , Ds          , Ds          , Ds          , Hd          , Dd          , Dd          , Dd          , Ds          , Ds          , Hd          , Hd          , Dd          , Dd          , Dd          , Dd          , Dd          , Dd          , Gs          , Gs^Ft       , Gs^Ft       , Gs^Ft       , Gs^Ft       , Gs^Ft       , Gs^Ft       , Ds^Ft       , Gs^Ft       , Ds          , Gs          , Gs^Fp       , Gs^Fp       , Gs^Fp       , Gs^Fp       , Gs^Fp       , Gs^Fds      , Gs^Fp       
Hd          , Hd          , Ds          , Ds          , Hd          , Hd          , Dd          , Dd          , Dd          , Dd          , Ds          , Ds          , Ds          , Hd          , Dd          , Dd          , Ds          , Ds          , Dd          , Hd          , Dd          , Dd          , Dd          , Dd          , Dd          , Dd          , Dd          , Gs          , Gs^Ft       , Gs^Ft       , Dd^Vdt      , Gs          , Gs^Ft       , Gs^Ft       , Gs^Ft       , Gs          , Gs^Vht      , Gs          , Gs          , Gs^Ft       , Gs^Fp       , Gs^Fp       , Gs^Fp       , Gs^Fp       
Hd          , Hd          , Dd          , Ds          , Hd          , Dd          , Dd          , Dd          , Dd          , Dd          , Hd          , Ds          , Ds          , Dd          , Ds          , Hd          , Ds          , Dd          , Dd          , Hd          , Ds          , Hd          , Dd          , Dd          , Ds          , Dd          , Gs^Ft       , Gs^Ft       , Gs          , Gs^Ft       , Gs          , Gs          , Ce          , Gs          , Gs          , Gs^Ft       , Gs^Ft       , Gs^Ft       , Gs^Fp       , Gs^Fp       , Gs^Fmf      , Gg^Ve       , Gs^Fds      , Gs^Fp       
Dd          , Ds          , Dd          , Ds          , Ds          , Ds          , Dd          , Dd          , Dd          , Ds          , Ds          , Ds          , Ds          , Ds          , Ds          , Hd          , Hd          , Dd          , Dd          , Dd          , Ds          , Hd          , Hd          , Dd          , Dd          , Ds          , Gs^Ft       , Gs^Ft       , Dd^Vdt      , Gs^Ft       , Gs          , Ce          , 2 Ke        , Ce          , Gs          , Gs^Ft       , Gs^Ft       , Gs^Ft       , Gs^Fmf      , Gs^Fmf      , Gs^Fmf      , Gs^Fp       , Gs^Fp       , Gs^Fp       
Dd          , Dd          , Dd          , Dd          , Dd^Ft       , Ds          , Dd          , Dd          , Dd          , Ds          , Dd^Ft       , Dd          , Ds          , Ds          , Ds          , Hd          , Ds          , Dd          , Ds          , Ds          , Hd          , Hd          , Dd          , Dd          , Dd          , Gs          , Gs          , Gs          , Gs          , Gs^Ft       , Gs          , Ce          , Ce          , Ce          , Gs          , Gs          , Gs^Ft       , Gs^Fmf      , Gs^Ft       , Gs          , Gs          , Gs^Fp       , Gs^Ft       , Gs^Ft       
Dd          , Dd          , Dd          , Gs          , Gs^Ft       , Dd^Ft       , Dd          , Dd          , Dd          , Dd          , Dd^Ft       , Dd          , Ds^Ft       , Ds          , Ds          , Ds          , Ds          , Ds          , Dd          , Ds          , Dd          , Dd          , Dd          , Dd          , Ds          , Ds          , Dd          , Gs^Ft       , Gs^Ft       , Gs          , Gs^Ft       , Gs          , Gs          , Gs          , Gs          , Gs^Ft       , Gs          , Gs^Fp       , Gs^Fp       , Gs          , Gs^Ft       , Gs          , Gs^Ft       , Gs^Ft       
Hd          , Ds          , Dd          , Gs^Ft       , Gs^Ft       , Gs          , Dd          , Dd          , Dd^Ft       , Dd          , Gs^Ft       , Gs^Ft       , Ds^Ft       , Gs^Ft       , Ds          , Dd          , Dd          , Dd          , Dd^Ft       , Dd          , Gs          , Gs^Ft       , Gs          , Dd          , Ds          , Ds          , Gs          , Gs^Ft       , Gs          , Gs^Vht      , Gs^Ft       , Gs^Ft       , Gs          , Gs          , Gs          , Gs          , Gs          , Gs^Fmf      , Gs^Ft       , Gs^Fp       , Gs^Ft       , Gs^Ft       , Gs^Fp       , Gs^Fp       
Ds          , Ds          , Dd^Ft       , Gs^Ft       , Gs          , Gs          , Gs^Ft       , Gs^Ft       , Dd^Ft       , Dd          , Dd^Ft       , Ds^Ft       , Ds^Ft       , Gs^Ft       , Gs^Ft       , Dd          , Dd          , Dd          , Dd          , Dd          , Gs          , Gs^Ft       , Gs^Ft       , Dd          , Gs          , Dd          , Gs          , Gs          , Gs          , Gs^Ft       , Gs          , Gs          , Gs          , Gs^Ft       , Gs          , Gs          , Gs          , Gs^Fp       , Gs          , Gs          , Gs^Ft       , Gs^Fp       , Gs^Fp       , Gs^Fp       
Ds          , Ds          , Ds          , Dd^Ft       , Gs^Ft       , Gs          , Gs^Ft       , Gs^Ft       , Gs          , Dd          , Dd          , Ds          , Ds          , Gs^Vht      , Dd          , Dd          , Dd          , Dd          , Dd          , Dd          , Dd          , Gs          , Gs^Ft       , Gs          , Ds          , Dd          , Dd          , Dd          , Ds          , Dd          , Gs          , Ds          , Gs          , Gs          , Gs          , Dd          , Gs          , Gs          , Gs          , Gs^Fp       , Gs^Fmf      , Gs^Fp       , Gs^Fmf      , Gs^Fp       
Dd          , Ds          , Gs          , Gs^Ft       , Gs^Ft       , Gs          , Gs^Vht      , Gs          , Gs          , Dd          , Ce          , Ds          , Ce          , Dd          , Dd          , Dd          , Dd          , Dd          , Dd          , Dd          , Dd          , Dd          , Gs          , Gs          , Dd          , Dd          , Ds          , Ds          , Dd          , Ds          , Dd          , Ds          , Gs          , Gs          , Gs          , Gs          , Gs          , Gg          , Gs^Fdf      , Gs^Fmf      , Gs^Fdf      , Gs^Fmf      , Gs^Fmf      , Gs^Fp       
Gs          , Gs          , Gs^Ft       , Gs^Ft       , Gs          , Gs^Ft       , Dd          , Gs          , Gs^Ft       , Ce          , Ce          , 3 Ke        , Ce          , Dd          , Dd^Ft       , Gs^Ft       , Dd          , Dd          , Dd          , Dd          , Gs          , Gs          , Gs          , Gs          , Dd          , Dd          , Ds          , Ds          , Dd          , Dd          , Dd          , Gs          , Gs          , Gs          , Gs          , Gs          , Gg          , Gg          , Gg          , Gg          , Gg^Ve       , Gg^Ft       , Gs^Fmf      , Gs^Fp       
Ww          , Gs          , Gs          , Gs          , Gs          , Gs^Ft       , Dd          , Gs          , Gs          , Gs^Ft       , Ce          , Ce          , Dd          , Gs^Ft       , Dd^Ft       , Gs^Vht      , Ds          , Dd          , Gs          , Gs^Ft       , Gs          , Gs          , Gs^Ft       , Gs          , Gs^Ft       , Gs          , Gs^Ft       , Ds          , Gs          , Dd          , Dd          , Gs          , Gs          , Gs          , Gs          , Gs          , Gg          , Gg          , Gs^Fdf      , Gs^Fp       , Gs^Fp       , Gs^Ft       , Gs^Ft       , Gs^Fp       
Gs          , Wwf         , Ww          , Gs          , Gs          , Gs          , Dd          , Gs          , Gs^Ft       , Gs^Ft       , Dd^Ft       , Dd          , Dd          , Dd          , Dd          , Ds          , Ds          , Ds          , Gs          , Gs          , Gs^Ft       , Gs^Ft       , Gs          , Gs^Ft       , Gs^Ft       , Gs^Ft       , Gs^Ft       , Gs          , Gs          , Gs          , Gs          , Gs^Ft       , Gs^Ft       , Gs          , Gs          , Gs          , Gs          , Gg          , Gs          , Gs          , Gs          , Gs^Fp       , Gs^Ft       , Gs^Fp       
Gs          , Gs          , Wwf         , Gs          , Gs          , Dd          , Gs          , Gs          , Gs^Ft       , Gs^Vht      , Dd          , Dd          , Dd          , Dd          , Dd          , Dd          , Ds          , Dd          , Gs          , Gs          , Gs          , Gs          , Gs^Ft       , Gs^Ft       , Gs          , Gs^Ft       , Gs          , Gs          , Gs          , Gs          , Gs^Ft       , Gs^Ft       , Gs          , Gs          , Gg^Vh       , Gs^Fdf      , Gs^Fdf      , Gs          , Gs^Fmf      , Gs          , Gs          , Gs          , Gs^Ft       , Gs^Fp       
Gs          , Dd          , Dd          , Wwf         , Wwf         , Dd          , Dd          , Gs          , Dd          , Dd          , Dd          , Dd          , Dd          , Dd          , Gs^Ft       , Gs          , Dd          , Dd          , Gs^Ft       , Gs          , Gs          , Gs          , Gs          , Gs          , Dd          , Gs^Ft       , Gs          , Dd          , Gs          , Gs          , Gs          , Gs^Ft       , Gs          , Gg          , Gg          , Gs^Fdf      , Gg          , Gs^Fdf      , Gs^Fmf      , Gs^Fdf      , Gs          , Gs          , Gs^Ft       , Gs^Ft       
Dd          , Dd          , Dd          , Gs          , Ww          , Gs          , Gs          , Dd          , Dd          , Dd          , Dd          , Dd          , Dd          , Gs          , Gs^Ft       , Gs^Ft       , Gs          , Gs          , Gs          , Gs          , Dd          , Gs          , Dd          , Dd          , Dd          , Dd          , Dd          , Dd          , Gs          , Gs          , Ds          , Gs          , Gs          , Gg          , Gg          , Gg          , Gg          , Gg          , Gs^Fmf      , Gs^Fmf      , Gs^Fp       , Gs^Fp       , Gs^Fp       , Gs^Ft       
Dd          , Dd          , Gs^Ft       , Gs          , Gs^Ft       , Ww          , Ww          , Dd          , Ds          , Ds          , Ds          , Dd          , Gs          , Gs          , Gs^Ft       , Gs^Ft       , Gs          , Gs^Ft       , Gs          , Gs          , Ds          , Dd          , Dd          , Dd          , Dd          , Dd          , Dd          , Gs          , Dd          , Gs          , Ds          , Ds          , Gs          , Gs          , Gs^Fdf      , Gg          , Gs^Fdf      , Gg          , Gs^Fmf      , Gs^Fmf      , Gs^Fp       , Gs^Ft       , Gs^Ft       , Gs^Ft       
Ds          , Dd          , Gs^Ft       , Gs^Ft       , Gs^Vht      , Gs^Ft       , Gs^Ft       , Wwf         , Wwf         , Gs          , Gs          , Gs          , Gs          , Gs          , Gs          , Gs          , Dd          , Gs          , Dd          , Dd          , Dd          , Ds          , Ds          , Dd          , Ds          , Dd          , Dd          , Dd          , Ds          , Ds          , Gg          , Gs          , Gs          , Gs          , Gs^Fdf      , Gs^Fmf      , Gs^Ft       , Gs^Ft       , Gs^Fp       , Gs^Fmf      , Gs^Fmf      , Gs^Ft       , Gs^Fp       , Gs^Ft       
Ds          , Dd          , Gs          , Gs^Ft       , Gs          , Gs^Ft       , Gs          , Gs          , Gs          , Ww          , Ww          , Gs          , Dd          , Dd          , Ds          , Dd          , Dd          , Dd          , Gs          , Dd          , Gs^Ft       , Dd          , Ds          , Ds          , Ds          , Ds          , Ds          , Ds          , Ds          , Ds          , Ds          , Gg          , Gg          , Gs          , Gs          , Gs          , Gs^Ft       , Gs^Ft       , Gg^Ve       , Gs^Fp       , Gs^Fp       , Gs^Fp       , Gs^Fp       , Gs^Fmf      
Gs^Ft       , Gs          , Dd^Vdt      , Gs          , Gs          , Gs          , Ce          , Gs          , Dd^Vdt      , Gs^Ft       , Wwf         , Gs          , Dd          , Dd          , Dd          , Ds          , Dd          , Dd          , Gs^Ft       , Gs          , Gs          , Gs^Ft       , Dd          , Dd^Ft       , Dd          , Ds          , Ds          , Gs          , Ds          , Ds^Ft       , Ds^Ft       , Gg^Vh       , Gg          , Gs          , Gs^Fdf      , Gs^Fdf      , Gs^Ft       , Gs^Fp       , Gs          , Gs^Fp       , Gs          , Gs          , Gs^Fmf      , Gs^Fmf      
Gs^Ft       , Gs          , Gs          , Gs          , Ce          , Ce          , Ce          , Gs          , Gs          , Wwf         , Ww          , Gs          , Gs          , Gs          , Dd          , Gs          , Gs^Ft       , Gs^Ft       , Gs          , Gs^Ft       , Gs^Ft       , Gs^Ft       , Gs^Ft       , Dd^Ft       , Gs          , Ds          , Ds          , Gs          , Gs          , Gs^Ft       , Gg          , Gg          , Gs          , Gg          , Gg          , Gs^Fmf      , Gs^Fmf      , Gs^Fp       , Gs          , Gs          , Ce          , Gs          , Gs^Fp       , Gs^Fp       
Gs          , Gs          , Gs          , Ce          , Gs          , 4 Ke        , Ce          , Gs          , Gs^Ft       , Ww          , Wo          , Gs^Ft       , Dd^Vdt      , Dd          , Dd          , Gs          , Gs          , Gs^Ft       , Gs^Ft       , Gs          , Gs^Ft       , Gs          , Dd^Ft       , Gs          , Dd^Ft       , Ds          , Ds          , Ds          , Ds          , Gs          , Gs          , Gg          , Gs          , Gg          , Gs^Fmf      , Gg          , Gg          , Gg          , Ce          , Ce          , Gs          , Gg          , Gg^Ve       , Gs^Fp       
Gs          , Gs          , Dd^Vdt      , Gs          , Gs          , Ce          , Gs          , Gs          , Wwf         , Ww          , Ww          , Ww          , Gs^Ft       , Gs          , Gs          , Gs          , Gs          , Gs^Ft       , Gs          , Gs^Ft       , Dd^Ft       , Dd          , Dd          , Ds^Ft       , Ds          , Ds          , Ds          , Ds^Ft       , Ds^Ft       , Gs          , Gs^Ft       , Gs^Fp       , Gs^Fp       , Gs          , Gs          , Gs          , Gg          , Ce          , Ce          , 1 Ke        , Ce          , Gg          , Gg          , Gg          
Gs^Ft       , Gs          , Gs          , Gs^Ft       , Gs          , Gs          , Gs^Ft       , Wwf         , Ww          , Ww          , Wwf         , Wwf         , Wwf         , Gs^Ft       , Gs          , Gs          , Gs          , Gs          , Gs          , Gs^Ft       , Gs^Ft       , Dd^Ft       , Dd^Ft       , Ds^Ft       , Dd          , Ds          , Ds          , Ds          , Ds^Ft       , Ds^Ft       , Ds^Ft       , Gs^Ft       , Gs^Ft       , Gs^Fmf      , Gs          , Gs          , Gg          , Gg          , Gg          , Gs          , Gs          , Gg          , Gs          , Gs          
Gs^Ft       , Gs          , Gs          , Gs^Ft       , Gs^Ft       , Gs^Ft       , Wwf         , Wwf         , Gs          , Ww          , Gs          , Wwf         , Gs          , Wwf         , Wwf         , Gs          , Gs          , Gs          , Gs          , Gs          , Gs^Ft       , Gs^Ft       , Dd          , Dd          , Dd          , Dd          , Dd          , Ds^Ft       , Gs^Ft       , Ds^Ft       , Gs^Ft       , Gs^Fmf      , Gs^Fmf      , Gs^Fmf      , Gs^Fmf      , Gg^Ve       , Gs^Fp       , Gg          , Gs^Fp       , Gs          , Gs^Fmf      , Gs          , Gs^Ft       , Gs^Ft       
Gs^Ft       , Gs^Ft       , Gs^Ft       , Gs^Ft       , Gs^Ft       , Gs          , Gs          , Gs          , Gs          , Gs          , Gs          , Gs          , Gs          , Gs          , Wwf         , Wwf         , Ww          , Gs          , Gs          , Gs          , Dd^Ft       , Gs^Ft       , Gs^Ft       , Gs          , Gs          , Dd          , Dd^Ft       , Ds^Ft       , Ds          , Gs          , Gs          , Gs^Ft       , Gs^Fp       , Gs^Fmf      , Gs^Fmf      , Gs^Fp       , Gg          , Gs^Ft       , Gs^Fp       , Gs^Fmf      , Gs^Fmf      , Gs^Fp       , Gs^Fp       , Gs^Fp       
