border_size=1
usage=map

Hd          , Hd          , Hd          , Hd          , Hd          , Hd          , Hd          , Ds          , Ds          , Ds          , Ds          , Ds          , Hd          , Dd          , Dd          , Dd          , Ds          , Ds          , Hd          , Hd          , Dd          , Dd          , Dd          , Dd          , Dd          , Dd          , Dd          , Dd^Ft       , Dd^Ft       , Dd^Ft       , Dd^Ft       , Dd^Ft       , Ds^Ft       , Ds^Ft       , Gs^Ft       , Ds          , Gs          , Gs^Fp       , Gs^Fp       , Gs^Fp       , Gs^Fp       , Gs^Fp       , Gs^Fds      , Gs^Fp       
Hd          , Hd          , Ds          , Ds          , Hd          , Hd          , Dd          , Dd          , Dd          , Dd          , Ds          , Ds          , Ds          , Hd          , Dd          , Dd          , Ds          , Ds          , Dd          , Hd          , Dd          , Dd          , Dd          , Dd          , Dd          , Dd          , Dd          , Dd          , Dd^Ft       , Dd^Ft       , Dd^Vdt      , Ds          , Ds^Ft       , Gs^Ft       , Gs^Ft       , Gs          , Gs^Vht      , Gs          , Gs          , Gs^Ft       , Gs^Fp       , Gs^Fp       , Gs^Fp       , Gs^Fp       
Hd          , Hd          , Dd          , Ds          , Hd          , Dd          , Dd          , Dd          , Dd          , Dd          , Hd          , Ds          , Ds          , Dd          , Ds          , Hd          , Ds          , Dd          , Dd          , Hd          , Ds          , Hd          , Dd          , Dd          , Ds          , Dd          , Dd^Ft       , Dd^Ft       , Dd          , Ds^Ft       , Ds          , Ds          , Ce          , Gs          , Gs          , Gs^Ft       , Gs^Ft       , Gs^Ft       , Gs^Fp       , Gs^Fp       , Gs^Fmf      , Gg^Ve       , Gs^Fds      , Gs^Fp       
Dd          , Ds          , Dd          , Ds          , Ds          , Ds          , Dd          , Dd          , Dd          , Ds          , Ds          , Ds          , Ds          , Ds          , Ds          , Hd          , Hd          , Dd          , Dd          , Dd          , Ds          , Hd          , Hd          , Dd          , Dd          , Ds          , Dd^Ft       , Dd^Ft       , Ds          , Ds^Ft       , Gs          , Ce          , 2 Ke        , Ce          , Gs          , Gs^Ft       , Gs^Ft       , Gs^Ft       , Gs^Fmf      , Gs^Fmf      , Gs^Fmf      , Gs^Fp       , Gs^Fp       , Gs^Fp       
Dd          , Dd          , Dd          , Dd          , Dd^Ft       , Ds          , Dd          , Dd          , Dd          , Ds          , Dd^Ft       , Dd          , Ds          , Ds          , Ds          , Hd          , Ds          , Dd          , Ds          , Ds          , Hd          , Hd          , Dd          , Dd          , Dd          , Dd          , Ds          , Ds          , Ds          , Gs^Ft       , Gs          , Ce          , Ce          , Ce          , Gs          , Gs          , Gs^Ft       , Gs^Fmf      , Gs^Ft       , Gs          , Gs          , Gs^Fp       , Gs^Ft       , Gs^Ft       
Dd          , Dd          , Dd          , Dd          , Dd^Ft       , Dd^Ft       , Dd          , Dd          , Dd          , Dd          , Dd^Ft       , Dd          , Ds^Ft       , Ds          , Ds          , Ds          , Ds          , Ds          , Dd          , Ds          , Dd          , Dd          , Dd          , Dd          , Ds          , Ds          , Dd          , Dd^Ft       , Dd^Ft       , Gs          , Gs^Ft       , Dd          , Dd          , Dd          , Gs          , Gs^Ft       , Gg          , Gs^Fp       , Gs^Fp       , Gs          , Gs^Ft       , Gs          , Gs^Ft       , Gs^Ft       
Hd          , Ds          , Dd          , Dd^Ft       , Dd^Ft       , Dd^Ft       , Dd          , Dd          , Dd^Ft       , Dd          , Gs^Ft       , Gs^Ft       , Ds^Ft       , Gs^Ft       , Ds          , Dd          , Dd          , Dd          , Dd^Ft       , Dd          , Dd          , Dd^Ft       , Dd          , Dd          , Ds          , Ds          , Dd          , Dd^Ft       , Dd          , Gs^Vht      , Dd^Ft       , Dd^Ft       , Ds          , Dd          , Dd          , Gg          , Gs^Fdf      , Gs^Fmf      , Gs^Ft       , Gs^Fp       , Gs^Ft       , Gs^Ft       , Gs^Fp       , Gs^Fp       
Ds          , Ds          , Dd^Ft       , Dd^Ft       , Dd          , Dd          , Dd^Ft       , Gs^Ft       , Dd^Ft       , Dd          , Dd^Ft       , Ds^Ft       , Ds^Ft       , Gs^Ft       , Gs^Ft       , Dd          , Dd          , Dd          , Dd          , Dd          , Dd          , Dd^Ft       , Dd^Ft       , Dd          , Ds          , Dd          , Dd          , Dd          , Dd          , Dd^Ft       , Ds          , Dd          , Ds          , Gs^Ft       , Dd          , Gg          , Gs^Fp       , Gs^Fp       , Gs          , Gs          , Gs^Ft       , Gs^Fp       , Gs^Fp       , Gs^Fp       
Ds          , Ds          , Ds          , Dd^Ft       , Dd^Ft       , Dd          , Gs^Ft       , Gs^Ft       , Dd          , Dd          , Dd          , Ds          , Ds          , Gs^Ft       , Dd          , Dd          , Dd          , Dd          , Dd          , Dd          , Dd          , Dd          , Dd^Ft       , Ds          , Ds          , Dd          , Dd          , Dd          , Ds          , Dd          , Ds          , Ds          , Ds          , Gs          , Dd          , Dd          , Gg          , Gs^Fp       , Gs          , Gs^Fp       , Gs^Fmf      , Gs^Fp       , Gs^Fmf      , Gs^Fp       
Dd          , Ds          , Dd          , Ds^Ft       , Dd^Ft       , Dd          , Dd          , Dd          , Dd          , Dd          , Ce          , Ds          , Ce          , Dd          , Dd          , Dd          , Dd          , Dd          , Dd          , Dd          , Dd          , Dd          , Dd          , Dd          , Dd          , Dd          , Ds          , Ds          , Dd          , Ds          , Dd          , Ds          , Gs          , Gs          , Gs          , Dd          , Gg          , Gg          , Gs^Fdf      , Gs^Fmf      , Gs^Fdf      , Gs^Fmf      , Gs^Fmf      , Gs^Fp       
Dd          , Dd          , Dd^Ft       , Ds^Ft       , Dd          , Dd^Ft       , Dd          , Dd          , Dd^Ft       , Ce          , Ce          , 3 Ke        , Ce          , Dd          , Dd^Ft       , Gs^Ft       , Dd          , Dd          , Dd          , Dd          , Dd          , Dd          , Dd          , Dd          , Dd          , Dd          , Ds          , Ds          , Dd          , Dd          , Dd          , Gs          , Dd          , Gs          , Gs          , Gg          , Gg          , Gg          , Gg          , Gg          , Gg^Ve       , Gg^Ft       , Gs^Fmf      , Gs^Fp       
Ww          , Dd          , Dd          , Ds          , Dd          , Dd^Ft       , Dd          , Ds          , Dd          , Gs^Ft       , Ce          , Ce          , Dd          , Gs^Ft       , Dd^Ft       , Ds          , Ds          , Dd          , Dd          , Dd^Ft       , Dd          , Dd          , Dd^Ft       , Dd          , Ds^Ft       , Ds          , Ds^Ft       , Ds          , Ds          , Dd          , Dd          , Dd          , Dd          , Dd          , Gs          , Gg          , Gg          , Gg          , Gs^Fdf      , Gs^Fp       , Gs^Fp       , Gs^Ft       , Gs^Ft       , Gs^Fp       
Dd          , Wwr         , Ww          , Dd          , Dd          , Dd          , Dd          , Dd          , Dd^Ft       , Gs^Ft       , Dd^Ft       , Dd          , Dd          , Dd          , Dd          , Ds          , Ds          , Ds          , Dd          , Dd          , Dd^Ft       , Dd^Ft       , Dd          , Dd^Ft       , Ds^Ft       , Dd^Ft       , Dd^Ft       , Ds          , Ds          , Ds          , Ds          , Ds^Ft       , Gg^Ft       , Dd          , Gs          , Gs          , Gs          , Gg          , Gs          , Gs          , Gs          , Gs^Fp       , Gs^Ft       , Gs^Fp       
Dd          , Dd          , Wwr         , Dd          , Dd          , Dd          , Dd          , Dd          , Dd^Ft       , Dd^Ft       , Dd          , Dd          , Dd          , Dd          , Dd          , Dd          , Ds          , Dd          , Dd          , Dd          , Dd          , Dd          , Dd^Ft       , Ds^Ft       , Dd          , Dd^Ft       , Dd          , Ds          , Gs          , Ds          , Ds^Ft       , Gg^Ft       , Gg          , Gg          , Gs          , Gs^Fdf      , Gs^Fdf      , Gs          , Gs^Fmf      , Gs          , Gs          , Gs          , Gs^Ft       , Gs^Fp       
Dd          , Dd          , Dd          , Wwr         , Wwr         , Dd          , Dd          , Dd          , Dd          , Dd          , Dd          , Dd          , Dd          , Dd          , Dd^Ft       , Dd          , Dd          , Dd          , Dd^Ft       , Dd          , Dd          , Dd          , Dd          , Dd          , Dd          , Dd^Ft       , Dd          , Dd          , Gs          , Gs          , Gg          , Gg^Ft       , Gg          , Gg          , Gg          , Gs^Fdf      , Gg          , Gs^Fdf      , Gs^Fmf      , Gs^Fdf      , Gs          , Gs          , Gs^Ft       , Gs^Ft       
Dd          , Dd          , Dd          , Dd          , Ww          , Dd          , Dd          , Dd          , Dd          , Dd          , Dd          , Dd          , Dd          , Dd          , Ds^Ft       , Dd^Ft       , Dd          , Dd          , Dd          , Dd          , Dd          , Dd          , Dd          , Dd          , Dd          , Dd          , Dd          , Dd          , Gs          , Gs          , Ds          , Gg          , Gg          , Gg          , Gg          , Gg          , Gg          , Gg          , Gs^Fmf      , Gs^Fmf      , Gs^Fp       , Gs^Fp       , Gs^Fp       , Gs^Ft       
Dd          , Dd          , Gs^Ft       , Dd          , Gs^Ft       , Ww          , Ww          , Dd          , Ds          , Ds          , Ds          , Dd          , Ds          , Ds          , Dd^Ft       , Ds^Ft       , Dd          , Dd^Ft       , Dd          , Dd          , Ds          , Dd          , Dd          , Dd          , Dd          , Dd          , Dd          , Gs          , Dd          , Gs          , Ds          , Ds          , Gs          , Gs          , Gs^Fdf      , Gg          , Gs^Fdf      , Gg          , Gs^Fmf      , Gs^Fmf      , Gs^Fp       , Gs^Ft       , Gs^Ft       , Gs^Ft       
Ds          , Dd          , Gs^Ft       , Gs^Ft       , Dd^Ft       , Gs^Ft       , Dd^Ft       , Wwf         , Wwf         , Dd          , Dd          , Dd          , Dd          , Ds          , Ds          , Ds          , Dd          , Dd          , Dd          , Dd          , Dd          , Ds          , Ds          , Dd          , Ds          , Dd          , Dd          , Dd          , Ds          , Ds          , Gg          , Gs          , Gs          , Gs          , Gs^Fdf      , Gs^Fmf      , Gs^Ft       , Gs^Ft       , Gs^Fp       , Gs^Fmf      , Gs^Fmf      , Gs^Ft       , Gs^Fp       , Gs^Ft       
Ds          , Dd          , Dd          , Dd^Ft       , Dd          , Dd^Ft       , Dd          , Dd          , Ds          , Ww          , Ww          , Dd          , Dd          , Dd          , Ds          , Dd          , Dd          , Dd          , Dd          , Dd          , Dd^Ft       , Dd          , Ds          , Ds          , Ds          , Ds          , Ds          , Ds          , Ds          , Ds          , Ds          , Gg          , Gg          , Gs          , Gs          , Gs          , Gs^Ft       , Gs^Ft       , Gg^Ve       , Gs^Fp       , Gs^Fp       , Gs^Fp       , Gs^Fp       , Gs^Fmf      
Gs^Ft       , Ds          , Ds          , Dd          , Dd          , Dd          , Ce          , Dd          , Ds          , Ds^Ft       , Wwf         , Dd          , Dd          , Dd          , Dd          , Ds          , Dd          , Dd          , Dd^Ft       , Dd          , Dd          , Dd^Ft       , Dd          , Dd^Ft       , Dd          , Ds          , Ds          , Gs          , Ds          , Ds^Ft       , Ds^Ft       , Gg          , Gg          , Gs          , Gs^Fdf      , Gs^Fdf      , Gs^Ft       , Gs^Fp       , Gs          , Gs^Fp       , Gs          , Gs          , Gs^Fmf      , Gs^Fmf      
Gs^Ft       , Ds          , Dd          , Dd          , Ce          , Ce          , Ce          , Dd          , Ds          , Wwr         , Ww          , Dd          , Dd          , Dd          , Dd          , Dd          , Dd^Ft       , Dd^Ft       , Dd          , Dd^Ft       , Dd^Ft       , Dd^Ft       , Dd^Ft       , Dd^Ft       , Dd          , Ds          , Ds          , Gs          , Gs          , Gs^Ft       , Gg          , Gg          , Gs          , Gg          , Gg          , Gs^Fmf      , Gs^Fmf      , Gs^Fp       , Gs          , Gs          , Ce          , Gs          , Gs^Fp       , Gs^Fp       
Dd          , Dd          , Dd          , Ce          , Dd          , 4 Ke        , Ce          , Ds          , Ds^Ft       , Ww          , Wo          , Ds^Ft       , Ds          , Dd          , Dd          , Dd          , Dd          , Dd^Ft       , Dd^Ft       , Dd          , Dd^Ft       , Dd          , Dd^Ft       , Dd          , Dd^Ft       , Ds          , Ds          , Ds          , Ds          , Gs          , Gs          , Gg          , Gs          , Gg          , Gs^Fmf      , Gg          , Gg          , Gg          , Ce          , Ce          , Gs          , Gg          , Gg^Ve       , Gs^Fp       
Dd          , Dd          , Dd          , Dd          , Dd          , Ce          , Ds          , Ds          , Wwr         , Ww          , Ww          , Ww          , Dd^Ft       , Dd          , Dd          , Dd          , Dd          , Dd^Ft       , Dd          , Dd^Ft       , Dd^Ft       , Dd          , Dd          , Ds^Ft       , Ds          , Ds          , Ds          , Ds^Ft       , Ds^Ft       , Gs          , Gs^Ft       , Gs^Fp       , Gs^Fp       , Gs          , Gs          , Gs          , Gg          , Ce          , Ce          , 1 Ke        , Ce          , Gg          , Gg          , Gg          
Gs^Ft       , Dd          , Dd          , Dd^Ft       , Dd          , Dd          , Ds^Ft       , Wwr         , Ww          , Ww          , Wwf         , Wwf         , Wwr         , Dd^Ft       , Dd          , Ds          , Ds          , Dd          , Dd          , Dd^Ft       , Dd^Ft       , Dd^Ft       , Dd^Ft       , Ds^Ft       , Dd          , Ds          , Ds          , Ds          , Ds^Ft       , Ds^Ft       , Ds^Ft       , Gs^Ft       , Gs^Ft       , Gs^Fmf      , Gs          , Gs          , Gg          , Gg          , Gg          , Gs          , Gs          , Gg          , Gs          , Gs          
Gs^Ft       , Dd          , Dd          , Dd^Ft       , Gs^Ft       , Ds^Ft       , Wwr         , Wwf         , Wwf         , Ww          , Dd          , Wwr         , Dd          , Wwr         , Wwr         , Ds          , Dd          , Dd          , Dd          , Dd          , Dd^Ft       , Dd^Ft       , Dd          , Dd          , Dd          , Dd          , Dd          , Ds^Ft       , Gs^Ft       , Ds^Ft       , Gs^Ft       , Gs^Fmf      , Gs^Fmf      , Gs^Fmf      , Gs^Fmf      , Gg^Ve       , Gs^Fp       , Gg          , Gs^Fp       , Gs          , Gs^Fmf      , Gs          , Gs^Ft       , Gs^Ft       
Gs^Ft       , Gs^Ft       , Gs^Ft       , Gs^Ft       , Gs^Ft       , Ds          , Dd          , Dd          , Dd          , Dd          , Ds          , Ds          , Ds          , Ds          , Wwr         , Wwr         , Ww          , Dd          , Dd          , Dd          , Dd^Ft       , Dd^Ft       , Dd^Ft       , Dd          , Dd          , Dd          , Dd^Ft       , Ds^Ft       , Ds          , Gs          , Gs          , Gs^Ft       , Gs^Fp       , Gs^Fmf      , Gs^Fmf      , Gs^Fp       , Gg          , Gs^Ft       , Gs^Fp       , Gs^Fmf      , Gs^Fmf      , Gs^Fp       , Gs^Fp       , Gs^Fp       
