border_size=1
usage=map

Hd          , Hd          , Hd          , Hd          , Hd          , Hd          , Hd          , Ds          , Ds          , Ds          , Ds          , Ds          , Hd          , Dd          , Dd          , Dd          , Ds          , Ds          , Hd          , Hd          , Dd          , Dd          , Dd          , Gs          , Gs          , Dd          , Gs          , Gs^Ft       , Gs^Ft       , Gs^Ft       , Gs^Ft       , Gs^Ft       , Gs^Ft       , Ds^Ft       , Gs^Ft       , Ds          , Gs          , Re          , Gs^Fp       , Gs^Fp       , Re          , Gs^Fp       , Gs^Fds      , Gs^Fp       
Hd          , Hd          , Ds          , Ds          , Hd          , Hd          , Dd          , Dd          , Dd          , Dd          , Ds          , Ds          , Ds          , Hd          , Dd          , Dd          , Ds          , Ds          , Dd          , Hd          , Dd          , Dd          , Dd          , Dd          , Dd          , Gs          , Gs          , Gs          , Gs^Ft       , Gs^Ft       , Re^Vct      , Gs          , Gs^Ft       , Gs^Ft       , Gs^Ft       , Gs          , Gs^Vht      , Re          , Gs^Fdf      , Gs^Ft       , Re          , Gs^Fp       , Gs^Fp       , Gs^Fp       
Hd          , Hd          , Dd          , Ds          , Hd          , Dd          , Dd          , Dd          , Dd          , Dd          , Hd          , Ds          , Ds          , Dd          , Ds          , Hd          , Ds          , Dd          , Dd          , Hd          , Ds          , Hd          , Dd          , Dd          , Gs          , Gs          , Gs^Ft       , Gs^Ft       , Gs          , Gs^Ft       , Re          , Re          , Ce          , Gs          , Gs          , Gs^Ft       , Gs^Ft       , Re          , Re          , Re          , Gs^Fmf      , Gs^Vht      , Gs^Fds      , Gs^Fp       
Dd          , Ds          , Dd          , Ds          , Ds          , Ds          , Dd          , Dd          , Gs          , Ds          , Ds          , Ds          , Ds          , Ds          , Ds          , Hd          , Hd          , Dd          , Dd^Vda      , Dd          , Ds          , Hd          , Hd          , Dd          , Dd          , Ds          , Gs^Ft       , Gs^Ft       , Re^Vct      , Re          , Re          , Ce          , 2 Ke        , Ce          , Re          , Gs^Ft       , Re          , Re          , Gs^Fmf      , Gs^Fmf      , Gs^Fmf      , Gs^Fp       , Gs^Fp       , Gs^Fp       
Dd          , Dd          , Dd          , Dd          , Dd^Ft       , Ds          , Dd          , Dd          , Gs          , Ds          , Dd^Ft       , Gs          , Gs          , Ds          , Ds          , Hd          , Ds          , Dd          , Ds          , Ds          , Hd          , Hd          , Dd          , Dd          , Dd          , Gs          , Gs          , Gs          , Gs          , Re          , Re          , Ce          , Ce          , Ce          , Gs          , Re          , Gs^Ft       , Gs^Fmf      , Gs^Ft       , Gs          , Gs          , Gs^Fp       , Gs^Ft       , Gs^Ft       
Dd          , Dd          , Dd          , Gs          , Gs^Ft       , Dd^Ft       , Dd          , Gs          , Gs          , Dd          , Dd^Ft       , Gs          , Ds^Ft       , Gs          , Ds          , Ds          , Ds          , Ds          , Dd          , Ds          , Dd          , Dd          , Dd          , Dd          , Gs          , Gs          , Dd          , Gs^Ft       , Gs^Ft       , Re          , Re          , Gs          , Gs          , Re          , Gs          , Re          , Gs          , Gs^Fp       , Gs^Fp       , Gs          , Gs^Ft       , Gs          , Gs^Ft       , Gs^Ft       
Hd          , Ds          , Dd          , Gs^Ft       , Gs^Ft       , Gs          , Dd          , Dd          , Dd^Ft       , Dd          , Gs^Ft       , Gs^Ft       , Ds^Ft       , Gs^Ft       , Gs          , Dd          , Gs          , Dd          , Dd^Ft       , Dd          , Gs          , Gs^Ft       , Gs          , Dd          , Ds          , Ds          , Gs          , Gs^Ft       , Gs          , Re^Vct      , Gs^Ft       , Gs^Ft       , Gs          , Gs          , Re          , Re          , Gs          , Gs^Fmf      , Gs^Ft       , Gs^Fp       , Gs^Ft       , Gs^Ft       , Gs^Fp       , Gs^Fp       
Ds          , Ds          , Dd^Ft       , Gs^Ft       , Gs          , Gs          , Gs^Ft       , Gs^Ft       , Dd^Ft       , Dd          , Dd^Ft       , Ds^Ft       , Ds^Ft       , Gs^Ft       , Gs^Ft       , Dd          , Dd          , Dd          , Dd          , Dd          , Gs          , Gs^Ft       , Gs^Ft       , Dd          , Gs          , Dd          , Gs          , Gs          , Gs          , Gs^Ft       , Gs          , Gs          , Gs          , Re          , Gs          , Gs          , Ds          , Gs^Fp       , Gs          , Gs          , Gs^Ft       , Gs^Fp       , Gs^Fp       , Gs^Fp       
Ds          , Ds          , Ds          , Dd^Ft       , Gs^Ft       , Gs          , Gs^Ft       , Gs^Ft       , Re^Vct      , Dd          , Dd          , Ds          , Gs          , Gs          , Gs          , Dd          , Chr         , Gs          , Gs          , Dd          , Gs          , Gs          , Gs^Ft       , Gs          , Ds          , Dd          , Dd          , Dd          , Ds          , Dd          , Gs          , Ds          , Gs          , Re          , Gs          , Chr         , Ds          , Gs          , Gs          , Gs^Fp       , Gs^Fmf      , Gs^Fp       , Gs^Fmf      , Gs^Fp       
Dd          , Gs          , Gs          , Gs^Ft       , Gs^Ft       , Gs          , Gs          , Re          , Re          , Dd          , Gs          , Gs          , Gs^Ft       , Gs          , Gs          , Gs          , Gs          , Gs          , Ds          , Gs          , Gs          , Gs          , Gs          , Gs          , Gs          , Gs          , Gs          , Ds          , Gs          , Gs          , Dd          , Ds          , Gs          , Gs          , Gs          , Ds          , Ds          , Gs          , Gs^Fdf      , Gs^Fmf      , Gs^Fdf      , Gs^Fmf      , Gs^Fmf      , Gs^Fp       
Gs          , Gs          , Gs^Ft       , Gs^Ft       , Gs          , Gs          , Ce          , Ce          , Ce          , Gs          , Re^Vct      , Gs          , Gs          , Gs          , Gs^Ft       , Gs^Ft       , Gs          , Gs          , Gs          , Gs          , Gs          , Gs          , Gs          , Gs          , Dd          , Dd          , Gs          , Gs          , Gs          , Gs          , Dd          , Gs          , Gs          , Gs          , Re          , Gs          , Gs          , Gs          , Gg          , Gg          , Gs^Vht      , Gg^Ft       , Gs^Fmf      , Gs^Fp       
Ww          , Gs          , Gs          , Gs          , Gs          , Re          , Ce          , 3 Ke        , Ce          , Re          , Re          , Gs          , Gs          , Gs          , Gs          , Gs          , Ds          , Dd          , Gs          , Gs^Ft       , Gs          , Gs          , Gs^Ft       , Gs          , Gs^Ft       , Gs          , Gs^Ft       , Gs          , Gs          , Dd          , Dd          , Gs          , Gs          , Gs          , Gs          , Re          , Gs          , Gs          , Gs^Fdf      , Gs^Fp       , Re          , Gs^Ft       , Gs^Ft       , Gs^Fp       
Gs          , Wwf         , Ww          , Gs          , Re^Vct      , Re          , Gs          , Ce          , Re          , Re          , Gs          , Re          , Gs          , Gs          , Re          , Gs          , Ds          , Ds          , Gs          , Gs          , Gs^Ft       , Gs^Ft       , Gs          , Gs^Ft       , Gs^Ft       , Gs^Ft       , Gs^Ft       , Gs          , Gs          , Gs          , Gs          , Gs          , Gs          , Gs          , Re          , Re          , Gs          , Gs          , Gs          , Gs          , Re          , Gs^Fp       , Gs^Ft       , Gs^Fp       
Gs          , Gs          , Wwf         , Gs          , Gs          , Gs          , Gs^Ft       , Gs          , Gs          , Re^Vct      , Gs          , Gs          , Gs          , Re          , Gs          , Re          , Rd          , Dd          , Gs          , Gs          , Gs          , Gs          , Gs^Ft       , Gs^Vht      , Gs          , Gs^Ft       , Gs          , Gs          , Gs          , Gs          , Gs^Ft       , Chr         , Gs          , Re          , Gs^Vht      , Gs^Fdf      , Gs^Fdf      , Gs          , Gs^Fmf      , Gs          , Gs          , Re          , Re          , Re          
Gs          , Dd          , Dd          , Wwf         , Wwf         , Gs^Ft       , Dd          , Gs^Ft       , Dd          , Dd          , Gs          , Gs          , Dd          , Gs          , Gs^Ft       , Gs          , Gs          , Gs          , Gs^Ft       , Gs          , Gs          , Gs          , Gs          , Re          , Dd          , Gs^Ft       , Gs          , Dd          , Gs          , Gs          , Gs          , Gs^Ft       , Gs          , Re          , Gg          , Gs^Fdf      , Gg          , Gs^Fdf      , Gs^Fmf      , Gs^Fdf      , Gs          , Gs          , Gs^Ft       , Gs^Ft       
Dd          , Dd          , Dd          , Gs          , Ww          , Gs          , Gs          , Dd          , Dd          , Gs          , Gs          , Dd          , Dd          , Gs          , Gs^Ft       , Gs^Ft       , Gs          , Gs          , Gs          , Gs          , Dd          , Gs          , Gs          , Re          , Re          , Dd          , Dd          , Dd          , Gs          , Gs          , Ds          , Gs          , Re          , Re          , Gg          , Gg          , Gg          , Gg          , Gs^Fmf      , Gs^Fmf      , Gs^Fp       , Gs^Fp       , Gs^Fp       , Gs^Ft       
Dd          , Dd          , Gs^Ft       , Gs          , Gs^Ft       , Ww          , Ww          , Dd          , Ds          , Gs          , Gs          , Dd          , Gs          , Gs          , Gs^Vht      , Gs^Ft       , Gs          , Gs^Ft       , Gs          , Gs          , Ds          , Gs          , Gs^Dr       , Gs          , Gs          , Dd          , Dd          , Re          , Re          , Gs          , Ds          , Ds          , Re          , Gs          , Gs^Fdf      , Gg          , Gs^Fdf      , Gg          , Gs^Fmf      , Gs^Fmf      , Gs^Fp       , Gs^Ft       , Gs^Ft       , Gs^Ft       
Ds          , Dd          , Gs^Ft       , Gs^Ft       , Re^Vct      , Gs^Ft       , Gs^Ft       , Wwf         , Wwf         , Gs          , Chr         , Gs^Dr       , Gs          , Re          , Gs          , Gs          , Dd          , Gs          , Dd          , Dd          , Dd          , Gs          , Gs          , Gs          , Gs          , Gs          , Gs          , Gs          , Ds          , Rd          , Rd          , Gs          , Re          , Gs          , Gs^Fdf      , Gs^Fmf      , Gs^Ft       , Gs^Ft       , Gs^Fp       , Gs^Fmf      , Gs^Fmf      , Gs^Ft       , Gs^Fp       , Gs^Ft       
Ds          , Dd          , Gs          , Gs^Ft       , Re          , Gs^Ft       , Gs          , Gs          , Gs          , Ww          , Ww          , Gs          , Re          , Re          , Gs          , Dd          , Gs          , Gs          , Gs          , Dd          , Gs^Ft       , Gs          , Gs          , Ds          , Ds          , Gs^Vht      , Gs          , Gs          , Gs          , Ds          , Ds          , Re          , Re          , Gs          , Gs          , Gs          , Gs^Ft       , Gs^Ft       , Gg^Vh       , Gs^Fp       , Gs^Fp       , Gs^Fp       , Gs^Fp       , Gs^Fmf      
Gs^Ft       , Gs          , Re^Vct      , Re          , Re          , Re          , Ce          , Re          , Re          , Gs^Ft       , Wwf         , Re          , Gs          , Gs          , Gs          , Gs          , Gs          , Dd          , Gs^Ft       , Gs          , Gs          , Gs^Ft       , Gs          , Dd^Ft       , Gs          , Gs          , Ds          , Gs          , Gs          , Ds^Ft       , Ds^Ft       , Gs^Vht      , Re          , Gs          , Gs          , Gs          , Gs          , Gs          , Gs          , Gs          , Gs          , Gs          , Gs^Fmf      , Gs^Fmf      
Gs^Ft       , Gs          , Gs          , Re          , Ce          , Ce          , Ce          , Re          , Gs          , Wwf         , Ww          , Gs          , Gs          , Gs^Ft       , Gs^Ft       , Gs          , Gs^Ft       , Gs^Ft       , Gs          , Gs^Ft       , Gs^Ft       , Gs^Ft       , Gs^Ft       , Dd^Ft       , Gs          , Gs          , Ds          , Gs          , Gs          , Gs^Ft       , Gs          , Gs          , Gs          , Re          , Re          , Ce          , Ce          , Gs          , Gs          , Gs          , Gs          , Gs          , Gs^Fp       , Gs^Fp       
Gs          , Gs          , Re          , Ce          , Re          , 4 Ke        , Ce          , Re          , Gs^Ft       , Ww          , Wo          , Gs^Ft       , Wwf         , Wwf         , Gs^Ft       , Gs          , Gs          , Gs^Ft       , Gs^Ft       , Gs          , Gs^Ft       , Gs          , Dd^Ft       , Gs          , Dd^Ft       , Ds          , Ds          , Ds          , Gs          , Gs          , Gs          , Gs          , Gs          , Gs          , Gs          , Ce          , 1 Ke        , Ce          , Re          , Gs          , Gs          , Gg^Vh       , Gs          , Gs^Fp       
Gs          , Gs          , Re^Vct      , Re          , Re          , Ce          , Gs          , Gs          , Wwf         , Ww          , Ww          , Ww          , Chr         , Gs          , Gs          , Gs^Ft       , Gs          , Gs^Ft       , Gs          , Gs^Ft       , Gs          , Gs          , Gs          , Ds^Ft       , Ds          , Ds          , Gs          , Gs^Ft       , Gs^Ft       , Gs          , Gs^Ft       , Gs^Fp       , Gs^Fp       , Gs          , Gs          , Ce          , Gs          , Ce          , Gs          , Re          , Rp          , Gs          , Rp          , Rp          
Gs^Ft       , Gs          , Gs          , Gs^Ft       , Gs          , Gs          , Gs^Ft       , Wwf         , Ww          , Ww          , Wwf         , Wwf         , Wwf         , Chr         , Gs          , Gs          , Gs^Dr       , Gs          , Gs          , Gs^Ft       , Gs^Ft       , Gs          , Gs          , Gs          , Dd          , Gs          , Ds          , Gs          , Ds^Ft       , Ds^Ft       , Ds^Ft       , Gs^Ft       , Gs^Ft       , Gs^Fmf      , Gs          , Gs          , Gs          , Gs          , Gs          , Gs          , Gs          , Rp          , Gs          , Rp          
Gs^Ft       , Gs          , Gs          , Gs^Ft       , Gs^Ft       , Gs^Ft       , Wwf         , Wwf         , Gs          , Ww          , Gs          , Wwf         , Gs          , Wwf         , Wwf         , Gs          , Gs          , Gs          , Gs          , Gs          , Gs^Ft       , Gs^Ft       , Gs          , Dd          , Gs          , Gs          , Dd          , Ds^Ft       , Gs^Ft       , Ds^Ft       , Gs^Ft       , Gs^Fmf      , Gs^Fmf      , Gs^Fmf      , Gs^Fmf      , Gg^Vh       , Gs^Fp       , Gg          , Gs^Fp       , Gs          , Gs^Fmf      , Gs          , Gs^Ft       , Gs^Ft       
Gs^Ft       , Gs^Ft       , Gs^Ft       , Gs^Ft       , Gs^Ft       , Gs          , Gs          , Gs          , Gs          , Gs          , Gs          , Gs          , Gs          , Gs          , Wwf         , Wwf         , Ww          , Gs          , Gs          , Gs          , Dd^Ft       , Gs^Ft       , Gs^Ft       , Gs          , Gs          , Dd          , Dd^Ft       , Ds^Ft       , Ds          , Gs          , Gs          , Gs^Ft       , Gs^Fp       , Gs^Fmf      , Gs^Fmf      , Gs^Fp       , Gg          , Gs^Ft       , Gs^Fp       , Gs^Fmf      , Gs^Fmf      , Gs^Fp       , Gs^Fp       , Gs^Fp       
