border_size=1
usage=map

Hd          , Hd          , Hd          , Hd          , Hd          , Hd          , Hd          , Ds          , Ds^Edp      , Ds          , Ds^Es       , Ds^Es       , Hd          , Dd          , Dd          , Dd          , Ds          , Ds          , Hd          , Hd          , Dd          , Dd          , Dd          , Gs          , Gs          , Dd          , Gs          , Gs^Ft       , Gs^Ft       , Gs^Ft       , Gs^Ft       , Gs^Ft       , Gs^Ft       , Ds^Ft       , Gs^Ft       , Ds          , Gs          , Re          , Gs^Fp       , Gs^Fp       , Re          , Gs^Fp       , Gs^Fds      , Gs^Fp       
Hd          , Hd^Edp      , Ds^Edp      , Ds          , Hd          , Hd          , Dd          , Dd          , Dd          , Dd          , Ds          , Ds          , Ds          , Hd          , Dd          , Dd^Edp      , Ds          , Ds          , Dd          , Hd          , Dd          , Dd          , Dd          , Dd          , Dd          , Gs          , Gs          , Gs          , Gs^Ft       , Gs^Ft       , Re^Vct      , Gs          , Gs^Ft       , Gs^Ft       , Gs^Ft       , Gs          , Gs^Vht      , Re          , Gs^Fdf      , Gs^Ft       , Re          , Gs^Fp       , Gs^Fp       , Gs^Fp       
Hd          , Hd          , Dd^Edpp     , Ds          , Hd          , Dd          , Dd^Edpp     , Dd          , Dd          , Dd          , Hd          , Ds          , Ds          , Dd          , Ds          , Hd          , Ds          , Dd          , Dd          , Hd          , Ds          , Hd          , Dd          , Dd          , Gs          , Gs          , Gs^Ft       , Gs^Ft       , Gs          , Gs^Ft       , Re          , Re          , Ce          , Gs          , Gs          , Gs^Ft       , Gs^Ft       , Re          , Re          , Re          , Gs^Fmf      , Gs^Vht      , Gs^Fds      , Gs^Fp       
Dd          , Ds          , Dd          , Ds          , Ds          , Ds          , Dd          , Dd          , Gd          , Ds          , Ds          , Ds          , Ds^Es       , Ds^Edp      , Ds          , Hd          , Hd          , Dd          , Dd^Vda      , Dd^Edpp     , Ds          , Hd          , Hd          , Dd          , Dd          , Ds          , Gs^Ft       , Gs^Ft       , Re^Vct      , Re          , Re          , Ce          , 2 Ke        , Ce          , Re          , Gs^Ft       , Re          , Re          , Gs^Fmf      , Gs^Fmf      , Gs^Fmf      , Gs^Fp       , Gs^Fp       , Gs^Fp       
Dd^Edp      , Dd          , Dd          , Dd          , Dd^Ft       , Ds          , Dd          , Dd^Edpp     , Gd          , Ds          , Dd^Ft       , Gd          , Gd          , Ds          , Ds          , Hd          , Ds          , Dd          , Ds^Edpp     , Ds^Edpp     , Hd          , Hd          , Dd          , Dd^Es       , Dd          , Gs          , Gs          , Gd          , Gd          , Re          , Re          , Ce          , Ce          , Ce          , Gs          , Re          , Gs^Ft       , Gs^Fmf      , Gs^Ft       , Gs^Es       , Gs          , Gs^Fp       , Gs^Ft       , Gs^Ft       
Dd          , Dd^Edpp     , Dd          , Gs          , Gd^Ft       , Dd^Ft       , Dd^Es       , Gd          , Gd          , Dd          , Dd^Ft       , Gs          , Gd^Ft       , Gd          , Ds          , Ds          , Ds          , Ds          , Dd          , Ds^Edpp     , Dd          , Dd          , Dd          , Dd^Edpp     , Gs          , Gs          , Dd          , Gd^Ft       , Gd^Ft       , Re          , Re          , Gs          , Gs          , Re          , Gs          , Re          , Gs          , Gs^Fp       , Gs^Fp       , Gs^Es       , Gs^Ft       , Gs          , Gs^Ft       , Gs^Ft       
Hd          , Ds^Edpp     , Dd          , Gs^Ft       , Gd^Ft       , Gd          , Dd          , Dd          , Dd^Ft       , Dd          , Gs^Ft       , Gs^Ft       , Ds^Ft       , Gs^Ft       , Gs          , Dd          , Gs          , Dd          , Dd^Ft       , Dd          , Gs          , Gs^Ft       , Gs          , Dd          , Ds          , Ds          , Gs          , Gs^Ft       , Gd          , Re^Vct      , Gd^Ft       , Gd^Ft       , Gs          , Gs          , Re          , Re          , Gs          , Gs^Fmf      , Gs^Ft       , Gs^Fp       , Gs^Ft       , Gs^Ft       , Gs^Fp       , Gs^Fp       
Ds          , Ds          , Dd^Ft       , Gd^Ft       , Gd          , Rd          , Gs^Ft       , Gs^Ft       , Dd^Ft       , Dd          , Dd^Ft       , Ds^Ft       , Ds^Ft       , Gs^Ft       , Gs^Ft       , Dd          , Dd          , Dd          , Dd          , Dd          , Gs          , Gs^Ft       , Gs^Ft       , Dd          , Gs          , Dd          , Gs          , Gs          , Gs          , Gd^Ft       , Gd          , Gd          , Gs          , Re          , Gs          , Gs          , Ds          , Gs^Fp       , Gs          , Gs          , Gs^Ft       , Gs^Fp       , Gs^Fp       , Gs^Fp       
Ds          , Ds          , Ds          , Dd^Ft       , Gs^Ft       , Gs          , Gs^Ft       , Gs^Ft       , Re^Vct      , Dd          , Dd          , Ds          , Gs          , Gs^Es       , Gs          , Dd          , Chr         , Gs          , Gs          , Hhd         , Hhd         , Gd          , Gd^Ft       , Gs          , Hhd         , Hhd         , Dd          , Dd          , Ds          , Dd          , Gs          , Hhd         , Hhd         , Re          , Gd          , Chr         , Ds          , Gs          , Gs          , Gs^Fp       , Gs^Fmf      , Gs^Fp       , Gs^Fmf      , Gs^Fp       
Dd          , Rd          , Rd          , Gs^Ft       , Gs^Ft       , Gs          , Gs          , Re          , Re          , Rd          , Rd          , Rd          , Gs^Ft       , Gs          , Gs          , Gs          , Gs          , Gs          , Ds          , Hhd         , Hhd         , Gd          , Gd          , Gs^Es       , Hhd         , Hhd         , Gs          , Ds^Edpp     , Gs          , Gs          , Hhd         , Hhd         , Hhd         , Gd          , Gd          , Ds          , Ds          , Gd          , Gs^Fdf      , Gs^Fmf      , Gs^Fdf      , Gs^Fmf      , Gs^Fmf      , Gs^Fp       
Rd          , Rd          , Gs^Ft       , Gs^Ft       , Gs          , Gs          , Ce          , Ce          , Ce          , Rd          , Rd^Vct      , Rd          , Gs          , Gs          , Gs^Ft       , Gs^Ft       , Gs          , Gs          , Gs          , Gd          , Gs          , Hhd         , Gs          , Hhd         , Dd          , Dd          , Gs          , Gs          , Gs          , Hhd         , Hhd         , Hhd         , Hhd         , Gd          , Re          , Gd          , Hhd         , Gd          , Gd          , Gg          , Gs^Vh       , Gg^Ft       , Gs^Fmf      , Gs^Fp       
Ww          , Rd          , Gs          , Gs          , Gs          , Re          , Ce          , 3 Ke        , Ce          , Re          , Re          , Rd^Es       , Gs          , Gs          , Gs          , Hhd         , Ds          , Dd          , Gs          , Gs^Ft       , Gs          , Gd          , Gs^Ft       , Gs          , Gs^Ft       , Gs          , Gd^Ft       , Gd          , Gs          , Hhd         , Hhd         , Gs          , Gs          , Hhd         , Gs          , Re          , Gd          , Gd          , Gs^Fdf      , Gs^Fp       , Re          , Gs^Ft       , Gs^Ft       , Gs^Fp       
Gs          , Wwf         , Ww          , Gs          , Re^Vct      , Re          , Gs          , Ce          , Re          , Re          , Rd          , Re          , Gs          , Gs          , Re          , Gs          , Ds          , Ds^Edpp     , Gs          , Gs          , Hhd         , Gs^Ft       , Gs          , Gs^Ft       , Gs^Ft       , Gs^Ft       , Gs^Ft       , Gs          , Gs          , Gs          , Gd          , Gs          , Gs          , Gs          , Re          , Re          , Gs          , Gs          , Gs          , Gs          , Re          , Gs^Fp       , Gs^Ft       , Gs^Fp       
Gs          , Gs          , Wwf         , Gs          , Gs          , Gs          , Gs^Ft       , Gs          , Gs          , Re^Vct      , Rd          , Rd          , Rd^Edp      , Re          , Gs          , Re          , Rd          , Dd          , Gs          , Hhd         , Hhd         , Gs          , Gs^Ft       , Gs^Vht      , Gs          , Gs^Ft       , Gs          , Gs          , Gs          , Gd          , Gd^Ft       , Chr         , Gs^Es       , Re          , Gs^Vht      , Gs^Fdf      , Gs^Fdf      , Gs          , Gs^Fmf      , Gs^Es       , Gs          , Re          , Re          , Re          
Gs          , Dd^Edp      , Dd          , Wwf         , Wwf         , Gs^Ft       , Dd          , Gs^Ft       , Dd          , Dd          , Rd          , Rd          , Dd^Edp      , Rd          , Gs^Ft       , Gs          , Hhd         , Gs          , Gs^Ft       , Hhd         , Hhd         , Gs          , Gs          , Rd          , Dd          , Gs^Ft       , Gs          , Dd          , Gd          , Gd          , Gd          , Gs^Ft       , Gs          , Re          , Gg          , Gs^Fdf      , Gg          , Gs^Fdf      , Gs^Fmf      , Gs^Fdf      , Gs          , Gs          , Gs^Ft       , Gs^Ft       
Dd          , Dd          , Dd          , Gs          , Ww          , Gs          , Gs          , Dd          , Dd^Edp      , Rd          , Rd          , Dd          , Dd          , Rd          , Gs^Ft       , Gs^Ft       , Hhd         , Hhd         , Gs          , Gs          , Dd          , Gs          , Gs          , Rd          , Rd          , Dd          , Dd          , Dd          , Gd          , Gd          , Ds          , Gs          , Re          , Re          , Gg          , Gg          , Gg          , Gg          , Gs^Fmf      , Gs^Fmf      , Gs^Fp       , Gs^Fp       , Gs^Fp       , Gs^Ft       
Dd          , Dd          , Gs^Ft       , Gs          , Gs^Ft       , Wwt         , Ww          , Dd          , Ds          , Rd          , Gd          , Dd          , Rd          , Rd          , Gs^Vht      , Gs^Ft       , Gs          , Gs^Ft       , Rd          , Rd          , Ds          , Gs          , Hhd         , Gs          , Gs          , Dd          , Dd          , Re          , Re          , Gd          , Ds          , Ds          , Re          , Gs          , Gs^Fdf      , Gg          , Gs^Fdf      , Gg          , Gs^Fmf      , Gs^Fmf      , Gs^Fp       , Gs^Ft       , Gs^Ft       , Gs^Ft       
Ds          , Dd^Es       , Gs^Ft       , Gs^Ft       , Re^Vct      , Gs^Ft       , Gs^Ft       , Wwf         , Wwf         , Gd          , Chr         , Gd^Dr       , Gd          , Re          , Gs          , Gs          , Dd          , Gs          , Dd          , Dd          , Dd          , Gs          , Hhd         , Gs          , Gs          , Gs          , Gs          , Gs          , Ds          , Rd          , Rd          , Gs          , Re          , Gs          , Gs^Fdf      , Gs^Fmf      , Gs^Ft       , Gs^Ft       , Gs^Fp       , Gs^Fmf      , Gs^Fmf      , Gs^Ft       , Gs^Fp       , Gs^Ft       
Ds          , Dd          , Gs          , Gs^Ft       , Re          , Gs^Ft       , Gs          , Gs          , Gs          , Ww          , Ww          , Gd          , Re          , Re          , Gs^Es       , Dd          , Gs          , Gs          , Gs          , Dd          , Gs^Ft       , Hhd         , Hhd         , Hhd         , Hhd         , Gs^Vht      , Gs          , Gs          , Gs          , Ds          , Ds          , Re          , Re          , Gs          , Gs          , Gs          , Gs^Ft       , Gs^Ft       , Gs^Vh       , Gs^Fp       , Gs^Fp       , Gs^Fp       , Gs^Fp       , Gs^Fmf      
Gs^Ft       , Gs          , Re^Vct      , Re          , Re          , Re          , Ce          , Re          , Re          , Gs^Ft       , Wwf         , Re          , Gs          , Gs          , Gs          , Gs          , Hhd         , Dd          , Gs^Ft       , Gs          , Gs          , Hhd         , Gs          , Hhd         , Gs          , Gs          , Ds          , Gs          , Gs          , Ds^Ft       , Ds^Ft       , Gs^Vh       , Re          , Gs          , Gs          , Gs          , Gs          , Gs          , Gs^Es       , Gs          , Gs          , Gs          , Gs^Fmf      , Gs^Fmf      
Gs^Ft       , Gs^Es       , Rd          , Re          , Ce          , Ce          , Ce          , Re          , Gs          , Wwf         , Ww          , Gs          , Gs          , Gs^Ft       , Gs^Ft       , Hhd         , Hhd         , Gs^Ft       , Gs          , Gs^Ft       , Hhd         , Hhd         , Gs^Ft       , Hhd         , Gs^Es       , Gs          , Ds          , Gs          , Gs          , Gs^Ft       , Gs          , Gs          , Gs          , Re          , Re          , Ce          , Ce          , Gs          , Gs          , Gs          , Gs          , Gs          , Gs^Fp       , Gs^Fp       
Gs          , Rd^Es       , Rd          , Ce          , Re          , 4 Ke        , Ce          , Re          , Gs^Ft       , Wwt         , Wot         , Gs^Ft       , Wwf         , Wwf         , Gs^Ft       , Hhd         , Gs          , Gs^Ft       , Gs^Ft       , Gs          , Gs^Ft       , Gs          , Dd^Ft       , Gs          , Dd^Ft       , Ds          , Ds          , Ds          , Gs          , Gs          , Gs          , Gs          , Gs          , Gs          , Gs          , Ce          , 1 Ke        , Ce          , Re          , Gs          , Gs          , Gs^Vh       , Gs          , Gs^Fp       
Rd          , Rd          , Re^Vct      , Re          , Re          , Ce          , Gs          , Gs          , Ww          , Wwt         , Wwt         , Wwt         , Chr         , Gs          , Gs          , Gs^Ft       , Gs          , Gs^Ft       , Hhd         , Gs^Ft       , Gs          , Gs          , Gs          , Ds^Ft       , Ds^Edpp     , Ds          , Gs          , Gs^Ft       , Gs^Ft       , Gs          , Gs^Ft       , Gs^Fp       , Gs^Fp       , Gs          , Gs          , Ce          , Gs          , Ce          , Gs          , Re          , Rp          , Gs          , Rp          , Rp          
Gs^Ft       , Rd          , Gs          , Gs^Ft       , Gs          , Gs          , Gs^Ft       , Ww          , Wwt         , Wwt         , Wwt         , Ww          , Wwf         , Chr         , Gs          , Gs          , Hhd         , Hhd         , Hhd         , Gs^Ft       , Gs^Ft       , Gs          , Gs          , Gs          , Dd          , Gs          , Ds          , Gs          , Ds^Ft       , Ds^Ft       , Ds^Ft       , Gs^Ft       , Gs^Ft       , Gs^Fmf      , Gs          , Gs          , Gs          , Gs          , Gs          , Gs          , Gs          , Rp          , Gs          , Rp          
Gs^Ft       , Gs          , Gs          , Gs^Ft       , Gs^Ft       , Gs^Ft       , Wwf         , Ww          , Ww          , Wwt         , Gs          , Ww          , Gs          , Ww          , Ww          , Gs          , Gs          , Hhd         , Hhd         , Gs          , Gs^Ft       , Gs^Ft       , Gs          , Dd          , Gs          , Gs^Es       , Dd          , Ds^Ft       , Gs^Ft       , Ds^Ft       , Gs^Ft       , Gs^Fmf      , Gs^Fmf      , Gs^Fmf      , Gs^Fmf      , Gg^Vh       , Gs^Fp       , Gg          , Gs^Fp       , Gs          , Gs^Fmf      , Gs          , Gs^Ft       , Gs^Ft       
Gs^Ft       , Gs^Ft       , Gs^Ft       , Gs^Ft       , Gs^Ft       , Gs          , Ww          , Ww          , Gs          , Gs          , Gs          , Gs          , Gs          , Gs          , Wwf         , Wwf         , Ww          , Gs          , Gs          , Gs          , Dd^Ft       , Gs^Ft       , Gs^Ft       , Gs          , Gs          , Dd          , Dd^Ft       , Ds^Ft       , Ds          , Gs          , Gs          , Gs^Ft       , Gs^Fp       , Gs^Fmf      , Gs^Fmf      , Gs^Fp       , Gg          , Gs^Ft       , Gs^Fp       , Gs^Fmf      , Gs^Fmf      , Gs^Fp       , Gs^Fp       , Gs^Fp       
