border_size=1
usage=map

Ww          , Ww          , Ds          , Rr          , Rr          , Rr          , Rp          , Gs^Fp       , Gs^Fp       , Gs^Fp       , Gs^Fp       , Rp          , Rp          , Gs^Fp       , Gs^Fp       , Gs^Fmw      , Gs^Fmw      , Gs^Fp       , Gs^Fp       , Gs^Fp       , Gs^Fmw      , Gs^Fp       , Gs^Fp       , Gs^Fp       , Gs^Fmw      , Gs^Fp       , Gs^Fp       , Gg          , Rp          , Gg          , Gs^Fp       , Gs^Fp       , Gs^Fms      , Gs^Fmw      , Gs^Fp       , Gs^Fp       , Gs^Fp       , Gs^Fds      , Gs^Fmw      , Gs^Fds      , Gs^Fp       , Gs^Fp       
Ww          , Ww          , Ds          , Rr          , Rr          , Rp^Vhc      , Rp          , Rp          , Rp          , Gs^Fp       , Gs^Fp       , Rp          , Rp          , Gs^Fp       , Gs^Fp       , Gs^Fmw      , Gs^Fmw      , Gs^Fmw      , Gs^Fp       , Gs^Fmw      , Gs^Fp       , Gs^Fmw      , Gs^Fp       , Gs^Fp       , Gs^Fp       , Gs^Fp       , Ch          , Gg          , Rp          , Ggf         , Gg          , Gs^Fmw      , Gs^Fmw      , Gs^Fmw      , Gs^Fp       , Hh^Fp       , Hh^Fp       , Gs^Fmw      , Gs^Fp       , Hh^Fp       , Gs^Fp       , Gs^Fp       
Ww          , Ww^Bw/      , Ww          , Ds          , Ds          , Rr          , Gg          , Rr          , Rr          , Rr          , Rr          , Rr          , Rr          , Gs^Fp       , Gg          , Gs^Fp       , Gs^Fp       , Gs^Fmw      , Gs^Fmw      , Gs^Fp       , Gs^Fp       , Gs^Fmw      , Gs^Fp       , Gs^Fp       , Gs^Fp       , Ch          , Ch          , Gg          , Gg          , Rp          , Gg          , Gs^Fmw      , Gs^Fp       , Gs^Fmw      , Hh^Fmw      , Hh^Fp       , Gs^Fp       , Hh^Fp       , Hh^Fmw      , Hh^Fmw      , Hh^Fmw      , Gs^Fp       
Ww          , Ww          , Ww          , Ww^Bw/      , Ds          , Ds          , Gg          , Gg          , Ch          , Rr          , Rp          , Rp^Vhc      , Rp          , Gg          , Gg          , Gg          , Gg          , Gs^Fp       , Gs^Fmw      , Gs^Fp       , Gs^Fmw      , Gs^Fp       , Gs^Fp       , Gs^Fp       , Gg          , Gg          , Ggf         , Gg          , Gg^Vh       , Rp          , Gg^Fet      , Gg          , Gg          , Gs^Fp       , Hh^Fmw      , Gs^Fp       , Gs^Fp       , Hh^Fmw      , Hh^Fmw      , Hh^Fmw      , Hh^Fp       , Gs^Fp       
Ww          , Ww          , Ww          , Ww          , Ds          , Gg          , Ch          , Ch          , Rr          , Rr          , Ch          , Rp          , Rr          , Rp          , Rr          , Gg          , Gg          , Gs^Fp       , Gs^Fp       , Gs^Fmw      , Gs^Fp       , Gs^Fp       , Gs^Fp       , Gg          , Gg          , Gg^Fet      , Gg^Vh       , Ggf         , Rp          , Rp          , Gg          , Gg^Vh       , Gg          , Gg          , Ch          , Ch          , Gg          , Hh^Fmw      , Gs^Fmw      , Gs^Fp       , Gs^Fp       , Hh^Fp       
Ww          , Ww          , Ww          , Ww          , Ch          , Ch          , Rr          , Rr          , Ch          , Rr          , Rr          , Ch          , Ch          , Rr          , Rp^Vhc      , Rr          , Rp          , Gg          , Gg          , Gs^Fp       , Gs^Fp       , Gs^Fp       , Gs^Fp       , Ch          , Gg          , Gg          , Gg          , Gg          , Rp          , Ggf         , Gg          , Gg          , Gg^Vh       , Ggf         , Ch          , Gg          , Gg          , Hh^Fdw      , Gg          , Gs^Fmw      , Gg          , Gg          
Ww          , Ww          , Ch          , Ch          , Rr          , Rr          , Ch          , Ch          , 2 Kh        , Ch          , Ch          , Rr          , Rr          , Rr          , Rr          , Rr          , Gg          , Rp          , Rp          , Gg          , Gs^Fp       , Gs^Fp       , Gg          , Ch          , Ggf         , Gg          , Gg^Vh       , Gg          , Rp          , Rp          , Rp          , Gg          , Gg^Fet      , Gg          , Gg          , Gg          , Gg          , Gg          , Gg          , Gs^Fmw      , Gg          , Gg          
Ww          , Ch          , Rr          , Rp          , Rp^Vhc      , Rr          , Ch          , Ww          , Ch          , Ch          , Rr          , Rr          , Ch          , Ch          , Ds          , Ds          , Ds          , Gg          , Gg          , Rp          , Rp          , Gg          , Gg          , Gg          , Gg          , Gg^Fet      , Rp          , Rp          , Gg^Vh       , Gg          , Gg^Vh       , Rp          , Rp          , Gg          , Rp          , Gg          , Rp          , Gg          , Rp          , Gg          , Gg          , Gg          
Ww          , Ch          , Ch          , Rp          , Rr          , Rr          , Ds          , Ch          , Rr          , Rr          , Rp^Vhc      , Ds          , Ww          , Ww          , Ww          , Ww          , Ch          , Ds          , Ds          , Gg          , Gg          , Rp          , Rp          , Gg          , Rp          , Rp          , Gg          , Gg          , Gg          , Gg          , Gg          , Gg          , Ch          , Rp          , Gg^Wm       , Rp          , Gg          , Rp          , Gg          , Rp          , Rp          , Gg          
Ww          , Ww          , Ww          , Ch          , Ch          , Ds          , Ww          , Ds          , Rr          , Rr          , Rr          , Ds          , Ds          , Ww          , Ww          , Ww          , Ww          , Ch          , Ww          , Ds          , Ds          , Gg          , Gg          , Rp          , Rp          , Gg          , Gg          , Ch          , Ch          , Gg          , Ch          , Gg          , Re^Gvs      , Re^Gvs      , Re^Gvs      , Gg          , Gg          , Gg          , Re^Gvs      , Gg          , Gg          , Rp          
Wo          , Ww          , Ds          , Ww          , Ww          , Ww          , Ww          , Ww^Bw/      , Ww          , Rr          , Rr          , Rp^Vhc      , Rr          , Ds          , Ww          , Ww          , Ww          , Ww          , Ds          , Ww          , Ds          , Gg          , Gg          , Gg          , Gg          , Rp          , Gg          , Gg          , Gg          , Ch          , Gg          , Gg          , Gg          , Re^Gvs      , Gg          , Gg^Vh       , Re^Gvs      , Re^Gvs      , Re^Gvs      , Re^Gvs      , Re^Gvs      , Gg          
Wo          , Ww          , Ww          , Ww          , Ww          , Ww          , Ww          , Ww          , Ww          , Ww^Bw/      , Ww          , Rr          , Ww          , Ww^Bw\      , Ww          , Ww          , Ww          , Ww          , Ww          , Ww          , Ch          , Ds          , Gg          , Gg          , Gg          , Rp          , Gg          , Gg          , Gg          , Gg          , Gg^Vh       , Re^Gvs      , Gg          , Gg          , Re^Gvs      , Gg          , Gg          , Re^Gvs      , Re^Gvs      , Re^Gvs      , Gg          , Gg          
Wo          , Wo          , Wo          , Ww          , Ww          , Ww          , Ww          , Ww          , Ww          , Ww          , Ww          , Ww^Bw|      , Ww          , Ww          , Ww          , Ww          , Wwr         , Ww          , Ww          , Ch          , Ww          , Ds          , Ww          , Gg          , Ww          , Rp          , Gg          , Gg          , Re^Gvs      , Re^Gvs      , Re^Gvs      , Gg          , Re^Gvs      , Re^Gvs      , Gg          , Gg          , Gg          , Gg          , Gg          , Gg          , Gs^Fmw      , Gs^Fp       
Wo          , Wo          , Wo          , Ww          , Wo          , Ww          , Ww          , Ww          , Ww          , Ww          , Ww          , Ww          , Wo          , Ww          , Ww          , Ww          , Ww          , Ww          , Ww          , Ww          , Ch          , Ww          , Ds          , Ww          , Gg          , Ww^Bw|      , Ww          , Gg^Wm       , Gg          , Re^Gvs      , Gg          , Gg          , Gg          , Gg          , Re^Gvs      , Re^Gvs      , Re^Gvs      , Gg^Wm       , Gg          , Gg          , Gs^Fms      , Gs^Fmw      
Wo          , Wo          , Wo          , Wo          , Wo          , Wo          , Wo          , Wo          , Ww          , Ww          , Ww          , Wo          , Ww          , Ww          , Ww          , Ww          , Ww          , Ww          , Ww          , Ch          , Ds          , Ds          , Gg          , Gg          , Ch          , Rp          , Gg          , Ww          , Ww          , Gg          , Ch          , Gg          , Re^Gvs      , Re^Gvs      , Re^Gvs      , Re^Gvs      , Re^Gvs      , Re^Gvs      , Gg          , Gg          , Gs^Fmw      , Gs^Fms      
Wo          , Wo          , Wo          , Wo          , Wo          , Wo          , Wo          , Wo          , Ww          , Ww          , Ww          , Ww          , Wo          , Ww          , Ww          , Ww          , Ww          , Wwr         , Ww          , Ww          , Chr         , Ds          , Gg          , Gg          , Gg          , Rp          , Rp          , Gg          , Gg          , Ww          , Ww          , Gg          , Gg          , Re^Gvs      , Re^Gvs      , Re^Gvs      , Gg          , Gg^Vh       , Re^Gvs      , Gg          , Gg          , Gs^Fds      
Wo          , Wo          , Wo          , Wo          , Wo          , Wo          , Wo          , Wo          , Wo          , Wo          , Wo          , Wo          , Wo          , Ww          , Wwr         , Ds          , Ww          , Ww          , Ww          , Chw         , Ds          , Ds          , Gg          , Gg          , Gg          , Gg          , Rp          , Ch          , Gg          , Gg          , Gg          , Ww          , Ww          , Gg          , Gg          , Gg          , Re^Gvs      , Re^Gvs      , Re^Gvs      , Re^Gvs      , Re^Gvs      , Gg          
Wo          , Wo          , Wo          , Wo          , Wo          , Wo          , Wo          , Wo          , Wo          , Wo          , Wo          , Wo          , Ww          , Ww          , Ww          , Ds          , Ds          , Ds          , Ww          , Ww          , Ds          , Gg          , Re^Gvs      , Re^Gvs      , Gg          , Gg          , Rp          , Gg          , Gg          , Gg          , Re^Gvs      , Gg          , Gg          , Ww          , Ww          , Gg          , Gg          , Re^Gvs      , Re^Gvs      , Re^Gvs      , Re^Gvs      , Re^Gvs      
Wo          , Wo          , Wo          , Wo          , Wo          , Wo          , Wo          , Wo          , Wo          , Wo          , Wo          , Ww          , Ww          , Ww          , Wwr         , Ww          , Ds          , Wwr         , Chr         , Chr         , Ds          , Gg          , Re^Gvs      , Re^Gvs      , Gg          , Gg          , Rp          , Gg          , Gg          , Re^Gvs      , Re^Gvs      , Re^Gvs      , Re^Gvs      , Gg          , Gg          , Ww          , Ww          , Gg          , Gg          , Re^Gvs      , Gg          , Gg          
Wwr         , Wwr         , Wwr         , Wo          , Wo          , Wo          , Wo          , Wo          , Wo          , Wo          , Wo          , Ww          , Ww          , Ww          , Wwr         , Ww          , Ww          , Ww          , Ww          , Ww          , Ds          , Gg          , Gg          , Gg          , Gg^Vh       , Gg          , Rp          , Gg          , Gg          , Re^Gvs      , Re^Gvs      , Re^Gvs      , Re^Gvs      , Gg          , Gg          , Gg          , Gg          , Ww          , Ww          , Gg          , Gg          , Re^Gvs      
Ww          , Wwr         , Wwr         , Wo          , Ww          , Wo          , Wo          , Wo          , Wo          , Wo          , Ww          , Ww          , Wwr         , Wwr         , Ww          , Ww          , Ww          , Ww          , Wwf         , Ds          , Chr         , Chr         , Gg          , Gg          , Rp          , Rp          , Re^Gvs      , Re^Gvs      , Re^Gvs      , Gg          , Gg          , Re^Gvs      , Gg          , Gg          , Re^Gvs      , Re^Gvs      , Re^Gvs      , Gg          , Gg          , Ww          , Ww          , Gg          
Ww          , Ww          , Ww          , Wwr         , Ww          , Wo          , Wo          , Wo          , Wo          , Wo          , Ww          , Ww          , Ww          , Wwr         , Ww          , Ww          , Wwr         , Wwf         , Ds          , Ds          , Chr         , 3 Khr       , Chr         , Rp          , Gg          , Re^Gvs      , Re^Gvs      , Re^Gvs      , Gg          , Gg          , Gg          , Gg          , Gg          , Gg          , Gg          , Re^Gvs      , Re^Gvs      , Re^Gvs      , Gg          , Gg          , Ch          , Ww          
Ww          , Ww          , Ww          , Ww          , Wwr         , Ww          , Ds          , Wo          , Wo          , Wo          , Wo          , Ww          , Ww          , Ww          , Wwr         , Ww          , Wwf         , Ww          , Ds          , Chr         , Gg          , Chr         , Chr         , Rp          , Gg^Vh       , Gg          , Gg          , Gg          , Gg          , Gg          , Gg          , Gg          , Gg          , Hh          , Gs^Fp       , Gg          , Gs^Fp       , Gg          , Hh          , Gg          , Gs^Fp       , Gg          
Ds          , Ww          , Wwf         , Ww          , Ww          , Ww          , Ww          , Ww          , Wo          , Wo          , Wo          , Ds          , Ww          , Wwr         , Ww          , Wwf         , Ds          , Ww          , Ww          , Ds          , Gg          , Gg          , Gg          , Rp          , Gg          , Gg          , Gg          , Hh^Fdw      , Gg          , Hh^Fdw      , Hh          , Gg          , Gg          , Gs          , Gs^Fp       , Hh^Fp       , Hh          , Hh^Vhh      , Mm          , Hh^Fp       , Mm          , Hh^Fp       
Wwf         , Ds          , Wwr         , Ds          , Ww          , Ww          , Wwr         , Ww          , Wwr         , Wo          , Wwr         , Ww          , Ww          , Ww          , Wwf         , Ds          , Wwr         , Ww          , Ds          , Ds          , Gg^Vh       , Gg          , Re          , Rp          , Gg          , Gg          , Hh          , Gg          , Hh          , Mm          , Mm          , Mm          , Gs          , Hh          , Gs          , Hh          , Gs          , Mm          , Hh          , Mm          , Mm          , Mm          
Wwr         , Wwr         , Wwr         , Ww          , Ww          , Ww          , Ww          , Ww          , Ww          , Wwr         , Ww          , Wwr         , Ww          , Ww          , Ww          , Ds          , Wwr         , Ds          , Ds          , Gg          , Gg          , Rp          , Gg          , Gg          , Gg          , Hh          , Hh^Vhh      , Hh^Fp       , Hh          , Mm          , Hh^Fmw      , Hh          , Mm          , Gs          , Gs          , Gs          , 1 Gs        , Gs          , Hh          , Mm          , Hh          , Hh          
Ww          , Ww          , Ww          , Ww          , Ww          , Ww^Vm       , Ww          , Wwr         , Ww          , Ww          , Ww          , Ww          , Ww          , Wwr         , Ww          , Wwr         , Ds          , Ds          , Gg          , Gg          , Gg          , Rp          , Gg          , Gg          , Gg          , Hh          , Gg          , Hh          , Hh^Fmw      , Hh          , Gg          , Hh          , Hh          , Hh          , Gs          , Gs          , Gs          , Gs          , Gs          , Hh          , Gg          , Gg          
Ww          , Ww          , Wwf         , Ds          , Ds          , Ww          , Wwr         , Wwr         , Ww          , Ww^Vm       , Ww          , Ww          , Ds          , Ww          , Ww          , Ww          , Ds          , Ds          , Gg          , Gg          , Gg          , Rp          , Re          , Hh          , Hh          , Hh^Fdw      , Hh          , Hh^Fp       , Gg          , Gg          , Gs          , Gs          , Hh^Fdw      , Gs          , Gs^Vht      , Gs          , Gs          , Gs          , Gs^Vht      , Gs          , Gs          , Gg          
Ww          , Wwr         , Wwf         , Ds          , Wwr         , Ww          , Ww          , Ds          , Wwr         , Ww          , Wwr         , Ww          , Ww          , Ww          , Ds          , Ds          , Gg          , Gg          , Gg          , Gg          , Ss          , Gg          , Gg          , Re          , Re          , Gg          , Gg          , Gg          , Rp          , Gg          , Re          , Rp          , Gs          , Rp          , Rp          , Gs          , Re          , Gs          , Rp          , Rp          , Rp          , Rp          
Ds          , Wwr         , Ww          , Wwr         , Ds          , Ww          , Ss          , Ds          , Ds          , Ww          , Ds          , Ww          , Ww          , Ww          , Ss          , Ss          , Gs^Fp       , Gs^Fp       , Gs^Fmw      , Gs^Fp       , Ss          , Gg          , Gg          , Re          , Gg          , Re          , Re          , Rp          , Gs^Fp       , Rp          , Gs          , Gs          , Gs^Fp       , Gs          , Gg          , Re          , Gs          , Re          , Hh^Fp       , Gs          , Hh^Fp       , Gs          
Ds          , Ww          , Ds          , Ds          , Ds          , Ds          , Ss          , Ss          , Ss          , Ss^Vhs      , Ds          , Ww          , Ss          , Ss          , Ss          , Gg          , Gg          , Gg          , Gg          , Gs^Fp       , Ss          , Ss          , Gs          , Gs          , Gs          , Gg          , Gg          , Gg          , Gg          , Gg          , Gs^Fp       , Gs^Fp       , Gs^Fp       , Gs^Fp       , Gg          , Gs          , Mm^Vhh      , Hh          , Hh^Fmw      , Hh^Fp       , Hh^Fmw      , Hh^Fp       
Gg          , Ds          , Ds          , Ss          , Ss          , Ds          , Chs         , Ss          , Ss          , Ss          , Ds          , Ds          , Ss          , Ss          , Gg          , Gg          , Gg          , Gg          , Ss          , Ss          , Gs^Fp       , Ss          , Ss^Bw|      , Gs          , Ss          , Gg          , Gg          , Hh          , Gg          , Hh          , Gs^Fp       , Gg          , Gs^Fp       , Gs^Fp       , Gs^Fp       , Hh          , Mm          , Mm          , Mm          , Mm          , Mm          , Mm          
Gs^Fp       , Gs^Fp       , Ss          , Ss          , Ss          , Chs         , Chs         , Chs         , Chs         , Chs         , Ss          , Ds          , Chs         , Chs         , Gg          , Gg          , Gs^Fp       , Ss          , Ss^Vhs      , Gs^Fp       , Gs^Fp       , Gs          , Re          , Ss          , Gs          , Ss          , Hh          , Hh^Fdw      , Gg          , Hh          , Hh          , Gg          , Hh^Fp       , Hh^Fdw      , Gg          , Hh          , Hh          , Mm          , Mm          , Mm          , Mm^Xm       , Mm          
Gs^Fp       , Ss          , Gg          , Ss^Vhs      , Ss          , Ss          , Ss          , Chs         , 4 Khs       , Chs         , Chs         , Ss          , Chs         , Chs         , Gg          , Gs^Fmw      , Gs^Fp       , Ss          , Gs^Fp       , Gs^Fmw      , Gs          , Gs          , Re          , Gs          , Gg          , Ss          , Ss          , Gg          , Hh          , Hh          , Hh^Fdw      , Gg          , Hh          , Hh          , Gg          , Hh          , Hh^Fp       , Hh^Fmw      , Mm          , Mm          , Mm^Xm       , Mm^Xm       
Gg          , Gg          , Gg          , Gs^Fp       , Gs^Fp       , Ss          , Gs          , Chs         , Chs         , Chs         , Ss          , Ss          , Gg          , Gg          , Gg          , Gs^Fp       , Ss          , Ss          , Ss          , Gs^Fmw      , Gs^Fp       , Gs          , Re          , Re          , Gg          , Ss          , Gg          , Hh          , Gs^Fp       , Hh^Fmw      , Hh^Fp       , Hh          , Hh          , Hh^Fmw      , Gg          , Hh          , Hh          , Hh          , Mm          , Mm^Xm       , Mm          , Mm^Xm       
Gg          , Gg          , Gg          , Gs^Fp       , Ss          , Ss          , Ss^Vhs      , Gs          , Chs         , Chs         , Gs          , Ss          , Ss          , Ss          , Ss          , Ss          , Ss^Vhs      , Ss          , Gs^Fp       , Gs^Fmw      , Gs          , Re          , Gs          , Gg          , Ss          , Ss          , Gs^Fp       , Hh          , Hh^Fp       , Hh^Fdw      , Hh          , Hh^Vhh      , Hh          , Hh          , Gs          , Gg          , Gg          , Hh          , Mm^Xm       , Mm          , Mm^Xm       , Mm          
Gs^Fp       , Gs^Fp       , Gg          , Gs^Fp       , Ss          , Ss          , Gs^Fp       , Gs^Fp       , Gs          , Gs          , Gs          , Gs^Fp       , Ss          , Gs^Fp       , Gs          , Ss          , Gg          , Ss          , Gs^Fp       , Gs          , Re          , Gs          , Ss          , Ss          , Gs^Fmw      , Gs^Fdw      , Gs^Fmw      , Gs          , Hh          , Hh^Fp       , Hh          , Gs^Fp       , Hh^Fmw      , Hh^Fp       , Hh^Fp       , Gs          , Hh^Fp       , Mm          , Mm          , Mm          , Mm^Xm       , Mm^Xm       
Gg          , Gs^Fp       , Gg          , Gg          , Ss          , Ss          , Ss          , Gs^Fp       , Gs^Fp       , Gs          , Gs^Fp       , Gs^Fp       , Ss          , Gs          , Gs          , Gg          , Re          , Ss          , Ss          , Re          , Gs^Fp       , Gs^Fdw      , Ss          , Ss          , Ss          , Gs^Fdw      , Gs^Fmw      , Gs          , Hh          , Hh          , Gs^Fdw      , Gs^Fp       , Gs^Fdw      , Hh          , Hh^Fmw      , Hh          , Hh          , Hh          , Hh          , Mm          , Mm          , Mm^Xm       
Gg          , Gg          , Gs^Fp       , Ss          , Gg          , Gg          , Gg          , Gg          , Gs          , Gs          , Gg          , Ss          , Gg          , Gs          , Re          , Gs          , Gg          , Gg          , Ss          , Gs^Fdw      , Gs^Fp       , Gs^Fp       , Ss          , Gs^Fmw      , Ss          , Gs^Fp       , Gs          , Hh          , Gs^Fp       , Gs^Fmw      , Gs^Fmw      , Gs^Fmw      , Hh^Fp       , Hh          , Hh          , Hh^Fdw      , Mm          , Mm^Xm       , Mm          , Mm          , Mm          , Mm^Xm       
Gg          , Gs^Fp       , Gs^Fp       , Gg          , Gs^Fp       , Gg          , Gg          , Gs          , Gg          , Re          , Re          , Gg          , Gs          , Re          , Gs          , Gs          , Gs^Fdw      , Gs          , Ss          , Gs^Fmw      , Gs^Fp       , Ss          , Gs^Fdw      , Gs^Fmw      , Ss          , Gs^Fp       , Gs          , Gs          , Ss          , Gs^Fdw      , Hh^Fmw      , Hh          , Hh          , Mm          , Mm          , Mm          , Mm          , Mm          , Hh^Fdw      , Hh          , Hh^Fdw      , Mm          
Gs^Fp       , Gs^Fmw      , Gs^Fmw      , Gs^Fmw      , Gs^Fp       , Gg          , Gs^Fp       , Gs^Fp       , Gs^Fp       , Gg          , Re          , Gs          , Re          , Re          , Gs          , Gs^Fdw      , Gs^Fdw      , Ss          , Ss          , Ss          , Ss          , Ss          , Gs^Fp       , Gs^Fmw      , Gs          , Ss          , Ss          , Ss          , Ss          , Gs^Fp       , Gs^Fdw      , Hh          , Hh^Fmw      , Mm          , Hh          , Mm          , Hh^Fdw      , Hh          , Hh^Fp       , Hh^Fmw      , Hh^Fp       , Hh          
Gs^Fp       , Gs^Fp       , Gg          , Gs^Fp       , Gs^Fmw      , Gs^Fmw      , Gg          , Gg          , Gg          , Gg          , Re          , Re          , Gg          , Gs          , Gs^Fp       , Gs^Fmw      , Gs^Fp       , Ss          , Ss          , Ss          , Gs          , Gs^Fp       , Gs^Fmw      , Gs^Fmw      , Gs^Fp       , Gs^Fp       , Gs^Fp       , Ss          , Gs^Fp       , Gs^Fp       , Gs^Fp       , Gs^Fp       , Gs^Fp       , Gs^Fp       , Hh          , Hh          , Gs^Fp       , Hh^Fmw      , Hh^Fmw      , Hh^Fmw      , Hh          , Hh^Fp       
