border_size=1
usage=map

Mm          , Mm          , Mm          , Mm          , Mm          , Mm          , Mm          , Hh          , Hh          , Hh          , Hh          , Rp          , Rp          , Gs          , Ww          , Ww          , Hh          , Hh          , Hh          , Hh          , Hh          , Mm          
Mm          , Mm          , Hh          , Mm          , Hh          , Mm          , Hh          , Hh          , Gs^Fms      , Ch          , Gs^Fms      , Hh          , Rp          , Ww          , Hh^Fms      , Hh^Fms      , Gs^Fms      , Hh^Fms      , Ch          , Hh^Fms      , Hh^Fms      , Hh          
Mm          , Hh          , Hh^Fms      , Hh^Fms      , Hh          , Hh          , Hh          , Hh          , Gs^Fms      , Gs^Fms      , Gg^Fet      , Gs^Fms      , Rp          , Ww^Bw\      , Rp          , Gg^Fet      , Rp          , Gs^Fms      , Gs^Fms      , Gs^Fds      , Gg^Fet      , Hh          
Mm          , Hh          , Hh^Fms      , Hh          , Hh^Fms      , Mm          , Hh          , Hh^Fms      , Ch          , Gs^Fms      , Rp          , Rp          , Ww          , Ww          , Ww          , Rp          , Gs^Fms      , Rp          , Rp          , Gs^Fds      , Gs^Fms      , Hh          
Mm          , Mm          , Hh          , Hh          , Ch          , Ch          , Hh          , Hh^Fds      , Hh          , Ggf         , Rp          , Ww          , Wo          , Wo          , Ww          , Gs^Fms      , Gg^Fet      , Gs^Fms      , Rp          , Ggf         , Ch          , Hh          
Mm          , Hh          , Hh^Fms      , Hh          , Ch          , 5 Kh        , Ch          , Hh          , Rp          , Rp          , Hh          , Ww          , Ww          , Ww          , Gg          , Gs^Fms      , Gs^Fms      , Gs^Fms      , Ggf         , Rp          , Rp          , Hh          
Mm          , Mm          , Hh^Fms      , Mm          , Hh          , Ch          , Rp          , Hh          , Rp          , Hh          , Ch          , Hh^Fds      , Ww          , Hh^Fp       , Hh^Fms      , Ch          , Hh          , Hh^Fms      , Hh^Fp       , Hh^Fms      , Hh          , Rp          
Hh          , Hh          , Hh^Fms      , Hh^Fms      , Hh          , Hh          , Rp          , Rp          , Mm          , Mm          , Mm          , Hh^Fms      , Ww          , Hh          , Ch          , Hh          , Ch          , Hh          , Hh          , Hh          , Hh          , Hh^Fp       
Rp          , Hh          , Rp          , Rp          , Rp          , Rp          , Rp          , Hh          , Mm          , Mm          , Mm          , Mm          , Ww          , Hh          , Ch          , 6 Kh        , Ch          , Hh          , Mm          , Hh          , Mm          , Mm          
Mm          , Rp          , Hh          , Hh          , Mm          , Mm          , Hh          , Rp          , Rp          , Mm          , Ww          , Ww          , Mm          , Hh^Fp       , Hh^Fms      , Ch          , Hh          , Mm          , Mm          , Mm          , Mm          , Mm          
Mm          , Hh          , Mm          , Hh          , Mm          , Mm          , Mm          , Hh          , Hh          , Ww^Bw\      , Rp          , Rp          , Rp          , Hh          , Hh          , Rp          , Hh          , Hh          , Mm          , Mm          , Mm          , Mm          
Mm          , Mm          , Mm          , Mm          , Hh          , Hh          , Hh          , Hh^Fms      , Hh          , Ww          , Hh          , Hh          , Gg^Fet      , Rp          , Rp          , Rp          , Hh^Fds      , Mm          , Mm          , Mm          , Mm          , Mm          
Mm          , Mm          , Mm          , Mm          , Hh^Fms      , Hh^Fms      , Hh          , Hh          , Ch          , Ww          , Ch          , Ch          , Gg^Fet      , Rp          , Rp          , Hh          , Hh          , Mm          , Mm          , Mm          , Mm          , Mm          
Mm          , Mm          , Mm          , Hh          , Hh^Fms      , Hh          , 2 Kh        , Ch          , Gg          , Ww          , Ggf         , Gg          , Rp          , Rp          , Ch          , Hh          , Hh          , Hh          , Mm          , Mm          , Hh          , Mm          
Mm          , Mm          , Hh          , Hh          , Ch          , Ch          , Ggf         , Ggf         , Ggf         , Ww          , Gg^Fet      , Ggf         , Rp          , Rp          , Ggf         , 4 Kh        , Ch          , Hh          , Hh          , Mm          , Hh^Fds      , Mm          
Mm          , Hh          , Hh          , Hh          , Ch          , Gg          , Gg          , Ggf         , Ww          , Ww          , Ww          , Gg^Fet      , Rp          , Rp          , Gg          , Gg          , Gg          , Ch          , Ch          , Hh          , Hh^Fds      , Hh^Fms      
Hh^Fms      , Hh          , Ch          , Ch          , Ww          , Ww          , Ww          , Ww          , Ww          , Ww          , Gg          , Gg          , Rp          , Rp          , Ggf         , Ggf         , Gg^Fet      , Ggf         , Ch          , Mm          , Hh^Fms      , Hh^Fms      
Hh          , Ch          , Ww          , Ww          , Gg          , Gg^Fet      , Gg^Fet      , Ww          , Gg          , Ggf         , Rp          , 1 Rp        , Rp          , Rp          , Gg^Fet      , Ggf         , Gg          , Ch          , Hh          , Mm          , Hh          , Hh^Fds      
Ww          , Ww          , Hh          , Ch          , Ch          , Ggf         , Ggf         , Gg          , Ggf         , Rp          , Rp          , Rp          , Gg^Fet      , Rp          , Rp          , Ggf         , Gg^Fet      , Ch          , Gg          , Hh          , Hh          , Hh^Fms      
Mm          , Hh          , Hh          , Hh          , Hh          , 3 Kh        , Ch          , Ggf         , Gg          , Ggf         , Gg^Fet      , Gg          , Ggf         , Ggf         , Gg^Fet      , Rp          , Rp          , Gg          , Gg^Fet      , Ggf         , Hh          , Hh^Fds      
Mm          , Mm          , Mm          , Mm          , Hh          , Hh          , Hh          , Ch          , Ch          , Gg          , Ch          , Ch          , Ch          , Ch          , Hh          , Ggf         , Gg^Fet      , Rp          , Rp          , Ggf         , Gg^Fet      , Hh          
Mm          , Mm          , Mm          , Mm          , Mm          , Hh^Fms      , Hh          , Hh          , Hh          , Ch          , Hh          , Hh          , Hh          , Hh          , Hh          , Hh          , Gg          , Ggf         , Gg^Fet      , Rp          , Rp          , Gg          
