border_size=1
usage=map

Gs^Fds      , Gs^Fms      , Gs^Fds      , Gs^Fms      , Gs^Fms      , Gs^Fds      , Gs^Fds      , Gg^Fet      , Gs^Fms      , Gs^Fds      , Gg          , Rp          , Rp          , Ww          , Ww          , Gg          , Gs^Fds      , Gs^Fms      , Gs^Fms      , Gs^Fms      , Gs^Fds      , Gs^Fds      , Gs^Fms      , Gs^Fms      , Gs^Fms      , Gs^Fds      , Gs^Fds      , Gs^Fds      , Gs^Fms      , Gs^Fds      , Gs^Fms      , Gs^Fms      
Gs^Fds      , Gs^Fms      , Gs^Fds      , Gs^Fms      , Gs^Fms      , Gs^Fds      , Gs^Fds      , Gs^Fms      , Gs^Fds      , Gs^Fds      , Gg          , Rp          , Rp          , Ww          , Ww          , Gg          , Gg          , Gs^Fds      , Gs^Fms      , Gs^Fms      , Gs^Fds      , Gs^Fms      , Gs^Fds      , Gs^Fms      , Gs^Fms      , Gs^Fms      , Gs^Fds      , Gs^Fds      , Gs^Fds      , Gs^Fms      , Gs^Fds      , Gs^Fms      
Gs^Fds      , Gg^Fet      , Gs^Fms      , Gs^Fms      , Gs^Fds      , Gs^Fms      , Gs^Fds      , Gs^Fms      , Gg          , Gs^Fds      , Ggf         , Rp          , Rp          , Ww^Bw\      , Ww^Bw\      , Rp          , Rp          , Gg          , Gs^Fds      , Gs^Fds      , Gg^Fet      , Gs^Fds      , Gs^Fms      , Gs^Fms      , Gs^Fds      , Gs^Fms      , Gg          , Gs^Fms      , Gg^Fet      , Gs^Fds      , Gs^Fms      , Gs^Fms      
Gs^Fms      , Gs^Fds      , Gs^Fds      , Gs^Fds      , Gg          , Gg^Fet      , Ggf         , Gg          , Rp          , Ggf         , Rp          , Rp          , Rp          , Ww          , Ww          , Rp          , Rp          , Rp          , Rp          , Gs^Fds      , Gs^Fds      , Gs^Fds      , Ggf         , Gg          , Rp          , Rp          , Rp          , Ggf         , Ggf         , Ggf         , Gs^Fds      , Gs^Fds      
Gs^Fms      , Gs^Fds      , Ggf         , Gs^Fds      , Gg          , Gg          , Rp          , Rp          , Rp          , Rp          , Rp          , Rp          , Ww          , Ww          , Ww          , Gg          , Ggf         , Rp          , Rp          , Rp          , Rp          , Gg          , Rp          , Rp          , Rp          , Rp          , Rp          , Rp          , Rp          , Gg          , Gg          , Gg          
Gs^Fds      , Ggf         , Ggf         , Ggf         , Ggf         , Ggf         , Rp          , Rp          , Ww          , Wwf         , Ww          , Ww          , Wo          , Ww          , Ww          , Wwf         , Ww          , Gg          , Gg          , 2 Rp        , Rp          , Rp          , Rp          , 3 Rp        , Gg          , Gg          , Gg          , Rp          , Rp          , Rp          , Rp          , Ggf         
Ggf         , Ggf         , Ggf         , Ggf         , Rp          , Rp          , Rp          , Wwf         , Ww          , Ww          , Ww          , Wo          , Wo          , Wo          , Wo          , Ww          , Ww          , Ggf         , Gg          , Gg          , Gg          , Rp          , Ggf         , Gg          , Gg          , Gg          , Ggf         , Gg          , Gg          , Rp          , Rp          , Rp          
Gg          , Gg          , Ggf         , Ggf         , Rp          , Rp          , Wwf         , Wwf         , Ww          , Ww          , Wo          , Wo          , Wo          , Wo          , Wo          , Ww          , Wwf         , Ggf         , Ggf         , Ggf         , Gg          , Ggf         , Gg          , Gg          , Gs^Fms      , Gs^Fds      , Gg          , Gg          , Gs^Fms      , Gg          , Gg          , Rp          
Ggf         , Ggf         , Gg          , Ggf         , Rp          , Rp          , Ww          , Ww          , Ww          , Wo          , Wo          , Wo          , Wo          , Wo          , Ww          , Ww          , Wwf         , Gg          , Ggf         , Gg          , Ggf         , Gg          , Gg          , Gg^Fet      , Gs^Fds      , Gg          , Gg          , Gg          , Gs^Fds      , Gs^Fms      , Gs^Fds      , Gg          
Gg          , Gg          , Rp          , Rp          , Rp          , Rp          , Gg          , Ww          , Ww          , Wo          , Ww          , Wo          , Ww          , Ww          , Ww          , Ww          , Gg          , Ggf         , Gg          , Gg          , 1 Gg        , Ggf         , Gg          , Gg          , Gg          , Ggf         , Gs^Fds      , Ggf         , Gg          , Gs^Fms      , Gg^Fet      , Gs^Fds      
Rp          , Rp          , Rp          , Rp          , Gg          , Gg          , Gg          , Ww          , Ww          , Ww          , Ww          , Ww          , Wwf         , Ww          , Wwf         , Wwf         , Ggf         , Gg          , Ggf         , Ggf         , Gg          , Ggf         , Gg          , Gs^Fds      , Gs^Fds      , Gg          , Gs^Fms      , Gg          , Gg          , Ggf         , Gs^Fds      , Gg          
Rp          , Rp          , Hh          , Hh          , Hh^Fds      , Hh          , Hh          , Wwf         , Ww          , Ww          , Gg          , Gg          , Gg          , Gg          , Ggf         , Gg          , Gg          , Gg          , Gg          , Ggf         , Gg          , Gg          , Gg          , Gs^Fms      , Gg^Fet      , Gs^Fds      , Gs^Fms      , Gs^Fds      , Gs^Fds      , Gg          , Gg          , Gg          
Hh          , Hh          , Hh^Fds      , Hh          , Hh^Fp       , Hh          , Hh          , Ww          , Ww          , Ww          , Ggf         , Ggf         , Ggf         , Gg          , Gg          , Gg          , Gg          , Ggf         , Gg          , Gg          , Gg          , Gs^Fds      , Gs^Fms      , Gs^Fds      , Gg          , Gs^Fms      , Gs^Fms      , Gs^Fms      , Gg          , Gg          , Gs^Fds      , Ggf         
Hh^Fms      , Hh^Fms      , Hh^Fp       , Hh          , Hh^Fp       , Hh^Fms      , Hh          , Ww          , Ww          , Gg          , Gg          , Gg          , Ggf         , Ggf         , Ggf         , Gg          , Gg          , Gg          , Gg          , Gs^Fds      , Gs^Fms      , Gg          , Gg          , Ggf         , Gs^Fms      , Gs^Fds      , Gg^Fet      , Gg          , Ggf         , Ggf         , Gs^Fds      , Gs^Fms      
Hh^Fms      , Hh          , Hh          , Hh^Fp       , Hh^Fp       , Hh^Fms      , Hh          , Ww          , Ww          , Gg          , Hh          , Hh          , Hh^Fp       , Gg          , Gg          , Gg          , Hh          , Gs^Fds      , Gs^Fds      , Gs^Fms      , Gs^Fds      , Gg          , Gg          , Gg          , Gg          , Gg          , Gg          , Gs^Fds      , Gg          , Gs^Fds      , Gs^Fms      , Gs^Fms      
