border_size=1
usage=map

Ryd         , Ryd         , Ryd         , Xos         , Xos         , Xos         , Xos         , Xos         , Xos         , Xos         , Yhr         , Xos         , Xos         , Xos         , Xos         , Xos         , Xos         , Xos         , Xos         , Xos         , Xos         , Xos         , Cud         , Cud         , Cud         , Xos         
Ryd         , Ryd         , Ryd         , Ryd         , Ryd^Z/      , Xos         , Xos         , Xos         , Xos         , Xos         , Ryd         , Xos         , Xos         , Xos         , Xos         , Xos         , Cud         , Xos         , Cud         , Xos         , Cud         , Cud         , Cud         , Cud         , Xos         , Xos         
Xos         , Ryd         , Ryd^Z/      , Ryd^Z/      , Ryd         , Ryd         , Ryd         , Xos         , Cud         , Ryd         , Xos         , Ryd         , Cud         , Xos         , Ryd         , Cud         , Cud         , Cud         , Cud         , Cud         , 2 Kud       , Cud         , Xos         , Xos         , Xos         , Xos         
Xos         , Xos         , Xos         , Ryd         , Ryd         , Ryd         , Ryd         , Ryd         , Ryd         , Ryd         , Ryd         , Ryd         , Ryd         , Ryd         , Cud         , Cud         , Cud         , 3 Kud       , 4 Kud       , Cud         , Cud         , Cud         , Xos         , Xos         , Xos         , Xos         
Xos         , Xos         , Xos         , Xos         , Ryd         , Ryd         , Ryd         , Ryd         , Ryd         , Ryd         , Wo          , Wo          , Wo          , Ryd         , Ryd         , Cud         , Cud         , Cud         , Cud         , 5 Kud       , Cud         , Cud         , Xos         , Xos         , Xos         , Xos         
Xos         , Xos         , Xos         , Xos         , Ryd         , Ryd         , Ryd         , Ryd         , Wo          , Wo          , Wo          , Wo          , Ryd         , Ryd         , Rr          , Ryd         , Ryd         , Cud         , Cud         , Cud         , Cud         , Cud         , Cud         , Xos         , Xos         , Xos         
Xos         , Xos         , Xos         , Xos         , Cud         , Ryd         , Ryd         , Ryd         , Ryd         , Wo          , Ryd         , Ryd         , Rr          , Rr          , Rr          , Rr          , Rr          , Ryd         , Ryd         , Cud         , Ryd         , Ryd         , Ryd         , Xos         , Yhr         , Yhr         
Yhr         , Yhr         , Yhr         , Xos         , Ryd         , Ryd         , Ryd         , Ryd         , Ryd         , Ryd         , Ryd         , Rr          , Rr          , 1 Rr        , Rr          , Rr          , Ryd         , Ryd         , Wo          , Ryd         , Ryd         , Xos         , Ryd         , Ryd         , Xos         , Xos         
Xos         , Xos         , Xos         , Ryd         , Ryd         , Xos         , Ryd         , Ryd         , Wo          , Wo          , Wo          , Ryd         , Ryd         , Rr          , Ryd         , Ryd         , Wo          , Wo          , Wo          , Wo          , Ryd         , Ryd         , Cud         , Xos         , Xos         , Xos         
Xos         , Xos         , Xos         , Xos         , Cud         , Ryd         , Ryd         , Ryd         , Ryd         , Wo          , Wo          , Wo          , Wo          , Ryd         , Ryd         , Wo          , Wo          , Wo          , Ryd         , Ryd         , Ryd         , Ryd         , Xos         , Xos         , Xos         , Xos         
Xos         , Xos         , Xos         , Xos         , Ryd         , Ryd         , Ryd         , Ryd         , Ryd         , Ryd         , Ryd         , Wo          , Ryd         , Ryd         , Ryd         , Ryd         , Ryd         , Ryd         , Ryd         , Ryd         , Xos         , Xos         , Xos         , Xos         , Xos         , Xos         
Xos         , Xos         , Xos         , Xos         , Ryd         , Ryd         , Ryd         , Ryd         , Ryd         , Ryd         , Xos         , Ryd         , Ryd         , Ryd         , Ryd         , Ryd         , Ryd         , Ryd         , Ryd         , Ryd         , Ryd         , Xos         , Xos         , Xos         , Xos         , Xos         
Xos         , Xos         , Cud         , Ryd         , Ryd         , Ryd         , Ryd         , Ryd         , Cud         , Ryd         , Ryd         , Ryd         , Cud         , Ryd         , Ryd         , Ryd         , Xos         , Ryd         , Ryd         , Ryd         , Cud         , Cud         , Ryd         , Xos         , Xos         , Xos         
Ryd         , Ryd         , Ryd         , Cud         , Cud         , Ryd         , Xos         , Xos         , Xos         , Xos         , Yhr         , Xos         , Xos         , Xos         , Xos         , Xos         , Xos         , Xos         , Xos         , Cud         , Ryd         , Ryd         , Ryd         , Ryd         , Ryd         , Xos         
Ryd         , Ryd         , Ryd         , Ryd         , Xos         , Xos         , Xos         , Xos         , Xos         , Xos         , Yhr         , Xos         , Xos         , Xos         , Xos         , Xos         , Xos         , Xos         , Xos         , Xos         , Xos         , Ryd         , Ryd         , Ryd         , Ryd         , Ryd         
Ryd         , Ryd         , Xos         , Xos         , Xos         , Xos         , Xos         , Xos         , Xos         , Xos         , Xos         , Yhr         , Yhr         , Xos         , Xos         , Xos         , Xos         , Xos         , Xos         , Xos         , Xos         , Xos         , Xos         , Ryd         , Cud         , Cud         
Xos         , Xos         , Xos         , Xos         , Xos         , Xos         , Xos         , Xos         , Xos         , Xos         , Xos         , Xos         , Xos         , Yhr         , Xos         , Xos         , Xos         , Xos         , Xos         , Xos         , Xos         , Xos         , Xos         , Xos         , Xos         , Ryd         
Xos         , Xos         , Xos         , Xos         , Xos         , Xos         , Xos         , Xos         , Xos         , Xos         , Xos         , Xos         , Xos         , Yhr         , Xos         , Xos         , Xos         , Xos         , Xos         , Xos         , Xos         , Xos         , Xos         , Xos         , Xos         , Xos         
