border_size=1
usage=map

Urb         , Urb         , Urb         , Xos         , Xos         , Xos         , Xos         , Xos         , Xos         , Xos         , Yhr         , Xos         , Xos         , Xos         , Xos         , Xos         , Xos         , Xos         , Xos         , Xos         , Xos         , Xos         , Cud         , Cud         , Cud         , Xos
Urb         , Urb         , Urb         , Urb         , Urb^Z/      , Xos         , Xos         , Xos         , Xos         , Xos         , Urb         , Xos         , Xos         , Xos         , Xos         , Xos         , Cud         , Xos         , Cud         , Xos         , Cud         , Cud         , Cud         , Cud         , Xos         , Xos
Xos         , Urb         , Urb^Z/      , Urb^Z/      , Urb         , Urb         , Urb         , Xos         , Cud         , Urb         , Xos         , Urb         , Cud         , Xos         , Urb         , Cud         , Cud         , Cud         , Cud         , Cud         , 2 Kud       , Cud         , Xos         , Xos         , Xos         , Xos
Xos         , Xos         , Xos         , Urb         , Urb         , Urb         , Urb         , Urb         , Urb         , Urb         , Urb         , Urb         , Urb         , Urb         , Cud         , Cud         , Cud         , 3 Kud       , 4 Kud       , Cud         , Cud         , Cud         , Xos         , Xos         , Xos         , Xos
Xos         , Xos         , Xos         , Xos         , Urb         , Urb         , Urb         , Urb         , Urb         , Urb         , Wo          , Wo          , Wo          , Urb         , Urb         , Cud         , Cud         , Cud         , Cud         , 5 Kud       , Cud         , Cud         , Xos         , Xos         , Xos         , Xos
Xos         , Xos         , Xos         , Xos         , Urb         , Urb         , Urb         , Urb         , Wo          , Wo          , Wo          , Wo          , Urb         , Urb         , Rr          , Urb         , Urb         , Cud         , Cud         , Cud         , Cud         , Cud         , Cud         , Xos         , Xos         , Xos
Xos         , Xos         , Xos         , Xos         , Cud         , Urb         , Urb         , Urb         , Urb         , Wo          , Urb         , Urb         , Rr          , Rr          , Rr          , Rr          , Rr          , Urb         , Urb         , Cud         , Urb         , Urb         , Urb         , Xos         , Yhr         , Yhr
Yhr         , Yhr         , Yhr         , Xos         , Urb         , Urb         , Urb         , Urb         , Urb         , Urb         , Urb         , Rr          , Rr          , 1 Rr        , Rr          , Rr          , Urb         , Urb         , Wo          , Urb         , Urb         , Xos         , Urb         , Urb         , Xos         , Xos
Xos         , Xos         , Xos         , Urb         , Urb         , Xos         , Urb         , Urb         , Wo          , Wo          , Wo          , Urb         , Urb         , Rr          , Urb         , Urb         , Wo          , Wo          , Wo          , Wo          , Urb         , Urb         , Cud         , Xos         , Xos         , Xos
Xos         , Xos         , Xos         , Xos         , Cud         , Urb         , Urb         , Urb         , Urb         , Wo          , Wo          , Wo          , Wo          , Urb         , Urb         , Wo          , Wo          , Wo          , Urb         , Urb         , Urb         , Urb         , Xos         , Xos         , Xos         , Xos
Xos         , Xos         , Xos         , Xos         , Urb         , Urb         , Urb         , Urb         , Urb         , Urb         , Urb         , Wo          , Urb         , Urb         , Urb         , Urb         , Urb         , Urb         , Urb         , Urb         , Xos         , Xos         , Xos         , Xos         , Xos         , Xos
Xos         , Xos         , Xos         , Xos         , Urb         , Urb         , Urb         , Urb         , Urb         , Urb         , Xos         , Urb         , Urb         , Urb         , Urb         , Urb         , Urb         , Urb         , Urb         , Urb         , Urb         , Xos         , Xos         , Xos         , Xos         , Xos
Xos         , Xos         , Cud         , Urb         , Urb         , Urb         , Urb         , Urb         , Cud         , Urb         , Urb         , Urb         , Cud         , Urb         , Urb         , Urb         , Xos         , Urb         , Urb         , Urb         , Cud         , Cud         , Urb         , Xos         , Xos         , Xos
Urb         , Urb         , Urb         , Cud         , Cud         , Urb         , Xos         , Xos         , Xos         , Xos         , Yhr         , Xos         , Xos         , Xos         , Xos         , Xos         , Xos         , Xos         , Xos         , Cud         , Urb         , Urb         , Urb         , Urb         , Urb         , Xos
Urb         , Urb         , Urb         , Urb         , Xos         , Xos         , Xos         , Xos         , Xos         , Xos         , Yhr         , Xos         , Xos         , Xos         , Xos         , Xos         , Xos         , Xos         , Xos         , Xos         , Xos         , Urb         , Urb         , Urb         , Urb         , Urb
Urb         , Urb         , Xos         , Xos         , Xos         , Xos         , Xos         , Xos         , Xos         , Xos         , Xos         , Yhr         , Yhr         , Xos         , Xos         , Xos         , Xos         , Xos         , Xos         , Xos         , Xos         , Xos         , Xos         , Urb         , Cud         , Cud
Xos         , Xos         , Xos         , Xos         , Xos         , Xos         , Xos         , Xos         , Xos         , Xos         , Xos         , Xos         , Xos         , Yhr         , Xos         , Xos         , Xos         , Xos         , Xos         , Xos         , Xos         , Xos         , Xos         , Xos         , Xos         , Urb
Xos         , Xos         , Xos         , Xos         , Xos         , Xos         , Xos         , Xos         , Xos         , Xos         , Xos         , Xos         , Xos         , Yhr         , Xos         , Xos         , Xos         , Xos         , Xos         , Xos         , Xos         , Xos         , Xos         , Xos         , Xos         , Xos         
