border_size=1
usage=map

Rr          , Urb         , Urb         , Xos         , Xos         , Xos         , Xos         , Xos         , Xos         , Xos         , Yhr         , Xos         , Xos         , Xos         , Xos         , Xos         , Xos         , Xos         , Xos         , Xos         , Xos         , Xos         , Cud         , Cud         , Cud         , Xos         
Urb         , Rr          , Rr          , Urb         , Urb^Z/      , Xos         , Xos         , Xos         , Xos         , Xos         , Urb         , Xos         , Xos         , Xos         , Xos         , Xos         , Cud         , Xos         , Cud         , Xos         , Cud         , Cud         , Cud         , Cud         , Xos         , Xos         
Xos         , Urb         , Urb^Z/      , Rr^Z/       , Rr          , Urb         , Urb         , Xos         , Cud         , Urb         , Xos         , Urb         , Cud         , Xos         , Urb         , Cud         , Cud         , Cud         , 3 Kud       , Cud         , 2 Kud       , Cud         , Xos         , Xos         , Xos         , Xos         
Xos         , Xos         , Xos         , Urb         , Urb         , Rr          , Rr          , Urb         , Urb         , Urb         , Urb         , Urb         , Urb         , Urb         , Cud         , Cud         , Cud         , Cud         , Cud         , Cud         , Cud         , Cud         , Xos         , Xos         , Xos         , Xos         
Xos         , Xos         , Xos         , Xos         , Urb         , Urb         , Urb         , Rr          , Urb         , Urb         , Wwg         , Wwg         , Wwg         , Urb         , Urb         , Cud         , Cud         , 4 Kud       , Cud         , Cud         , Cud         , Cud         , Xos         , Xos         , Xos         , Xos         
Xos         , Xos         , Xos         , Xos         , Urb         , Urb         , Urb         , Urb         , Wwg         , Wwg         , Wwg         , Wwg         , Urb         , Urb         , Rr          , Urb         , Urb         , Cud         , Cud         , 5 Kud       , Cud         , Cud         , Cud         , Xos         , Xos         , Xos         
Xos         , Xos         , Xos         , Xos         , Cud         , Urb         , Urb         , Urb         , Urb         , Wwg         , Urb         , Urb         , Rr          , Rr          , Rr          , Rr          , Rr          , Urb         , Urb         , Cud         , Urb         , Urb         , Urb         , Xos         , Yhr         , Yhr         
Yhl         , Yhr^Xo      , Yhr^Xp      , Xos         , Urb         , Urb         , Urb         , Urb         , Urb         , Urb         , Urb         , Rr          , Rr          , 1 Rr        , Rr          , Rr          , Urb         , Urb         , Wwg         , Urb         , Urb         , Xos         , Urb         , Urb         , Xos         , Xos         
Xos         , Xos         , Xos         , Urb         , Urb         , Xos         , Urb         , Urb         , Wwg         , Wwg         , Wwg         , Urb         , Urb         , Rr          , Urb         , Urb         , Wwg         , Wwg         , Wwg         , Wwg         , Urb         , Urb         , Cud         , Xos         , Xos         , Xos         
Xos         , Xos         , Xos         , Xos         , Cud         , Urb         , Urb         , Urb         , Urb         , Wwg         , Wwg         , Wwg         , Wwg         , Urb         , Urb         , Wwg         , Wwg         , Wwg         , Urb         , Urb         , Urb         , Urb         , Xos         , Xos         , Xos         , Xos         
Xos         , Xos         , Xos         , Xos         , Urb         , Urb         , Urb         , Urb         , Rr          , Urb         , Urb         , Wwg         , Urb         , Urb         , Urb         , Urb         , Urb         , Urb         , Urb         , Urb         , Xos         , Xos         , Xos         , Xos         , Xos         , Xos         
Xos         , Xos         , Xos         , Xos         , Urb         , Urb         , Rr          , Rr          , Urb         , Urb         , Xos         , Urb         , Urb         , Urb         , Urb         , Urb         , Urb         , Rr          , Rr          , Urb         , Urb         , Xos         , Xos         , Xos         , Xos         , Xos         
Xos         , Xos         , Cud         , Urb         , Rr          , Rr          , Urb         , Urb         , Cud         , Urb         , Urb         , Urb         , Cud         , Urb         , Urb         , Urb         , Xos         , Urb         , Urb         , Rr          , Cud         , Cud         , Urb         , Xos         , Xos         , Xos         
Urb         , Urb         , Rr          , Cud         , Cud         , Urb         , Xos         , Xos         , Xos         , Xos         , Yhr^Xp      , Xos         , Xos         , Xos         , Xos         , Xos         , Xos         , Xos         , Xos         , Cud         , Urb         , Rr          , Rr          , Urb         , Urb         , Xos         
Rr          , Rr          , Urb         , Urb         , Xos         , Xos         , Xos         , Xos         , Xos         , Xos         , Yhr^Xo      , Xos         , Xos         , Xos         , Xos         , Xos         , Xos         , Xos         , Xos         , Xos         , Xos         , Urb         , Urb         , Rr          , Rr          , Urb         
Urb         , Urb         , Xos         , Xos         , Xos         , Xos         , Xos         , Xos         , Xos         , Xos         , Xos         , Yhl^Xp      , Yhl         , Xos         , Xos         , Xos         , Xos         , Xos         , Xos         , Xos         , Xos         , Xos         , Xos         , Urb         , Cud         , Cud         
Xos         , Xos         , Xos         , Xos         , Xos         , Xos         , Xos         , Xos         , Xos         , Xos         , Xos         , Xos         , Xos         , Yhl         , Xos         , Xos         , Xos         , Xos         , Xos         , Xos         , Xos         , Xos         , Xos         , Xos         , Xos         , Urb         
Xos         , Xos         , Xos         , Xos         , Xos         , Xos         , Xos         , Xos         , Xos         , Xos         , Xos         , Xos         , Xos         , Yhl^Xp      , Xos         , Xos         , Xos         , Xos         , Xos         , Xos         , Xos         , Xos         , Xos         , Xos         , Xos         , Xos         
