border_size=1
usage=map

Rr          , Urb         , Urb         , Xol         , Xol         , Xol         , Xol         , Xol         , Xol         , Xol         , Yhr         , Xol         , Xol         , Xol         , Xol         , Xol         , Xol         , Xol         , Xol         , Xol         , Xol         , Xol         , Cud         , Cud         , Cud         , Xol         
Urb         , Rr          , Rr          , Urb         , Urb^Z/      , Xol         , Xol         , Xol         , Xol         , Xol         , Urb         , Xol         , Xol         , Xol         , Xol         , Xol         , Cud         , Xol         , Cud         , Xol         , Cud         , Cud         , Cud         , Cud         , Xol         , Xol         
Xol         , Urb         , Urb^Z/      , Rr^Z/       , Rr          , Urb         , Urb         , Xol         , Cud         , Urb         , Xos         , Urb         , Cud         , Xol         , Urb         , Cud         , Cud         , Cud         , 3 Kud       , Cud         , 2 Kud       , Cud         , Xol         , Xol         , Xol         , Xol         
Xol         , Xol         , Xol         , Urb         , Urb         , Rr          , Rr          , Urb         , Urb         , Urb         , Urb         , Urb         , Urb         , Urb         , Cud         , Cud         , Cud         , Cud         , Cud         , Cud         , Cud         , Cud         , Xol         , Xol         , Xol         , Xol         
Xol         , Xol         , Xol         , Xol         , Urb         , Urb         , Urb         , Rr          , Urb         , Urb         , Wwg         , Wwg         , Wwg         , Urb         , Urb         , Cud         , Cud         , 4 Kud       , Cud         , Cud         , Cud         , Cud         , Xol         , Xol         , Xol         , Xol         
Xol         , Xol         , Xol         , Xol         , Urb         , Urb         , Urb         , Urb         , Wwg         , Wwg         , Wwg         , Wwg         , Urb         , Urb         , Rr          , Urb         , Urb         , Cud         , Cud         , 5 Kud       , Cud         , Cud         , Cud         , Xol         , Xol         , Xol         
Xol         , Xol         , Xol         , Xol         , Cud         , Urb         , Urb         , Urb         , Urb         , Wwg         , Urb         , Urb         , Rr          , Rr          , Rr          , Rr          , Rr          , Urb         , Urb         , Cud         , Urb         , Urb         , Urb         , Xol         , Yhr         , Yhr         
Yhl         , Yhr^Xo      , Yhr^Xp      , Xol         , Urb         , Urb         , Urb         , Urb         , Urb         , Urb         , Urb         , Rr          , Rr          , 1 Rr        , Rr          , Rr          , Urb         , Urb         , Wwg         , Urb         , Urb         , Xos         , Urb         , Urb         , Xol         , Xol         
Xol         , Xol         , Xol         , Urb         , Urb         , Xos         , Urb         , Urb         , Wwg         , Wwg         , Wwg         , Urb         , Urb         , Rr          , Urb         , Urb         , Wwg         , Wwg         , Wwg         , Wwg         , Urb         , Urb         , Cud         , Xol         , Xol         , Xol         
Xol         , Xol         , Xol         , Xol         , Cud         , Urb         , Urb         , Urb         , Urb         , Wwg         , Wwg         , Wwg         , Wwg         , Urb         , Urb         , Wwg         , Wwg         , Wwg         , Urb         , Urb         , Urb         , Urb         , Xol         , Xol         , Xol         , Xol         
Xol         , Xol         , Xol         , Xol         , Urb         , Urb         , Urb         , Urb         , Rr          , Urb         , Urb         , Wwg         , Urb         , Urb         , Urb         , Urb         , Urb         , Urb         , Urb         , Urb         , Xol         , Xol         , Xol         , Xol         , Xol         , Xol         
Xol         , Xol         , Xol         , Xol         , Urb         , Urb         , Rr          , Rr          , Urb         , Urb         , Xos         , Urb         , Urb         , Urb         , Urb         , Urb         , Urb         , Rr          , Rr          , Urb         , Urb         , Xol         , Xol         , Xol         , Xol         , Xol         
Xol         , Xol         , Cud         , Urb         , Rr          , Rr          , Urb         , Urb         , Cud         , Urb         , Urb         , Urb         , Cud         , Urb         , Urb         , Urb         , Xol         , Urb         , Urb         , Rr          , Cud         , Cud         , Urb         , Xol         , Xol         , Xol         
Urb         , Urb         , Rr          , Cud         , Cud         , Urb         , Xol         , Xol         , Xol         , Xol         , Yhr^Xp      , Xol         , Xol         , Xol         , Xol         , Xol         , Xol         , Xol         , Xol         , Cud         , Urb         , Rr          , Rr          , Urb         , Urb         , Xol         
Rr          , Rr          , Urb         , Urb         , Xol         , Xol         , Xol         , Xol         , Xol         , Xol         , Yhr^Xo      , Xol         , Xol         , Xol         , Xol         , Xol         , Xol         , Xol         , Xol         , Xol         , Xol         , Urb         , Urb         , Rr          , Rr          , Urb         
Urb         , Urb         , Xol         , Xol         , Xol         , Xol         , Xol         , Xol         , Xol         , Xol         , Xol         , Yhl^Xp      , Yhl         , Xol         , Xol         , Xol         , Xol         , Xol         , Xol         , Xol         , Xol         , Xol         , Xol         , Urb         , Cud         , Cud         
Xol         , Xol         , Xol         , Xol         , Xol         , Xol         , Xol         , Xol         , Xol         , Xol         , Xol         , Xol         , Xol         , Yhl         , Xol         , Xol         , Xol         , Xol         , Xol         , Xol         , Xol         , Xol         , Xol         , Xol         , Xol         , Urb         
Xol         , Xol         , Xol         , Xol         , Xol         , Xol         , Xol         , Xol         , Xol         , Xol         , Xol         , Xol         , Xol         , Yhl^Xp      , Xol         , Xol         , Xol         , Xol         , Xol         , Xol         , Xol         , Xol         , Xol         , Xol         , Xol         , Xol         
