border_size=1
usage=map

Xuc         , Xuc         , Xuc         , Xuc         , Xuc         , Xuc         , Xuc         , Xuc         , Xuc         , Xuc         , Xuc         , Xuc         , Xuc         , Xuc         , Xuc         , Yhl         , Xuc         , Xuc         , Ss          , Ss          , Ss          , Xuc         , Xuc         , Xuc         , Xuc         , Wog         , Wog         , Xuc         , Xuc         , Xuc         , Xuc         , Xuc         , Xuc         , Xuc         , Xuc         , Xuc         , Xuc         , Xuc         , Xuc         , Xuc         , Xuc         , Xuc         
Xuc         , Xuc         , Xuc         , Xuc         , Xuc         , Xuc         , Xuc         , Xuc         , Xuc         , Xuc         , Xuc         , Xuc         , Xuc         , Xuc         , Xuc         , Yhl         , Xuc         , Ss          , Xuc         , Ss          , Ss          , Xuc         , Xuc         , Xuc         , Wog         , Ss          , Ss          , Xuc         , Xuc         , Xuc         , Xuc         , Xuc         , Xuc         , Xuc         , Xuc         , Xuc         , Xuc         , Xuc         , Xuc         , Xuc         , Xuc         , Xuc         
Xuc         , Xuc         , Xuc         , Xuc         , Xuc         , Xuc         , Xuc         , Xuc         , Xuc         , Xuc         , Xuc         , Xuc         , Xuc         , Xuc         , Xuc         , Yhl^Xp      , Yhl^Xp      , Ss          , Ss          , Ss          , Xuc         , Xuc         , Xuce        , Ss          , Wog         , Ss          , Xuc         , Xuc         , Xuc         , Xuc         , Xuc         , Xuc         , Xuc         , Xuc         , Xuc         , Xuc         , Xuc         , Xuc         , Xuc         , Xuc         , Xuc         , Xuc         
Xuc         , Xuc         , Xuc         , Xuc         , Xuc         , Xuc         , Xuc         , Xuc         , Xuc         , Xuc         , Xuc         , Xuc         , Xuc         , Ss          , Ss          , Xuc         , Xuc         , Yhl         , Yhl^Xp      , Xuc         , Xuce        , Xuc         , Xuce        , Wwg         , Ss          , Xuc         , Xuc         , Xuc         , Xuc         , Xuc         , Xuc         , Xuc         , Xuc         , Xuc         , Xuc         , Xuc         , Xuc         , Xuc         , Xuc         , Xuc         , Xuc         , Xuc         
Xuc         , Xuc         , Xuc         , Xuc         , Qxu         , Xuc         , Xuc         , Xuc         , Xos         , Xuc         , Xuc         , Xuc         , Xuc         , Xuc         , Ss          , Xuc         , Xuc         , Xuc         , Uh          , Xuce        , Uue         , Xuce        , Uu^Em       , Ss          , Ss          , Xuc         , Ss          , Ss          , Ss          , Xuc         , Xuc         , Xuc         , Xuc         , Xuc         , Xuc         , Xuc         , Xuc         , Xuc         , Xuc         , Xuc         , Xuc         , Xuc         
Uu          , Xuc         , Xuc         , Qxu         , Qxu         , Xuc         , Xuc         , Xuc         , Xuc         , Xos         , Xos         , Xuc         , Xuc         , Yhl         , Yhl^Xp      , Xuc         , Xuc         , Uu^Es       , Uh          , Uu^Es       , Uue^Em      , Uue         , Uh          , Uu          , Ss          , Ss          , Xuc         , Ss          , Ss          , Xuc         , Xuc         , Xuc         , Xuc         , Xuc         , Xuc         , Xuc         , Xuc         , Xuc         , Xuc         , Xuc         , Xuc         , Xuc         
Ur^Br\      , Uu          , Uu          , Qxu         , Xuc         , Xuc         , Uh          , Xuc         , Xuc         , Xuc         , Xuc         , Xos         , Xos         , Xuc         , Yhl         , Yhl^Es      , Uu^Es       , Xuc         , Uu^Em       , Uu          , Uu          , Uue         , Uh          , Uh          , Uh          , Xuc         , Xuc         , Xuc         , Xuc         , Xuc         , Xuc         , Xuc         , Xuc         , Xuc         , Xuc         , Xuc         , Xuc         , Xuc         , Xuc         , Xuc         , Xuc         , Xuc         
Uu          , Ur^Br\      , Ur^Br\      , Uu^Em       , Uu^Em       , Xuc         , Uh          , Xuc         , Xuc         , Xuc         , Xuc         , Xuc         , Xuc         , Xos         , Xuc         , Xuc         , Uu          , Uu          , Uu^Uf       , 2 Uu        , Uh          , Xuc         , Uh          , Uu^Es       , Yhl^Xp      , Yhl^Xp      , Yhl         , Xuc         , Xuc         , Xuc         , Xuc         , Xuc         , Xuc         , Xuc         , Xuc         , Xuc         , Xuc         , Xuc         , Xuc         , Xuc         , Xuc         , Xuc         
Xuc         , Uu          , Ur^Es       , Ur^Br\      , Ur^Br\      , Uu          , Uu^Em       , Uh          , Xuc         , Uh          , Uh          , Uh          , Xuc         , Xos         , Yhl         , Yhl^Xp      , Xuc         , Uh          , Uu^Em       , Uu^Uf       , Uu^Em       , Xuc         , Uu^Em       , Uu          , Xuc         , Yhl^Xp      , Xuc         , Xuc         , Xuc         , Xuc         , Xuc         , Xuc         , Xuc         , Xuc         , Xuc         , Xuc         , Xuc         , Xuc         , Xuc         , Xuc         , Xuc         , Xuc         
Xuc         , Qxu         , Xuc         , Uu^Ii       , Uu          , Ur^Br\      , Ur^Br\      , Uu^Ii       , Uu^Ii       , Uh          , Uh          , Xuc         , Uh          , Xos         , Xos         , Xuc         , Xuc         , Uu^Uf       , Uh          , Uu          , Uu^Em       , Uh          , Uu^Uf       , Uu^Uf       , Yhl^Xp      , Xuc         , Xuc         , Xuc         , Xuc         , Xuc         , Xuc         , Xuc         , Xuc         , Xuc         , Xuc         , Xuc         , Xuc         , Xuc         , Xuc         , Xuc         , Xuc         , Xuc         
Xuc         , Xuc         , Xuc         , Xuc         , Xuc         , Uu^Ii       , Uu          , Ur^Br\      , Ur^Br\      , Uu          , Re^Es       , Xuc         , Uh          , Xuc         , Xuc         , Xos         , Xos         , Xuc         , Uh          , Uu^Xo       , Xuc         , Xuc         , Xuc         , Yhl         , Xuc         , Xuc         , Xuc         , Xuc         , Xos         , Xos         , Xos         , Xuc         , Xuc         , Xuc         , Xuc         , Xuc         , Xuc         , Xuc         , Xuc         , Xuc         , Xuc         , Xuc         
Xuc         , Xuc         , Xuc         , Xuc         , Qxu         , Xuc         , Qxu         , Qxu         , Uu^Es       , Ur^Br\      , Uu^Br\      , Re^Em       , Uu          , Uh          , Xuc         , Xuc         , Xuc         , Xos         , Xos         , Uu          , Xos         , Xos         , Xos         , Xuc         , Xuc         , Xuc         , Xos         , Xos         , Xos         , Xos         , Xos         , Xos         , Xos         , Xuc         , Xuc         , Xuc         , Xuc         , Xuc         , Xuc         , Xuc         , Xuc         , Xuc         
Xuc         , Xuc         , Xuc         , Xuc         , Qxu         , Qxu         , Qxu         , Qxu         , Uh          , Qxu         , Uh          , Uu^Br\      , Uh          , Uu^Uf       , Uu^Em       , Uh          , Uh          , Uu^Em       , Ur^Es       , Xos         , Xos         , Xuc         , Xuc         , Xos         , Xos         , Xos         , Xos         , Xos         , Xos         , Xos         , Xos         , Xos         , Xos         , Xos         , Xos         , Xuc         , Xuc         , Xuc         , Xuc         , Xuc         , Xuc         , Xuc         
Xuc         , Xuc         , Xuc         , Xuc         , Xuc         , Qxu         , Xuc         , Xuc         , Uh          , Uue         , Re^Uf       , Re^Es       , Re^Es       , Uu          , Uh          , Uh          , Uu^Uf       , Uu          , Ur          , Uu^Uf       , Uu          , Xuc         , Uh          , Xos         , Xos         , Xos         , Xos         , Xos         , Xos         , Xos         , Xos         , Xos         , Xos         , Xos         , Yhl         , Xos         , Xos         , Xuc         , Xuc         , Xuc         , Xuc         , Xuc         
Xuc         , Xuc         , Xuc         , Xuc         , Xuc         , Xuc         , Xuc         , Xuc         , Xuc         , Uh          , Uu^Uf       , Re^Uf       , Re^Ii       , Uh          , Uh          , Uh          , Uu^Uf       , Uh^Es       , Ur          , Uh          , Uu^Ii       , Uh          , Xos         , Xos         , Wog         , Xos         , Wog         , Wog         , Wog         , Wog         , Xos         , Xos         , Yhl         , Yhl         , Yhl         , Yhl         , Yhl         , Xos         , Xos         , Xuc         , Xuc         , Xuc         
Xuc         , Xuc         , Xuc         , Xuc         , Xuc         , Xuc         , Xuc         , Xuc         , Xuc         , Uh          , Xuc         , Xuc         , Uue         , Uue         , Xuc         , Xuc         , Xuc         , Uu^Em       , Ur^Es       , Ur^Ii       , Urb^Es      , Uu          , Xos         , Xos         , Wog^Xo      , Wog         , Xos         , Wog         , Xos         , Xos         , Xos         , Yhl         , Yhl         , Yhl         , Yhl         , Yhl         , Xos         , Xos         , Xos         , Xos         , Xos         , Xuc         
Xuc         , Xuc         , Xuc         , Xuc         , Xuc         , Xuc         , Xuc         , Xuc         , Xuc         , Xuc         , Xuc         , Xuc         , Xuc         , Xuc         , Xos         , Xos         , Uu          , Uh^Ii       , Urb         , Ur          , Urb         , Urb         , Wwg         , Wog         , Wog         , Wog^Xo      , Uue         , Xos         , Xos         , Xos         , Xos         , Yhl         , Yhl         , Yhl         , Xos         , Xos         , Xos         , Xos         , Xos         , Xos         , Xos         , Xos         
Xuc         , Xuc         , Xuc         , Xuc         , Xuc         , Xuc         , Xuc         , Xuc         , Xuc         , Xuc         , Xuc         , Xuc         , Xos         , Xos         , Ss          , Xos         , Uh          , Urb         , Urb         , Urb         , Urb         , Urb^Ii      , Wwg         , Wog         , Ss          , Xos         , Xos         , Xos         , Xos         , Xos         , Xos         , Yhl         , Yhl         , Yhl         , Xos         , Xos         , Xos         , Xos         , Xos         , Xos         , Xuce        , Xuce        
Xuc         , Xuc         , Xuc         , Xuc         , Xuc         , Xuc         , Xuc         , Xuc         , Xuc         , Xuc         , Xos         , Xos         , Xos         , Sm          , Ss          , Ss          , Ss          , Sm          , Urb         , Wwf         , Urb^Ii      , Wwg^Es      , Wwg^Es      , Wwg         , Xos         , Xos         , Xos         , Xos         , Xos         , Xos         , Yhl^Z\      , Yhl         , Yhl         , Yhl         , Xos         , Xos         , Xos         , Xos         , Xuce        , Xuce        , Xuce        , Xuce        
Xuc         , Xuc         , Xuc         , Xuc         , Xuc         , Xuc         , Xuc         , Xuc         , Xos         , Xos         , Xos         , Xos         , Xos         , Xos         , Ss          , Ss          , Ss          , Sm          , Wwg         , Wwf^Es      , Urb         , Wwf         , Urb^Z/      , Urb^Z/      , Xos         , Xos         , Xos         , Xos         , Xos         , Xos         , Yhl         , Yhl^Z\      , Yhl^Z\      , Yhl         , Xos         , Xos         , Xuce        , Xuce        , Xuce        , Xuce        , Yhr         , Yhr         
Xuc         , Xuc         , Xuc         , Xuc         , Xuc         , Xuc         , Xos         , Xos         , Xos         , Xos         , Xos         , Xos         , Xos         , Xos         , Xos         , Sm          , Xos         , Sm          , Wwg^Es      , Wwg         , Xos         , Urb^Z/      , Urb         , Urb         , Xos         , Xos         , Xos         , Xos         , Xos         , Yhr         , Yhr         , Yhr         , Yhl         , Xos         , Xos         , Xuce        , Xuce        , Xuce        , Yhr         , Yhr         , Xuce        , Xuce        
Xuce        , Xuc         , Xuc         , Xuc         , Xos         , Xos         , Xos         , Xos         , Xos         , Xos         , Xos         , Xos         , Xos         , Xos         , Xos         , Xos         , Wog         , Wog         , Wwg         , Wwg         , Xos         , Urb         , Urb         , Urb         , Xos         , Xos         , Xos         , Xos         , Uh          , Uue         , 3 Uue       , Yhl         , Xos         , Xos         , Xos         , Xuce        , Xuce        , Yhr         , Xuce        , Xuce        , Xuce        , Xuce        
Xuce        , Xuce        , Xuce        , Xos         , Xos         , Xos         , Xos         , Xos         , Xos         , Xos         , Xos         , Xos         , Xos         , Xos         , Wog         , Wog^Xo      , Wog^Xo      , Wog         , Xos         , Xos         , Xos         , Urb         , Cud         , Cud         , Urb         , Xos         , Xos         , Uh          , Uh          , Yhr         , Uue         , Yhr         , Xos         , Xos         , Xos         , Xuce        , Xuce        , Yhr         , Xuce        , Xuce        , Xos         , Xos         
Xuce        , Xuce        , Xuce        , Xuce        , Xuce        , Xos         , Xos         , Xos         , Xos         , Xos         , Xos         , Xos         , Wog         , Wog         , Wog         , Wog         , Xos         , Xos         , Xos         , Xos         , Xos         , Cud         , Urb         , Urb         , Urb         , Urb         , Re          , Xos         , Xos         , Uue         , Uh          , Uue         , Xos         , Xos         , Xos         , Xuce        , Xuce        , Yhr^Xo      , Xuce        , Xuce        , Yhr         , Yhr         
Xuce        , Xuce        , Xuce        , Xuce        , Xuce        , Xuce        , Xuce        , Xos         , Xos         , Xos         , Xos         , Wog         , Wog         , Wog         , Xos         , Xos         , Xos         , Xos         , Xos         , Xos         , Xos         , Xos         , Xos         , Urb         , Re          , Urb         , Re          , Re          , Urb         , Xos         , Xos         , Xos         , Xos         , Xos         , Xos         , Xuce        , Xuce        , Yhr^Xp      , Qxe         , Xu          , Xu          , Ur^Br/      
Xuce        , Xuce        , Xuce        , Xuce        , Xuce        , Xuce        , Xuce        , Xuce        , Xuce        , Xos         , Xos         , Wog         , Wog         , Xos         , Xos         , Xos         , Xos         , Xos         , Xos         , Xos         , Xos         , Xos         , Xos         , Xos         , Xos         , Re          , Urb         , Urb         , Urb         , Urb         , Xos         , Xos         , Xos         , Xos         , Xos         , Xuce        , Uue         , Qxe         , Uh          , Xuc         , Xu          , Uue         
Xuce        , Xuce        , Xuce        , Xuce        , Xuce        , Xuce        , Xuce        , Xuce        , Xuce        , Xuce        , Xuce        , Wog         , Wog         , Wog         , Xos         , Xos         , Xos         , Xos         , Xos         , Xos         , Xos         , Xos         , Xos         , Xos         , Xos         , Xos         , Xos         , Urb         , Re          , Re          , Xos         , Qxe         , Qxe         , Xos         , Uh          , Uh          , Ur^Br/      , Uh          , Uue         , Xuc         , Xuce        , Xuce        
Xuce        , Xuce        , Xuce        , Xuce        , Xuce        , Xuce        , Xuce        , Xuce        , Xuce        , Xuce        , Xuce        , Xuce        , Wog         , Wog         , Xos         , Xos         , Xos         , Xos         , Xos         , Xos         , Xos         , Xos         , Xos         , Xos         , Yhr         , Xos         , Xos         , Urb         , Cud         , Cud         , Xos         , Xos         , Xos         , Qxe         , Qxe         , Ur^Br|      , Uue         , Uue         , Qxe         , Qxe         , Xuce        , Xuce        
Md          , Xuce        , Md          , Xuce        , Xuce        , Xuce        , Xuce        , Xuce        , Xuce        , Xuce        , Xuce        , Xuce        , Wog         , Wog         , Xos         , Xos         , Xos         , Xos         , Xos         , Xos         , Xos         , Xos         , Xos         , Xos         , Yhr^Xo      , Xos         , Xos         , Cud         , Urb         , Urb         , Xos         , Xos         , Xos         , Xos         , Urb         , Ur^Br|      , Urb         , Xos         , Xos         , Qxe         , Xos         , Xuce        
Md          , Md          , Md          , Md          , Md          , Xuce        , Xuce        , Xuce        , Xuce        , Xuce        , Xuce        , Xuce        , Wog         , Wog         , Xos         , Xos         , Xos         , Xos         , Xos         , Xos         , Xos         , Xos         , Xos         , Xos         , Yhr^Xp      , Xos         , Rb          , Urb         , Urb         , Urb         , Rb^Es       , Xos         , Xos         , Xos         , Uh          , Urb         , Ur^Em       , Xos         , Xos         , Xos         , Xos         , Xos         
Md          , Md          , Md          , Md          , Hhd         , Md          , Md          , Md          , Hhd         , Xuce        , Wwg         , Wwg         , Wwg         , Wwg         , Xos         , Xos         , Xos         , Xos         , Xos         , Yhr         , Yhr         , Xos         , Xos         , Xos         , Uh          , Xos         , Urb^Es      , Urb         , Urb         , Re          , Rb          , Rb          , Urb         , Rb          , Uh          , Uh          , Urb^Em      , Xos         , Xos         , Xos         , Xos         , Xos         
Hhd         , Hhd         , Md          , Md          , Ww          , Hhd         , Ww          , Md          , Ww          , Ww          , Ww          , Wwg         , Xuce        , Xuce        , Xos         , Xos         , Xos         , Xos         , Xos         , Xos         , Xos         , Yhr^Xo      , Yhr^Xp      , Xos         , Uue^Em      , Uue^Es      , Uue^Uf      , Uue         , Uu^Uf       , Re          , Re^Es       , Urb         , Urb         , Rb          , Urb         , Ur^Es       , Urb         , Xol         , Xol         , Xos         , Xos         , Xos         
Ww          , Ww          , Ww          , Ww          , Ww          , Ww          , Ww          , Ww          , Gg          , Ww          , Ww          , Hhd         , Xuce        , Xuce        , Xuce        , Xos         , Xos         , Xos         , Xos         , Xos         , Xos         , Xos         , Xos         , Uh          , Uue         , Uh^Em       , Uue^Uf      , Uue         , Uu^Emf      , Uu          , Re^Em       , Uu          , Urb         , Urb         , Urb         , 1 Urb       , Rr          , Urb         , Urb         , Xol         , Xol         , Xos         
Ww          , Ww          , Hhd         , Ww          , Hhd         , Gs          , Gs          , Gll         , Gll         , Gg          , Ww          , Hhd         , Hhd         , Xuce        , Xuce        , Xuce        , Xos         , Xos         , Xos         , Xos         , Xos         , Xos         , Xos         , Xos         , Uh          , Uu^Uf       , Uh          , Uue^Em      , Uue^Es      , Uu^Es       , Uu          , Uu^Em       , Uh          , Uu          , Uh          , Urb         , Urb         , Rd          , Rd          , Urb         , Urb         , Xol         
Hhd         , Md          , Hhd         , Gs          , Md          , Hhd         , Hhd         , Gg          , Hhd         , Gll         , Hhd         , Md          , Md          , Xuce        , Xuce        , Xuce        , Xuce        , Xos         , Xos         , Xos         , Xos         , Xos         , Yhr^Xo      , Yhr^Xp      , Xos         , Xos         , Qxu         , Qxe         , Qxe         , Uu^Em       , Uu^Em       , Uu^Es       , Uh          , Uu          , Uu^Uf       , Uh          , Xos         , Urb         , Urb         , Rr          , Rd          , Urb         
Md          , Md          , Hhd         , Gg          , Gg          , Hhd         , Hhd         , Gs          , Gg          , Hhd         , Md          , Md          , Hhd         , Md          , Xuce        , Xuce        , Xuce        , Xuce        , Xuce        , Xos         , Xos         , Yhr         , Xos         , Xos         , Xos         , Qxu         , Qxe         , Qxe         , Qxe         , Qxe         , Uu^Uf       , Uu^Uf       , Uu          , Uh          , Uu          , Uh          , Xos         , Xos         , Xol         , Urb         , Urb         , Rr          
