border_size=1
usage=map

Xuc         , Xuc         , Xuc         , Xuc         , Xuc         , Xuc         , Xuc         , Xuc         , Xuc         , Xuc         , Xuc         , Xuc         , Xuc         , Xuc         , Xuc         , Yhl         , Xuc         , Xuc         , Xuc         , Xuc         , Xuc         , Xuc         , Xuc         , Xuc         , Xuc         , Wog         , Wog         , Xuc         , Xuc         , Xuc         , Xuc         , Xuc         , Xuc         , Xuc         , Xuc         , Xuc         , Xuc         , Xuc         , Xuc         , Xuc         , Xuc         , Xuc         
Xuc         , Xuc         , Xuc         , Xuc         , Xuc         , Xuc         , Xuc         , Xuc         , Xuc         , Xuc         , Xuc         , Xuc         , Xuc         , Xuc         , Xuc         , Yhl         , Xuc         , Xuc         , Xuc         , Xuc         , Xuc         , Xuc         , Xuc         , Xuc         , Wog         , Wog         , Xuc         , Xuc         , Xuc         , Xuc         , Xuc         , Xuc         , Xuc         , Xuc         , Xuc         , Xuc         , Xuc         , Xuc         , Xuc         , Xuc         , Xuc         , Xuc         
Xuc         , Xuc         , Xuc         , Xuc         , Xuc         , Xuc         , Xuc         , Xuc         , Xuc         , Xuc         , Xuc         , Xuc         , Xuc         , Xuc         , Xuc         , Yhl         , Yhl         , Xuc         , Xuc         , Xuc         , Xuc         , Xuc         , Xuc         , Xuc         , Wog         , Wog         , Xuc         , Xuc         , Xuc         , Xuc         , Xuc         , Xuc         , Xuc         , Xuc         , Xuc         , Xuc         , Xuc         , Xuc         , Xuc         , Xuc         , Xuc         , Xuc         
Xuc         , Xuc         , Xuc         , Xuc         , Xuc         , Xuc         , Xuc         , Xuc         , Xuc         , Xuc         , Xuc         , Xuc         , Xuc         , Xuc         , Xuc         , Xuc         , Xuc         , Yhl         , Yhl         , Xuc         , Xuc         , Xuc         , Xuc         , Wwg         , Wwg         , Xuc         , Xuc         , Xuc         , Xuc         , Xuc         , Xuc         , Xuc         , Xuc         , Xuc         , Xuc         , Xuc         , Xuc         , Xuc         , Xuc         , Xuc         , Xuc         , Xuc         
Xuc         , Xuc         , Xuc         , Xuc         , Xuc         , Xuc         , Xuc         , Xuc         , Xuc         , Xuc         , Xuc         , Xuc         , Xuc         , Xuc         , Xuc         , Xuc         , Xuc         , Xuc         , Uu          , Xuc         , Uu          , Xuc         , Uu          , Wwg         , Wwg         , Xuc         , Xuc         , Xuc         , Xuc         , Xuc         , Xuc         , Xuc         , Xuc         , Xuc         , Xuc         , Xuc         , Xuc         , Xuc         , Xuc         , Xuc         , Xuc         , Xuc         
Xuc         , Xuc         , Xuc         , Xuc         , Xuc         , Xuc         , Xuc         , Xuc         , Xuc         , Xuc         , Xuc         , Xuc         , Xuc         , Yhl         , Yhl         , Xuc         , Xuc         , Uu          , Uu          , Uu          , Uu          , Uu          , Uu          , Uu          , Uu          , Wwg         , Xuc         , Xuc         , Xuc         , Xuc         , Xuc         , Xuc         , Xuc         , Xuc         , Xuc         , Xuc         , Xuc         , Xuc         , Xuc         , Xuc         , Xuc         , Xuc         
Xuc         , Xuc         , Xuc         , Xuc         , Xuc         , Xuc         , Xuc         , Xuc         , Xuc         , Xuc         , Xuc         , Xuc         , Xuc         , Xuc         , Yhl         , Yhl         , Uu          , Xuc         , Uu          , Uu          , Uu          , Uu          , Uu          , Uu          , Uu          , Xuc         , Xuc         , Xuc         , Xuc         , Xuc         , Xuc         , Xuc         , Xuc         , Xuc         , Xuc         , Xuc         , Xuc         , Xuc         , Xuc         , Xuc         , Xuc         , Xuc         
Xuc         , Xuc         , Xuc         , Xuc         , Xuc         , Xuc         , Xuc         , Xuc         , Xuc         , Xuc         , Xuc         , Xuc         , Xuc         , Xuc         , Xuc         , Xuc         , Uu          , Uu          , Uu          , Uu          , Uu          , Xuc         , Uu          , Uu          , Yhl         , Yhl         , Yhl         , Xuc         , Xuc         , Xuc         , Xuc         , Xuc         , Xuc         , Xuc         , Xuc         , Xuc         , Xuc         , Xuc         , Xuc         , Xuc         , Xuc         , Xuc         
Xuc         , Xuc         , Xuc         , Xuc         , Xuc         , Xuc         , Xuc         , Xuc         , Xuc         , Xuc         , Xuc         , Xuc         , Xuc         , Xuc         , Yhl         , Yhl         , Xuc         , Uu          , Uu          , Uu          , Uu          , Xuc         , Uu          , Uu          , Xuc         , Yhl         , Xuc         , Xuc         , Xuc         , Xuc         , Xuc         , Xuc         , Xuc         , Xuc         , Xuc         , Xuc         , Xuc         , Xuc         , Xuc         , Xuc         , Xuc         , Xuc         
Xuc         , Xuc         , Xuc         , Xuc         , Xuc         , Xuc         , Xuc         , Xuc         , Xuc         , Xuc         , Xuc         , Xuc         , Xuc         , Xuc         , Xuc         , Xuc         , Xuc         , Uu          , Uu          , Uu          , Uu          , Uu          , Uu          , Uu          , Yhl         , Xuc         , Xuc         , Xuc         , Xuc         , Xuc         , Xuc         , Xuc         , Xuc         , Xuc         , Xuc         , Xuc         , Xuc         , Xuc         , Xuc         , Xuc         , Xuc         , Xuc         
Xuc         , Xuc         , Xuc         , Xuc         , Xuc         , Xuc         , Xuc         , Xuc         , Xuc         , Xuc         , Xuc         , Xuc         , Xuc         , Xuc         , Xuc         , Xuc         , Xuc         , Xuc         , Uu^Z\       , Uu          , Xuc         , Xuc         , Xuc         , Yhl         , Xuc         , Xuc         , Xuc         , Xuc         , Xos         , Xos         , Xos         , Xuc         , Xuc         , Xuc         , Xuc         , Xuc         , Xuc         , Xuc         , Xuc         , Xuc         , Xuc         , Xuc         
Xuc         , Xuc         , Xuc         , Xuc         , Xuc         , Xuc         , Xuc         , Xuc         , Xuc         , Xuc         , Xuc         , Xuc         , Xuc         , Xuc         , Xuc         , Xuc         , Xuc         , Uu^Es       , Uu^Em       , Xuc         , Xuc         , Xuc         , Xuc         , Xuc         , Xuc         , Xuc         , Xos         , Xos         , Xos         , Xos         , Xos         , Xos         , Xos         , Xuc         , Xuc         , Xuc         , Xuc         , Xuc         , Xuc         , Xuc         , Xuc         , Xuc         
Xuc         , Xuc         , Xuc         , Xuc         , Xuc         , Xuc         , Xuc         , Xuc         , Xuc         , Xuc         , Xuc         , Xuc         , Xuc         , Xuc         , Xuc         , Xuc         , Uh          , Uu^Em       , Ur^Es       , Xuc         , Uu^Em       , Xuc         , Xuc         , Xuc         , Xos         , Xos         , Xos         , Xos         , Xos         , Xos         , Xos         , Xos         , Xos         , Xos         , Xos         , Xuc         , Xuc         , Xuc         , Xuc         , Xuc         , Xuc         , Xuc         
Xuc         , Xuc         , Xuc         , Xuc         , Xuc         , Xuc         , Xuc         , Xuc         , Xuc         , Xuc         , Xuc         , Xuc         , Xuc         , Xuc         , Xuc         , Xuc         , Uu^Uf       , Uu          , Ur          , Uu^Uf       , Xuc         , Xuc         , Xos         , Xos         , Xos         , Xos         , Xos         , Xos         , Xos         , Xos         , Xos         , Xos         , Xos         , Xos         , Xos         , Xos         , Xos         , Xuc         , Xuc         , Xuc         , Xuc         , Xuc         
Xuc         , Xuc         , Xuc         , Xuc         , Xuc         , Xuc         , Xuc         , Xuc         , Xuc         , Xuc         , Xuc         , Xuc         , Xuc         , Xuc         , Xuc         , Xuc         , Uu^Uf       , Uh^Es       , Ur          , Uh          , Xuc         , Xos         , Xos         , Xos         , Wog         , Xos         , Wog         , Wog         , Wog         , Wog         , Xos         , Xos         , Xos         , Xos         , Xos         , Xos         , Xos         , Xos         , Xos         , Xuc         , Xuc         , Xuc         
Xuc         , Xuc         , Xuc         , Xuc         , Xuc         , Xuc         , Xuc         , Xuc         , Xuc         , Xuc         , Xuc         , Xuc         , Xuc         , Xuc         , Xuc         , Xuc         , Xuc         , Uu^Em       , Ur^Es       , Ur          , Urb^Es      , Xos         , Xos         , Xos         , Wog^Xo      , Wog         , Xos         , Wog         , Xos         , Xos         , Xos         , Xos         , Xos         , Xos         , Xos         , Xos         , Xos         , Xos         , Xos         , Xos         , Xos         , Xuc         
Xuc         , Xuc         , Xuc         , Xuc         , Xuc         , Xuc         , Xuc         , Xuc         , Xuc         , Xuc         , Xuc         , Xuc         , Xuc         , Xuc         , Xos         , Xos         , Uu          , Uh          , Urb         , Ur          , Urb         , Xos         , Wwg         , Wog         , Wog^Xo      , Wog         , Xos         , Xos         , Xos         , Xos         , Xos         , Xos         , Xos         , Xos         , Xos         , Xos         , Xos         , Xos         , Xos         , Xos         , Xos         , Xos         
Xuc         , Xuc         , Xuc         , Xuc         , Xuc         , Xuc         , Xuc         , Xuc         , Xuc         , Xuc         , Xuc         , Xuc         , Xos         , Xos         , Xos         , Xos         , Uu          , Urb         , Urb         , Urb         , Urb         , Xos         , Wwg         , Wog         , Xos         , Xos         , Xos         , Xos         , Xos         , Xos         , Xos         , Xos         , Yhl         , Xos         , Xos         , Xos         , Xos         , Xos         , Xos         , Xos         , Xuce        , Xuce        
Xuc         , Xuc         , Xuc         , Xuc         , Xuc         , Xuc         , Xuc         , Xuc         , Xuc         , Xuc         , Xos         , Xos         , Xos         , Xos         , Xos         , Xos         , Xos         , Xos         , Urb         , Wwf         , Urb         , Wwg         , Wwg         , Wwg         , Xos         , Xos         , Xos         , Xos         , Xos         , Xos         , Yhl^Z\      , Yhl         , Yhl         , Yhl         , Xos         , Xos         , Xos         , Xos         , Xuce        , Xuce        , Xuce        , Xuce        
Xuc         , Xuc         , Xuc         , Xuc         , Xuc         , Xuc         , Xuc         , Xuc         , Xos         , Xos         , Xos         , Xos         , Xos         , Xos         , Xos         , Xos         , Xos         , Xos         , Wwg         , Wwf         , Urb         , Wwf         , Urb^Z/      , Urb^Z/      , Xos         , Xos         , Xos         , Xos         , Xos         , Xos         , Yhl         , Yhl^Z\      , Yhl^Z\      , Yhl         , Xos         , Xos         , Xuce        , Xuce        , Xuce        , Xuce        , Yhr         , Yhr         
Xuc         , Xuc         , Xuc         , Xuc         , Xuc         , Xuc         , Xos         , Xos         , Xos         , Xos         , Xos         , Xos         , Xos         , Xos         , Xos         , Xos         , Xos         , Xos         , Wwg         , Wwg         , Xos         , Urb^Z/      , Urb         , Urb         , Xos         , Xos         , Xos         , Xos         , Xos         , Yhr         , Yhr         , Yhr         , Yhl         , Xos         , Xos         , Xuce        , Xuce        , Xuce        , Yhr         , Yhr         , Xuce        , Xuce        
Xuce        , Xuc         , Xuc         , Xuc         , Xos         , Xos         , Xos         , Xos         , Xos         , Xos         , Xos         , Xos         , Xos         , Xos         , Xos         , Xos         , Wog^Xo      , Wog         , Wwg         , Wwg         , Xos         , Urb         , Urb         , Urb         , Xos         , Xos         , Xos         , Xos         , Uh          , Uue         , Uue         , Yhl         , Xos         , Xos         , Xos         , Xuce        , Xuce        , Yhr         , Xuce        , Xuce        , Xuce        , Xuce        
Xuce        , Xuce        , Xuce        , Xos         , Xos         , Xos         , Xos         , Xos         , Xos         , Xos         , Xos         , Xos         , Xos         , Xos         , Wog         , Wog         , Wog^Xo      , Wog         , Xos         , Xos         , Xos         , Urb         , Kud         , Cud         , Urb         , Xos         , Xos         , Uh          , Uh          , Yhr         , Uue         , Yhr         , Xos         , Xos         , Xos         , Xuce        , Xuce        , Yhr         , Xuce        , Xuce        , Xos         , Xos         
Xuce        , Xuce        , Xuce        , Xuce        , Xuce        , Xos         , Xos         , Xos         , Xos         , Xos         , Xos         , Xos         , Wog         , Wog         , Wog         , Wog         , Xos         , Xos         , Xos         , Xos         , Xos         , Cud         , Urb         , Urb         , Urb         , Urb         , Urb         , Xos         , Xos         , Uue         , Uh          , Uue         , Xos         , Xos         , Xos         , Xuce        , Xuce        , Yhr^Xo      , Xuce        , Xuce        , Urb         , Urb         
Xuce        , Xuce        , Xuce        , Xuce        , Xuce        , Xuce        , Xuce        , Xos         , Xos         , Xos         , Xos         , Wog         , Wog         , Wog         , Xos         , Xos         , Xos         , Xos         , Xos         , Xos         , Xos         , Xos         , Xos         , Urb         , Urb         , Urb         , Urb         , Urb         , Urb         , Xos         , Xos         , Xos         , Xos         , Xos         , Xos         , Xuce        , Xuce        , Yhr^Xp      , Urb^Es      , Urb         , Urb         , Urb         
Xuce        , Xuce        , Xuce        , Xuce        , Xuce        , Xuce        , Xuce        , Xuce        , Xuce        , Xos         , Xos         , Wog         , Wog         , Xos         , Xos         , Xos         , Xos         , Xos         , Xos         , Xos         , Xos         , Xos         , Xos         , Xos         , Xos         , Urb         , Urb         , Urb         , Urb         , Urb         , Xos         , Xos         , Xos         , Xos         , Xos         , Xuce        , Urb         , Urb^Es      , Urb         , Urb         , Xos         , Xos         
Xuce        , Xuce        , Xuce        , Xuce        , Xuce        , Xuce        , Xuce        , Xuce        , Xuce        , Xuce        , Xuce        , Wog         , Wog         , Wog         , Xos         , Xos         , Xos         , Xos         , Xos         , Xos         , Xos         , Xos         , Xos         , Xos         , Xos         , Xos         , Xos         , Urb         , Urb         , Urb         , Xos         , Xos         , Xos         , Xos         , Urb         , Urb         , Urb^Es      , Urb         , Xos         , Xos         , Xos         , Xos         
Xuce        , Xuce        , Xuce        , Xuce        , Xuce        , Xuce        , Xuce        , Xuce        , Xuce        , Xuce        , Xuce        , Xuce        , Wog         , Wog         , Xos         , Xos         , Xos         , Xos         , Xos         , Xos         , Xos         , Xos         , Xos         , Xos         , Yhr         , Xos         , Xos         , Urb         , Cud         , Cud         , Xos         , Xos         , Xos         , Xos         , Urb         , Urb         , Xos         , Xos         , Xos         , Xos         , Xos         , Xos         
Md          , Xuce        , Md          , Xuce        , Xuce        , Xuce        , Xuce        , Xuce        , Xuce        , Xuce        , Xuce        , Xuce        , Wog         , Wog         , Xos         , Xos         , Xos         , Xos         , Xos         , Xos         , Xos         , Xos         , Xos         , Xos         , Yhr^Xo      , Xos         , Xos         , Cud         , Urb         , Urb         , Xos         , Xos         , Xos         , Xos         , Cud         , Urb         , Xos         , Xos         , Xos         , Xos         , Xos         , Xos         
Md          , Md          , Md          , Md          , Md          , Xuce        , Xuce        , Xuce        , Xuce        , Xuce        , Xuce        , Xuce        , Wog         , Wog         , Xos         , Xos         , Xos         , Xos         , Xos         , Xos         , Xos         , Xos         , Xos         , Xos         , Yhr^Xp      , Xos         , Urb         , Urb         , Urb         , Urb         , Xos         , Xos         , Xos         , Xos         , Urb         , Cud         , Xos         , Xos         , Xos         , Xos         , Xos         , Xos         
Md          , Md          , Md          , Md          , Hhd         , Md          , Md          , Md          , Hhd         , Xuce        , Wwg         , Wwg         , Wwg         , Wwg         , Xos         , Xos         , Xos         , Xos         , Xos         , Yhr         , Yhr         , Xos         , Xos         , Xos         , Uh          , Xos         , Urb^Es      , Urb         , Urb         , Urb         , Urb         , Xos         , Urb         , Urb         , Urb         , Urb         , Xos         , Xos         , Xos         , Xos         , Xos         , Xos         
Hhd         , Hhd         , Md          , Md          , Ww          , Hhd         , Ww          , Md          , Ww          , Ww          , Ww          , Wwg         , Xuce        , Xuce        , Xos         , Xos         , Xos         , Xos         , Xos         , Xos         , Xos         , Yhr^Xo      , Yhr^Xp      , Xos         , Uue^Em      , Uue^Es      , Uue^Uf      , Uue         , Urb         , Urb         , Urb         , Urb         , Urb         , Urb         , Urb         , Urb         , Urb         , Xos         , Xos         , Xos         , Xos         , Xos         
Ww          , Ww          , Ww          , Ww          , Ww          , Ww          , Ww          , Ww          , Gg          , Ww          , Ww          , Hhd         , Xuce        , Xuce        , Xuce        , Xos         , Xos         , Xos         , Xos         , Xos         , Xos         , Xos         , Xos         , Uh          , Uue         , Uh^Em       , Uue^Uf      , Uue         , Urb         , Urb         , Urb         , Urb         , Urb         , Urb         , Urb         , 1 Urb       , Urb         , Urb         , Urb         , Xos         , Xos         , Xos         
Ww          , Ww          , Hhd         , Ww          , Hhd         , Gs          , Gs          , Gll         , Gll         , Gg          , Ww          , Hhd         , Hhd         , Xuce        , Xuce        , Xuce        , Xos         , Xos         , Xos         , Xos         , Xos         , Xos         , Xos         , Xos         , Uh          , Uu^Uf       , Uh          , Uue^Em      , Uue^Es      , Urb         , Urb         , Urb         , Xos         , Xos         , Xos         , Urb         , Urb         , Urb         , Urb         , Urb         , Urb         , Xos         
Hhd         , Md          , Hhd         , Gs          , Md          , Hhd         , Hhd         , Gg          , Hhd         , Gll         , Hhd         , Md          , Md          , Xuce        , Xuce        , Xuce        , Xuce        , Xos         , Xos         , Xos         , Xos         , Xos         , Yhr^Xo      , Yhr^Xp      , Xos         , Xos         , Xos         , Uu^Es       , Xos         , Uu^Em       , Xos         , Xos         , Xos         , Xos         , Xos         , Xos         , Xos         , Urb         , Urb         , Urb         , Urb         , Urb         
Md          , Md          , Hhd         , Gg          , Gg          , Hhd         , Hhd         , Gs          , Gg          , Hhd         , Md          , Md          , Hhd         , Md          , Xuce        , Xuce        , Xuce        , Xuce        , Xuce        , Xos         , Xos         , Yhr         , Xos         , Xos         , Xos         , Xos         , Xos         , Xos         , Xos         , Xos         , Xos         , Xos         , Xos         , Xos         , Xos         , Xos         , Xos         , Xos         , Xos         , Urb         , Urb         , Urb         
