border_size=1
usage=map

Xuc         , Xuc         , Xuc         , Xuc         , Xuc         , Xuc         , Xuc         , Xuc         , Xuc         , Xuc         , Xuc         , Xuc         , Xuc         , Xuc         , Xuc         , Yhl         , Xuc         , Xuc         , Ss          , Ss          , Ss          , Xuc         , Xuc         , Xuc         , Xuc         , Wog         , Wog         , Xuc         , Xuc         , Xuc         , Xuc         , Xuc         , Xuc         , Xuc         , Xuc         , Xuc         , Xuc         , Xuc         , Xuc         , Xuc         , Xuc         , Xuc         
Xuc         , Xuc         , Xuc         , Xuc         , Xuc         , Xuc         , Xuc         , Xuc         , Xuc         , Xuc         , Xuc         , Xuc         , Xuc         , Xuc         , Xuc         , Yhl         , Xuc         , Ss          , Xuc         , Ss          , Ss          , Xuc         , Xuc         , Xuc         , Wog         , Ss          , Ss          , Xuc         , Xuc         , Xuc         , Xuc         , Xuc         , Xuc         , Xuc         , Xuc         , Xuc         , Xuc         , Xuc         , Xuc         , Xuc         , Xuc         , Xuc         
Xuc         , Xuc         , Xuc         , Xuc         , Xuc         , Xuc         , Xuc         , Xuc         , Xuc         , Xuc         , Xuc         , Xuc         , Xuc         , Xuc         , Xuc         , Yhl^Xp      , Yhl^Xp      , Ss          , Ss          , Ss          , Xuc         , Xuc         , Xuce        , Ss          , Wog         , Ss          , Xuc         , Xuc         , Xuc         , Xuc         , Xuc         , Xuc         , Xuc         , Xuc         , Xuc         , Xuc         , Xuc         , Xuc         , Xuc         , Xuc         , Xuc         , Xuc         
Xuc         , Xuc         , Xuc         , Xuc         , Xuc         , Xuc         , Xuc         , Xuc         , Xuc         , Xuc         , Xuc         , Xuc         , Xuc         , Ss          , Ss          , Xuc         , Xuc         , Yhl         , Yhl^Xp      , Xuc         , Xuce        , Xuc         , Xuce        , Wwg         , Ss          , Xuc         , Xuc         , Xuc         , Xuc         , Xuc         , Xuc         , Xuc         , Xuc         , Xuc         , Xuc         , Xuc         , Xuc         , Xuc         , Xuc         , Xuc         , Xuc         , Xuc         
Xuc         , Xuc         , Xuc         , Xuc         , Xuc         , Xuc         , Xuc         , Xuc         , Xuc         , Xuc         , Xuc         , Xuc         , Xuc         , Xuc         , Ss          , Xuc         , Xuc         , Xuc         , Uh          , Xuce        , Uue         , Xuce        , Uu^Em       , Ss          , Ss          , Xuc         , Ss          , Ss          , Ss          , Xuc         , Xuc         , Xuc         , Xuc         , Xuc         , Xuc         , Xuc         , Xuc         , Xuc         , Xuc         , Xuc         , Xuc         , Xuc         
Xuc         , Xuc         , Xuc         , Xuc         , Xuc         , Xuc         , Xuc         , Xuc         , Xuc         , Xuc         , Xuc         , Xuc         , Xuc         , Yhl         , Yhl^Xp      , Xuc         , Xuc         , Uu^Es       , Uh          , Uu^Es       , Uue^Em      , Uue         , Uh          , Uu          , Ss          , Ss          , Xuc         , Ss          , Ss          , Xuc         , Xuc         , Xuc         , Xuc         , Xuc         , Xuc         , Xuc         , Xuc         , Xuc         , Xuc         , Xuc         , Xuc         , Xuc         
Xuc         , Xuc         , Xuc         , Xuc         , Xuc         , Xuc         , Xuc         , Xuc         , Xuc         , Xuc         , Xuc         , Xuc         , Xuc         , Xuc         , Yhl         , Yhl^Es      , Uu^Es       , Xuc         , Uu^Em       , Uu          , Uu          , Uue         , Uh          , Uh          , Uh          , Xuc         , Xuc         , Xuc         , Xuc         , Xuc         , Xuc         , Xuc         , Xuc         , Xuc         , Xuc         , Xuc         , Xuc         , Xuc         , Xuc         , Xuc         , Xuc         , Xuc         
Xuc         , Xuc         , Xuc         , Xuc         , Xuc         , Xuc         , Xuc         , Xuc         , Xuc         , Xuc         , Xuc         , Xuc         , Xuc         , Xuc         , Xuc         , Xuc         , Uu          , Uu          , Uu^Uf       , 2 Uu        , Uh          , Xuc         , Uh          , Uu^Es       , Yhl^Xp      , Yhl^Xp      , Yhl         , Xuc         , Xuc         , Xuc         , Xuc         , Xuc         , Xuc         , Xuc         , Xuc         , Xuc         , Xuc         , Xuc         , Xuc         , Xuc         , Xuc         , Xuc         
Xuc         , Xuc         , Xuc         , Xuc         , Xuc         , Xuc         , Xuc         , Xuc         , Xuc         , Xuc         , Xuc         , Xuc         , Xuc         , Xuc         , Yhl         , Yhl^Xp      , Xuc         , Uh          , Uu^Em       , Uu^Uf       , Uu^Em       , Xuc         , Uu^Em       , Uu          , Xuc         , Yhl^Xp      , Xuc         , Xuc         , Xuc         , Xuc         , Xuc         , Xuc         , Xuc         , Xuc         , Xuc         , Xuc         , Xuc         , Xuc         , Xuc         , Xuc         , Xuc         , Xuc         
Xuc         , Xuc         , Xuc         , Xuc         , Xuc         , Xuc         , Xuc         , Xuc         , Xuc         , Xuc         , Xuc         , Xuc         , Xuc         , Xuc         , Xuc         , Xuc         , Xuc         , Uu^Uf       , Uu^Xo       , Uu          , Uu^Em       , Uh          , Uu^Uf       , Uu^Uf       , Yhl^Xp      , Xuc         , Xuc         , Xuc         , Xuc         , Xuc         , Xuc         , Xuc         , Xuc         , Xuc         , Xuc         , Xuc         , Xuc         , Xuc         , Xuc         , Xuc         , Xuc         , Xuc         
Xuc         , Xuc         , Xuc         , Xuc         , Xuc         , Xuc         , Xuc         , Xuc         , Xuc         , Xuc         , Xuc         , Xuc         , Xuc         , Xuc         , Xuc         , Xuc         , Xuc         , Xuc         , Uu^Z\       , Uu^Xo       , Xuc         , Xuc         , Xuc         , Yhl         , Xuc         , Xuc         , Xuc         , Xuc         , Xos         , Xos         , Xos         , Xuc         , Xuc         , Xuc         , Xuc         , Xuc         , Xuc         , Xuc         , Xuc         , Xuc         , Xuc         , Xuc         
Xuc         , Xuc         , Xuc         , Xuc         , Xuc         , Xuc         , Xuc         , Xuc         , Xuc         , Xuc         , Xuc         , Xuc         , Xuc         , Xuc         , Xuc         , Xuc         , Xuc         , Uu^Es       , Uu^Em       , Xuc         , Xuc         , Xuc         , Xuc         , Xuc         , Xuc         , Xuc         , Xos         , Xos         , Xos         , Xos         , Xos         , Xos         , Xos         , Xuc         , Xuc         , Xuc         , Xuc         , Xuc         , Xuc         , Xuc         , Xuc         , Xuc         
Xuc         , Xuc         , Xuc         , Xuc         , Xuc         , Xuc         , Xuc         , Xuc         , Xuc         , Xuc         , Xuc         , Xuc         , Xuc         , Xuc         , Xuc         , Xuc         , Uh          , Uu^Em       , Ur^Es       , Xuc         , Uu^Em       , Xuc         , Xuc         , Xuc         , Xos         , Xos         , Xos         , Xos         , Xos         , Xos         , Xos         , Xos         , Xos         , Xos         , Xos         , Xuc         , Xuc         , Xuc         , Xuc         , Xuc         , Xuc         , Xuc         
Xuc         , Xuc         , Xuc         , Xuc         , Xuc         , Xuc         , Xuc         , Xuc         , Xuc         , Xuc         , Xuc         , Xuc         , Xuc         , Xuc         , Xuc         , Xuc         , Uu^Uf       , Uu          , Ur          , Uu^Uf       , Xuc         , Xuc         , Xos         , Xos         , Xos         , Xos         , Xos         , Xos         , Xos         , Xos         , Xos         , Xos         , Xos         , Xos         , Yhl         , Xos         , Xos         , Xuc         , Xuc         , Xuc         , Xuc         , Xuc         
Xuc         , Xuc         , Xuc         , Xuc         , Xuc         , Xuc         , Xuc         , Xuc         , Xuc         , Xuc         , Xuc         , Xuc         , Xuc         , Xuc         , Xuc         , Xuc         , Uu^Uf       , Uh^Es       , Ur          , Uh          , Xuc         , Xos         , Xos         , Xos         , Wog         , Xos         , Wog         , Wog         , Wog         , Wog         , Xos         , Xos         , Yhl         , Yhl         , Yhl         , Yhl         , Yhl         , Xos         , Xos         , Xuc         , Xuc         , Xuc         
Xuc         , Xuc         , Xuc         , Xuc         , Xuc         , Xuc         , Xuc         , Xuc         , Xuc         , Xuc         , Xuc         , Xuc         , Xuc         , Xuc         , Xuc         , Xuc         , Xuc         , Uu^Em       , Ur^Es       , Ur          , Urb^Es      , Xos         , Xos         , Xos         , Wog^Xo      , Wog         , Xos         , Wog         , Xos         , Xos         , Xos         , Yhl         , Yhl         , Yhl         , Yhl         , Yhl         , Xos         , Xos         , Xos         , Xos         , Xos         , Xuc         
Xuc         , Xuc         , Xuc         , Xuc         , Xuc         , Xuc         , Xuc         , Xuc         , Xuc         , Xuc         , Xuc         , Xuc         , Xuc         , Xuc         , Xos         , Xos         , Uu          , Uh          , Urb         , Ur          , Urb         , Xos         , Wwg         , Wog         , Wog^Xo      , Wog         , Xos         , Xos         , Xos         , Xos         , Xos         , Yhl         , Yhl         , Yhl         , Xos         , Xos         , Xos         , Xos         , Xos         , Xos         , Xos         , Xos         
Xuc         , Xuc         , Xuc         , Xuc         , Xuc         , Xuc         , Xuc         , Xuc         , Xuc         , Xuc         , Xuc         , Xuc         , Xos         , Xos         , Xos         , Xos         , Uu          , Urb         , Urb         , Urb         , Urb         , Xos         , Wwg         , Wog         , Xos         , Xos         , Xos         , Xos         , Xos         , Xos         , Xos         , Yhl         , Yhl         , Yhl         , Xos         , Xos         , Xos         , Xos         , Xos         , Xos         , Xuce        , Xuce        
Xuc         , Xuc         , Xuc         , Xuc         , Xuc         , Xuc         , Xuc         , Xuc         , Xuc         , Xuc         , Xos         , Xos         , Xos         , Xos         , Xos         , Xos         , Xos         , Xos         , Urb         , Wwf         , Urb         , Wwg^Es      , Wwg^Es      , Wwg         , Xos         , Xos         , Xos         , Xos         , Xos         , Xos         , Yhl^Z\      , Yhl         , Yhl         , Yhl         , Xos         , Xos         , Xos         , Xos         , Xuce        , Xuce        , Xuce        , Xuce        
Xuc         , Xuc         , Xuc         , Xuc         , Xuc         , Xuc         , Xuc         , Xuc         , Xos         , Xos         , Xos         , Xos         , Xos         , Xos         , Xos         , Xos         , Xos         , Xos         , Wwg         , Wwf^Es      , Urb         , Wwf         , Urb^Z/      , Urb^Z/      , Xos         , Xos         , Xos         , Xos         , Xos         , Xos         , Yhl         , Yhl^Z\      , Yhl^Z\      , Yhl         , Xos         , Xos         , Xuce        , Xuce        , Xuce        , Xuce        , Yhr         , Yhr         
Xuc         , Xuc         , Xuc         , Xuc         , Xuc         , Xuc         , Xos         , Xos         , Xos         , Xos         , Xos         , Xos         , Xos         , Xos         , Xos         , Xos         , Xos         , Xos         , Wwg^Es      , Wwg         , Xos         , Urb^Z/      , Urb         , Urb         , Xos         , Xos         , Xos         , Xos         , Xos         , Yhr         , Yhr         , Yhr         , Yhl         , Xos         , Xos         , Xuce        , Xuce        , Xuce        , Yhr         , Yhr         , Xuce        , Xuce        
Xuce        , Xuc         , Xuc         , Xuc         , Xos         , Xos         , Xos         , Xos         , Xos         , Xos         , Xos         , Xos         , Xos         , Xos         , Xos         , Xos         , Wog^Xo      , Wog         , Wwg         , Wwg         , Xos         , Urb         , Urb         , Urb         , Xos         , Xos         , Xos         , Xos         , Uh          , Uue         , 3 Uue       , Yhl         , Xos         , Xos         , Xos         , Xuce        , Xuce        , Yhr         , Xuce        , Xuce        , Xuce        , Xuce        
Xuce        , Xuce        , Xuce        , Xos         , Xos         , Xos         , Xos         , Xos         , Xos         , Xos         , Xos         , Xos         , Xos         , Xos         , Wog         , Wog         , Wog^Xo      , Wog         , Xos         , Xos         , Xos         , Urb         , Cud         , Cud         , Urb         , Xos         , Xos         , Uh          , Uh          , Yhr         , Uue         , Yhr         , Xos         , Xos         , Xos         , Xuce        , Xuce        , Yhr         , Xuce        , Xuce        , Xos         , Xos         
Xuce        , Xuce        , Xuce        , Xuce        , Xuce        , Xos         , Xos         , Xos         , Xos         , Xos         , Xos         , Xos         , Wog         , Wog         , Wog         , Wog         , Xos         , Xos         , Xos         , Xos         , Xos         , Cud         , Urb         , Urb         , Urb         , Urb         , Urb         , Xos         , Xos         , Uue         , Uh          , Uue         , Xos         , Xos         , Xos         , Xuce        , Xuce        , Yhr^Xo      , Xuce        , Xuce        , Yhr         , Yhr         
Xuce        , Xuce        , Xuce        , Xuce        , Xuce        , Xuce        , Xuce        , Xos         , Xos         , Xos         , Xos         , Wog         , Wog         , Wog         , Xos         , Xos         , Xos         , Xos         , Xos         , Xos         , Xos         , Xos         , Xos         , Urb         , Urb         , Urb         , Urb         , Urb         , Urb         , Xos         , Xos         , Xos         , Xos         , Xos         , Xos         , Xuce        , Xuce        , Yhr^Xp      , Urb^Es      , Yhr         , Yhr         , Yhr         
Xuce        , Xuce        , Xuce        , Xuce        , Xuce        , Xuce        , Xuce        , Xuce        , Xuce        , Xos         , Xos         , Wog         , Wog         , Xos         , Xos         , Xos         , Xos         , Xos         , Xos         , Xos         , Xos         , Xos         , Xos         , Xos         , Xos         , Urb         , Urb         , Urb         , Urb         , Urb         , Xos         , Xos         , Xos         , Xos         , Xos         , Xuce        , Urb         , Urb^Es      , Urb         , Urb         , Xos         , Xos         
Xuce        , Xuce        , Xuce        , Xuce        , Xuce        , Xuce        , Xuce        , Xuce        , Xuce        , Xuce        , Xuce        , Wog         , Wog         , Wog         , Xos         , Xos         , Xos         , Xos         , Xos         , Xos         , Xos         , Xos         , Xos         , Xos         , Xos         , Xos         , Xos         , Urb         , Urb         , Urb         , Xos         , Xos         , Xos         , Xos         , Urb         , Urb         , Urb^Es      , Urb         , Xos         , Xos         , Xos         , Xos         
Xuce        , Xuce        , Xuce        , Xuce        , Xuce        , Xuce        , Xuce        , Xuce        , Xuce        , Xuce        , Xuce        , Xuce        , Wog         , Wog         , Xos         , Xos         , Xos         , Xos         , Xos         , Xos         , Xos         , Xos         , Xos         , Xos         , Yhr         , Xos         , Xos         , Urb         , Cud         , Cud         , Xos         , Xos         , Xos         , Xos         , Urb         , Urb         , Xos         , Xos         , Xos         , Xos         , Xos         , Xos         
Md          , Xuce        , Md          , Xuce        , Xuce        , Xuce        , Xuce        , Xuce        , Xuce        , Xuce        , Xuce        , Xuce        , Wog         , Wog         , Xos         , Xos         , Xos         , Xos         , Xos         , Xos         , Xos         , Xos         , Xos         , Xos         , Yhr^Xo      , Xos         , Xos         , Cud         , Urb         , Urb         , Xos         , Xos         , Xos         , Xos         , Cud         , Urb         , Xos         , Xos         , Xos         , Xos         , Xos         , Xos         
Md          , Md          , Md          , Md          , Md          , Xuce        , Xuce        , Xuce        , Xuce        , Xuce        , Xuce        , Xuce        , Wog         , Wog         , Xos         , Xos         , Xos         , Xos         , Xos         , Xos         , Xos         , Xos         , Xos         , Xos         , Yhr^Xp      , Xos         , Urb         , Urb         , Urb         , Urb         , Xol         , Xos         , Xos         , Xos         , Urb         , Cud         , Xos         , Xos         , Xos         , Xos         , Xos         , Xos         
Md          , Md          , Md          , Md          , Hhd         , Md          , Md          , Md          , Hhd         , Xuce        , Wwg         , Wwg         , Wwg         , Wwg         , Xos         , Xos         , Xos         , Xos         , Xos         , Yhr         , Yhr         , Xos         , Xos         , Xos         , Uh          , Xos         , Urb^Es      , Urb         , Urb         , Urb         , Urb         , Xol         , Urb         , Urb         , Urb         , Urb         , Xol         , Xos         , Xos         , Xos         , Xos         , Xos         
Hhd         , Hhd         , Md          , Md          , Ww          , Hhd         , Ww          , Md          , Ww          , Ww          , Ww          , Wwg         , Xuce        , Xuce        , Xos         , Xos         , Xos         , Xos         , Xos         , Xos         , Xos         , Yhr^Xo      , Yhr^Xp      , Xos         , Uue^Em      , Uue^Es      , Uue^Uf      , Uue         , Urb         , Urb         , Urb         , Urb         , Urb         , Urb         , Urb         , Urb         , Urb         , Xol         , Xol         , Xos         , Xos         , Xos         
Ww          , Ww          , Ww          , Ww          , Ww          , Ww          , Ww          , Ww          , Gg          , Ww          , Ww          , Hhd         , Xuce        , Xuce        , Xuce        , Xos         , Xos         , Xos         , Xos         , Xos         , Xos         , Xos         , Xos         , Uh          , Uue         , Uh^Em       , Uue^Uf      , Uue         , Urb         , Urb         , Urb         , Urb         , Urb         , Urb         , Urb         , 1 Urb       , Rr          , Urb         , Urb         , Xol         , Xol         , Xos         
Ww          , Ww          , Hhd         , Ww          , Hhd         , Gs          , Gs          , Gll         , Gll         , Gg          , Ww          , Hhd         , Hhd         , Xuce        , Xuce        , Xuce        , Xos         , Xos         , Xos         , Xos         , Xos         , Xos         , Xos         , Xos         , Uh          , Uu^Uf       , Uh          , Uue^Em      , Uue^Es      , Urb         , Urb         , Urb         , Xos         , Xol         , Xol         , Urb         , Urb         , Rr          , Rr          , Urb         , Urb         , Xol         
Hhd         , Md          , Hhd         , Gs          , Md          , Hhd         , Hhd         , Gg          , Hhd         , Gll         , Hhd         , Md          , Md          , Xuce        , Xuce        , Xuce        , Xuce        , Xos         , Xos         , Xos         , Xos         , Xos         , Yhr^Xo      , Yhr^Xp      , Xos         , Xos         , Xos         , Uu^Es       , Xos         , Uu^Em       , Xos         , Xos         , Xos         , Xos         , Xos         , Xol         , Xol         , Urb         , Urb         , Rr          , Rr          , Urb         
Md          , Md          , Hhd         , Gg          , Gg          , Hhd         , Hhd         , Gs          , Gg          , Hhd         , Md          , Md          , Hhd         , Md          , Xuce        , Xuce        , Xuce        , Xuce        , Xuce        , Xos         , Xos         , Yhr         , Xos         , Xos         , Xos         , Xos         , Xos         , Xos         , Xos         , Xos         , Xos         , Xos         , Xos         , Xos         , Xos         , Xos         , Xos         , Xol         , Xol         , Urb         , Urb         , Rr          
