border_size=1
usage=map

Xos         , Xos         , Xos         , Xos         , Xos         , Xos         , Xos         , Xos         , Xos         , Xos         , Xos         , Xos         , Yhl         , Yhl         , Xos         , Xos         , Xos         , Xos         , Xos         , Xos         , Xos         , Xos         , Xos         , Xos         , Xos         , Xos         , Xos         , Xos         , Xos         , Xos         , Xos         , Xos         
Xos         , Xos         , Xos         , Xos         , Xos         , Xos         , Xos         , Xos         , Xos         , Xos         , Xos         , Xos         , Yhl         , Yhl         , Xos         , Xos         , Xos         , Xos         , Xos         , Xos         , Xos         , Xos         , Xos         , Xos         , Xos         , Xos         , Xos         , Xos         , Xos         , Xos         , Cud         , Cud         
Xos         , Xos         , Xos         , Xos         , Xos         , Xos         , Xos         , Xos         , Xos         , Xos         , Xos         , Xos         , Yhl         , Yhl         , Xos         , Xos         , Xos         , Xos         , Xos         , Xos         , Xos         , Xos         , Xos         , Xos         , Xos         , Xos         , Xos         , Xos         , Cud         , Cud         , Wo          , Wo          
Xos         , Xos         , Xos         , Xos         , Xos         , Xos         , Xos         , Xos         , Xos         , Xos         , Xos         , Xos         , Yhl         , Yhl         , Xos         , Xos         , Xos         , Xos         , Xos         , Xos         , Xos         , Xos         , Xos         , Xos         , Xos         , Xos         , Cud         , Cud         , Wo          , Wo          , Wo          , Wo          
Xos         , Xos         , Xos         , Xos         , Xos         , Xos         , Xos         , Xos         , Xos         , Xos         , Xos         , Xos         , Yhl         , Yhl         , Xos         , Xos         , Xos         , Xos         , Xos         , Xos         , Xos         , Xos         , Xos         , Xos         , Cud         , Cud         , Wo          , Wo          , Wo          , Wo          , Cud         , Cud         
Xos         , Xos         , Xos         , Xos         , Xos         , Xos         , Xos         , Xos         , Xos         , Xos         , Xos         , Xos         , Yhl         , Yhl         , Xos         , Xos         , Xos         , Xos         , Xos         , Xos         , Xos         , Xos         , Cud         , Cud         , Wo          , Wo          , Wo          , Wo          , Cud         , Cud         , Xos         , Xos         
Xos         , Xos         , Xos         , Xos         , Xos         , Xos         , Xos         , Xos         , Xos         , Xos         , Xos         , Xos         , Yhl         , Yhl         , Yhl^Xp      , Xos         , Xos         , Xos         , Xos         , Xos         , Cud         , Cud         , Wo          , Wo          , Wo          , Wo          , Cud         , Cud         , Xos         , Xos         , Xos         , Xos         
Xos         , Xos         , Xos         , Xos         , Xos         , Xos         , Xos         , Xos         , Xos         , Xos         , Yhl^Xp      , Yhl^Xp      , Yhr         , Yhr         , Yhr         , Yhl^Xp      , Yhl^Xp      , Xos         , Cud         , Cud         , Wo          , Wo          , Wo          , Wo          , Cud         , Cud         , Xos         , Xos         , Xos         , Xos         , Xos         , Xos         
Yhl         , Xos         , Xos         , Xos         , Xos         , Xos         , Xos         , Xos         , Yhl^Xp      , Yhl^Xp      , Yhr         , Yhr         , Yhs         , Yhs         , Yhs         , Yhr         , Cud         , Cud         , Wo          , Wo          , Wo          , Wo          , Cud         , Cud         , Xos         , Xos         , Xos         , Xos         , Xos         , Xos         , Xos         , Xos         
Yhl         , Yhl         , Yhl         , Xos         , Xos         , Xos         , Yhl^Xp      , Yhl^Xp      , Yhr         , Yhr         , Yhs         , Yhs         , Wzb         , Wzb         , Wzb         , Cud         , Wzb^Z\      , Wo^Z\       , Wo^Z\       , Wo          , Cud         , Cud         , Xos         , Xos         , Xos         , Xos         , Xos         , Xos         , Xos         , Xos         , Xos         , Xos         
Xos         , Yhl         , Yhl         , Yhl         , Yhl         , Yhl^Xp      , Yhr         , Yhr         , Yhs         , Yhs         , Wzb         , Wzb         , Yhs^Z/      , Xos         , Yhs^Z\      , Wzb         , Wzb         , Wzb^Z\      , Cud         , Cud         , Yhr         , Yhl^Xp      , Yhl^Xp      , Xos         , Xos         , Xos         , Xos         , Xos         , Xos         , Xos         , Xos         , Xos         
Xos         , Xos         , Yhl         , Yhl         , Yhr         , Yhr         , Yhs         , Yhs         , Wzb         , Wzb         , Yhs^Z/      , Xos         , Wzb         , Wzb         , Wzb         , Xos         , Yhs^Z\      , Wzb         , Wzb         , Yhs         , Yhs         , Yhr         , Yhr         , Yhl^Xp      , Xos         , Xos         , Xos         , Xos         , Xos         , Xos         , Xos         , Xos         
Xos         , Yhl^Xp      , Yhr         , Yhr         , Yhs         , Yhs         , Wzb         , Wzb         , Yhs^Z/      , Xos         , Wzb         , Wzb         , Wzb         , Wzb         , Wzb         , Wzb         , Wzb         , Xos         , Yhs^Z\      , Wzb         , Wzb         , Yhs         , Yhr         , Yhl^Xp      , Xos         , Xos         , Xos         , Xos         , Xos         , Xos         , Xos         , Xos         
Xos         , Yhl^Xp      , Yhr         , Yhs         , Wzb         , Wzb         , Yhs^Z/      , Xos         , Wzb         , Wzb         , Wzb         , Wzb         , Wzb         , Wzb         , Wzb         , Wzb         , Wzb         , Wzb         , Yhs^Z/      , Xos         , Wzb         , Yhs         , Yhr         , Yhl^Xp      , Xos         , Xos         , Xos         , Xos         , Xos         , Xos         , Xos         , Xos         
Xos         , Yhl^Xp      , Yhr         , Yhs         , Wzb         , Xos         , Yhs^Z\      , Wzb         , Wzb         , Wzb         , Zw          , Wzb         , Wzb         , Wzb         , Wzb         , Wzb         , Yhs^Z/      , Xos         , Wzb         , Wzb         , Yhs         , Yhs         , Yhr         , Yhl^Xp      , Xos         , Xos         , Xos         , Xos         , Xos         , Xos         , Xos         , Xos         
Xos         , Yhl^Xp      , Yhr         , Yhs         , Yhs         , Wzb         , Yhs         , Xos         , Yhs         , Zw          , Wzb         , Wzb         , Wzb         , Wzb         , Yhs^Z/      , Xos         , Wzb         , Wzb         , Yhs         , Yhs         , Yhr         , Yhr         , Yhl         , Yhl^Xp      , Xos         , Xos         , Xos         , Xos         , Xos         , Xos         , Xos         , Xos         
Xos         , Yhl^Xp      , Yhl         , Yhr         , Yhr         , Yhs         , Yhs         , Yhs         , Yhs         , Xos         , Yhs^Z\      , Wzb         , Yhs^Z/      , Xos         , Wzb         , Wzb         , Yhs         , Yhs         , Yhr         , Yhr         , Yhl^Xp      , Yhl         , Yhl         , Yhl         , Yhl         , Xos         , Xos         , Xos         , Xos         , Xos         , Xos         , Xos         
Xos         , Xos         , Urb         , Yhl         , Yhl         , Yhr         , Yhr         , Yhs         , Yhs         , Yhs         , Wzb         , Xos         , Wzb         , Wzb         , Wzb^Z/      , Cud         , Cud         , Yhr         , Yhl^Xp      , Yhl^Xp      , Xos         , Xos         , Xos         , Yhl         , Yhl         , Yhl         , Yhl         , Xos         , Xos         , Xos         , Xos         , Xos
Urb         , Urb         , Urb         , Urb         , Xos         , Yhl^Xp      , Yhl^Xp      , Yhr         , Yhr         , Yhs         , Yhs         , Wzb         , Yhs         , Cud         , Cud         , Wzb^Z/      , Wzb         , Cud         , Cud         , Xos         , Xos         , Xos         , Xos         , Xos         , Xos         , Yhl         , Yhl         , Yhl         , Yhl         , Xos         , Xos         , Xos
Urb         , Urb         , Xos         , Xos         , Xos         , Xos         , Xos         , Yhl^Xp      , Yhl^Xp      , Yhr         , Yhr         , Yhs         , Yhr         , Yhr         , Yhl^Xp      , Cud         , Cud         , Wzb         , Wzb         , Cud         , Cud         , Xos         , Xos         , Xos         , Xos         , Xos         , Xos         , Yhl         , Yhl         , Yhl         , Yhl         , Xos
Xos         , Xos         , Xos         , Xos         , Xos         , Xos         , Xos         , Xos         , Xos         , Yhl^Xp      , Yhl         , Yhr         , Yhl^Xp      , Yhl^Xp      , Xos         , Xos         , Xos         , Cud         , Cud         , Wzb         , Wzb         , Cud         , Cud         , Xos         , Xos         , Xos         , Xos         , Xos         , Xos         , Yhl         , Yhl         , Yhl         
Xos         , Xos         , Xos         , Xos         , Xos         , Xos         , Xos         , Xos         , Xos         , Xos         , Yhl         , Yhl         , Xos         , Xos         , Xos         , Xos         , Xos         , Xos         , Xos         , Cud         , Cud         , Wzb         , Wzb         , Cud         , Cud         , Xos         , Xos         , Xos         , Xos         , Xos         , Xos         , Yhl         
Xos         , Xos         , Xos         , Xos         , Xos         , Xos         , Xos         , Xos         , Xos         , Xos         , Yhl         , Yhl         , Xos         , Xos         , Xos         , Xos         , Xos         , Xos         , Xos         , Xos         , Xos         , Cud         , Cud         , Wzb         , Wzb         , Cud         , Cud         , Xos         , Xos         , Xos         , Xos         , Xos         
Xos         , Xos         , Xos         , Xos         , Xos         , Xos         , Xos         , Xos         , Xos         , Xos         , Yhl         , Yhl         , Xos         , Xos         , Xos         , Xos         , Xos         , Xos         , Xos         , Xos         , Xos         , Xos         , Xos         , Cud         , Cud         , Wzb         , Wzb         , Cud         , Cud         , Xos         , Xos         , Xos         
Xos         , Xos         , Xos         , Xos         , Xos         , Xos         , Xos         , Xos         , Xos         , Xos         , Yhl         , Yhl         , Xos         , Xos         , Xos         , Xos         , Xos         , Xos         , Xos         , Xos         , Xos         , Xos         , Xos         , Xos         , Xos         , Cud         , Cud         , Wzb         , Wzb         , Cud         , Cud         , Xos         
Xos         , Xos         , Xos         , Xos         , Xos         , Xos         , Xos         , Xos         , Xos         , Xos         , Yhl         , Yhl         , Xos         , Xos         , Xos         , Xos         , Xos         , Xos         , Xos         , Xos         , Xos         , Xos         , Xos         , Xos         , Xos         , Xos         , Xos         , Cud         , Cud         , Wzb         , Wzb         , Cud         
