border_size=1
usage=map

Xos         , Xos         , Xos         , Xos         , Xos         , Xos         , Xos         , Xos         , Xos         , Xos         , Xos         , Xos         , Yhl         , Yhl         , Xos         , Xos         , Xos         , Xos         , Xos         , Xos         , Xos         , Xos         , Xos         , Xos         , Xos         , Xos         , Xos         , Xos         , Xos         , Xos         , Xos         , Xos         
Xos         , Xos         , Xos         , Xos         , Xos         , Xos         , Xos         , Xos         , Xos         , Xos         , Xos         , Xos         , Yhl         , Yhl         , Xos         , Xos         , Xos         , Xos         , Xos         , Xos         , Xos         , Xos         , Xos         , Xos         , Xos         , Xos         , Xos         , Xos         , Xos         , Xos         , Cud         , Cud         
Xos         , Xos         , Xos         , Xos         , Xos         , Xos         , Xos         , Xos         , Xos         , Xos         , Xos         , Xos         , Yhl         , Yhl         , Xos         , Xos         , Xos         , Xos         , Xos         , Xos         , Xos         , Xos         , Xos         , Xos         , Xos         , Xos         , Xos         , Xos         , Cud         , Cud         , Wo          , Wo          
Xos         , Xos         , Xos         , Xos         , Xos         , Xos         , Xos         , Xos         , Xos         , Xos         , Xos         , Xos         , Yhl         , Yhl         , Xos         , Xos         , Xos         , Xos         , Xos         , Xos         , Xos         , Xos         , Xos         , Xos         , Xos         , Xos         , Cud         , Cud         , Wo          , Wo          , Wo          , Wo          
Xos         , Xos         , Xos         , Xos         , Xos         , Xos         , Xos         , Xos         , Xos         , Xos         , Xos         , Xos         , Yhl         , Yhl         , Xos         , Xos         , Xos         , Xos         , Xos         , Xos         , Xos         , Xos         , Xos         , Xos         , Cud         , Cud         , Wo          , Wo          , Wo          , Wo          , Cud         , Cud         
Xos         , Xos         , Xos         , Xos         , Xos         , Xos         , Xos         , Xos         , Xos         , Xos         , Xos         , Xos         , Yhl         , Yhl         , Xos         , Xos         , Xos         , Xos         , Xos         , Xos         , Xos         , Xos         , Cud         , Cud         , Wo          , Wo          , Wo          , Wo          , Cud         , Cud         , Xos         , Xos         
Xos         , Xos         , Xos         , Xos         , Xos         , Xos         , Xos         , Xos         , Xos         , Xos         , Xos         , Xos         , Yhl         , Yhl         , Yhl^Xp      , Xos         , Xos         , Xos         , Xos         , Xos         , Cud         , Cud         , Wo          , Wo          , Wo          , Wo          , Cud         , Cud         , Xos         , Xos         , Xos         , Xos         
Xos         , Xos         , Xos         , Xos         , Xos         , Xos         , Xos         , Xos         , Xos         , Xos         , Yhl^Xp      , Yhl^Xp      , Yhr         , Yhr         , Yhr         , Yhl^Xp      , Yhl^Xp      , Xos         , Cud         , Cud         , Wo          , Wo          , Wo          , Wo          , Cud         , Cud         , Xos         , Xos         , Xos         , Xos         , Xos         , Xos         
Yhl         , Xos         , Xos         , Xos         , Xos         , Xos         , Xos         , Xos         , Yhl^Xp      , Yhl^Xp      , Yhr         , Yhr         , Yhs         , Yhs         , Yhs         , Yhr         , Cud         , Cud         , Wo          , Wo          , Wo          , Wo          , Cud         , Cud         , Xos         , Xos         , Xos         , Xos         , Xos         , Xos         , Xos         , Xos         
Yhl         , Yhl         , Yhl         , Xos         , Xos         , Xos         , Yhl^Xp      , Yhl^Xp      , Yhr         , Yhr         , Yhs         , Yhs         , Wwb         , Wwb         , Wwb         , Cud         , Wwb^Z\      , Wo^Z\       , Wo^Z\       , Wo          , Cud         , Cud         , Xos         , Xos         , Xos         , Xos         , Xos         , Xos         , Xos         , Xos         , Xos         , Xos         
Xos         , Yhl         , Yhl         , Yhl         , Yhl         , Yhl^Xp      , Yhr         , Yhr         , Yhs         , Yhs         , Wwb         , Wwb         , Yhs^Z/      , Xos         , Yhs^Z\      , Wwb         , Wwb         , Wwb^Z\      , Cud         , Cud         , Yhr         , Yhl^Xp      , Yhl^Xp      , Xos         , Xos         , Xos         , Xos         , Xos         , Xos         , Xos         , Xos         , Xos         
Xos         , Xos         , Yhl         , Yhl         , Yhr         , Yhr         , Yhs         , Yhs         , Wwb         , Wwb         , Yhs^Z/      , Xos         , Wwb         , Wwb         , Wwb         , Xos         , Yhs^Z\      , Wwb         , Wwb         , Yhs         , Yhs         , Yhr         , Yhr         , Yhl^Xp      , Xos         , Xos         , Xos         , Xos         , Xos         , Xos         , Xos         , Xos         
Xos         , Yhl^Xp      , Yhr         , Yhr         , Yhs         , Yhs         , Wwb         , Wwb         , Yhs^Z/      , Xos         , Wwb         , Wwb         , Wwb         , Wwb         , Wwb         , Wwb         , Wwb         , Xos         , Yhs^Z\      , Wwb         , Wwb         , Yhs         , Yhr         , Yhl^Xp      , Xos         , Xos         , Xos         , Xos         , Xos         , Xos         , Xos         , Xos         
Xos         , Yhl^Xp      , Yhr         , Yhs         , Wwb         , Wwb         , Yhs^Z/      , Xos         , Wwb         , Wwb         , Wwb         , Wwb         , Wwb         , Wwb         , Wwb         , Wwb         , Wwb         , Wwb         , Yhs^Z/      , Xos         , Wwb         , Yhs         , Yhr         , Yhl^Xp      , Xos         , Xos         , Xos         , Xos         , Xos         , Xos         , Xos         , Xos         
Xos         , Yhl^Xp      , Yhr         , Yhs         , Wwb         , Xos         , Yhs^Z\      , Wwb         , Wwb         , Wwb         , Zw          , Wwb         , Wwb         , Wwb         , Wwb         , Wwb         , Yhs^Z/      , Xos         , Wwb         , Wwb         , Yhs         , Yhs         , Yhr         , Yhl^Xp      , Xos         , Xos         , Xos         , Xos         , Xos         , Xos         , Xos         , Xos         
Xos         , Yhl^Xp      , Yhr         , Yhs         , Yhs         , Wwb         , Yhs         , Xos         , Yhs         , Zw          , Wwb         , Wwb         , Wwb         , Wwb         , Yhs^Z/      , Xos         , Wwb         , Wwb         , Yhs         , Yhs         , Yhr         , Yhr         , Yhl         , Yhl^Xp      , Xos         , Xos         , Xos         , Xos         , Xos         , Xos         , Xos         , Xos         
Xos         , Yhl^Xp      , Yhl         , Yhr         , Yhr         , Yhs         , Yhs         , Yhs         , Yhs         , Xos         , Yhs^Z\      , Wwb         , Yhs^Z/      , Xos         , Wwb         , Wwb         , Yhs         , Yhs         , Yhr         , Yhr         , Yhl^Xp      , Yhl         , Yhl         , Yhl         , Yhl         , Xos         , Xos         , Xos         , Xos         , Xos         , Xos         , Xos         
Xos         , Xos         , Urb         , Yhl         , Yhl         , Yhr         , Yhr         , Yhs         , Yhs         , Yhs         , Wwb         , Xos         , Wwb         , Wwb         , Wwb^Z/      , Cud         , Cud         , Yhr         , Yhl^Xp      , Yhl^Xp      , Xos         , Xos         , Xos         , Yhl         , Yhl         , Yhl         , Yhl         , Xos         , Xos         , Xos         , Xos         , Xos         
Urb         , Urb         , Urb         , Urb         , Xos         , Yhl^Xp      , Yhl^Xp      , Yhr         , Yhr         , Yhs         , Yhs         , Wwb         , Yhs         , Cud         , Cud         , Wwb^Z/      , Wwb         , Cud         , Cud         , Xos         , Xos         , Xos         , Xos         , Xos         , Xos         , Yhl         , Yhl         , Yhl         , Yhl         , Xos         , Xos         , Xos         
Urb         , Urb         , Xos         , Xos         , Xos         , Xos         , Xos         , Yhl^Xp      , Yhl^Xp      , Yhr         , Yhr         , Yhs         , Yhr         , Yhr         , Yhl^Xp      , Cud         , Cud         , Wwb         , Wwb         , Cud         , Cud         , Xos         , Xos         , Xos         , Xos         , Xos         , Xos         , Yhl         , Yhl         , Yhl         , Yhl         , Xos         
Xos         , Xos         , Xos         , Xos         , Xos         , Xos         , Xos         , Xos         , Xos         , Yhl^Xp      , Yhl         , Yhr         , Yhl^Xp      , Yhl^Xp      , Xos         , Xos         , Xos         , Cud         , Cud         , Wwb         , Wwb         , Cud         , Cud         , Xos         , Xos         , Xos         , Xos         , Xos         , Xos         , Yhl         , Yhl         , Yhl         
Xos         , Xos         , Xos         , Xos         , Xos         , Xos         , Xos         , Xos         , Xos         , Xos         , Yhl         , Yhl         , Xos         , Xos         , Xos         , Xos         , Xos         , Xos         , Xos         , Cud         , Cud         , Wwb         , Wwb         , Cud         , Cud         , Xos         , Xos         , Xos         , Xos         , Xos         , Xos         , Yhl         
Xos         , Xos         , Xos         , Xos         , Xos         , Xos         , Xos         , Xos         , Xos         , Xos         , Yhl         , Yhl         , Xos         , Xos         , Xos         , Xos         , Xos         , Xos         , Xos         , Xos         , Xos         , Cud         , Cud         , Wwb         , Wwb         , Cud         , Cud         , Xos         , Xos         , Xos         , Xos         , Xos         
Xos         , Xos         , Xos         , Xos         , Xos         , Xos         , Xos         , Xos         , Xos         , Xos         , Yhl         , Yhl         , Xos         , Xos         , Xos         , Xos         , Xos         , Xos         , Xos         , Xos         , Xos         , Xos         , Xos         , Cud         , Cud         , Wwb         , Wwb         , Cud         , Cud         , Xos         , Xos         , Xos         
Xos         , Xos         , Xos         , Xos         , Xos         , Xos         , Xos         , Xos         , Xos         , Xos         , Yhl         , Yhl         , Xos         , Xos         , Xos         , Xos         , Xos         , Xos         , Xos         , Xos         , Xos         , Xos         , Xos         , Xos         , Xos         , Cud         , Cud         , Wwb         , Wwb         , Cud         , Cud         , Xos         
Xos         , Xos         , Xos         , Xos         , Xos         , Xos         , Xos         , Xos         , Xos         , Xos         , Yhl         , Yhl         , Xos         , Xos         , Xos         , Xos         , Xos         , Xos         , Xos         , Xos         , Xos         , Xos         , Xos         , Xos         , Xos         , Xos         , Xos         , Cud         , Cud         , Wwb         , Wwb         , Cud         
