border_size=1
usage=map

Xu          , Xu          , Xu          , Xu          , Xu          , Xu          , Xu          , Xu          , Xu          , Xu          , Xu          , Xu          , Xu          , Xu          , Xu          , Xu          , Xu          , Xu          , Xu          , Xu          , Xu          , Xu          , Xos         , Xu^Zok      , Xu^Zok      , Xu^Zok      , Xos         , Xu          , Xu          , Xu          , Xu          , Xos         , Xos         , Xos         , Xos         , Xos         , Xu          , Xu          , Xu          , Xu          , Xu          , Xu          , Xu          , Xos         , Xos         , Xos         , Xos         , Xos         , Xos         , Xos         , Xos         , Xos         , Xos         , Xos         , Xu          , Xu          , Xu          , Xu          , Xu          
Xu          , Xu          , Xu          , Xu          , Xu          , Xu          , Xu          , Xu          , Xu          , Xu          , Xu          , Xu          , Xu          , Xu          , Xu          , Xu          , Xu          , Xu          , Xu          , Xu          , Xu          , Xu          , Xos         , Xu^Zok      , Yhl^Zok     , Xu^Zok      , Xos         , Xu          , Xu          , Xu          , Xu          , Xu          , Xu          , Xos         , Xos         , Xos         , Xu          , Xu          , Xu          , Xu          , Uu          , Uu          , Uu          , Xu          , Uu          , Xos         , Xos         , Xos         , Xos         , Xos         , Xos         , Xos         , Xu          , Xu          , Xu          , Xu          , Xu          , Xu          , Xu          
Xu          , Xu          , Xu          , Xu          , Xu          , Xu          , Xu          , Xu          , Xu          , Xu          , Xu          , Xu          , Xu          , Xu          , Xu          , Xu          , Xu          , Xu          , Xu          , Xu          , Xos         , Xu          , Xos         , Yhl^Zok     , Yhl         , Yhl^Zok     , Xos         , Xu          , Xu          , Xu          , Xu          , Xu          , Yhl         , Yhl^Xp      , Xos         , Xos         , Xu          , Xu          , Yhl         , Uu          , Uu          , Uu          , Xu          , Uu          , Xu          , Uu          , Uu          , Xos         , Ryd         , Xos         , Uh          , Uh          , Uu          , Xu          , Xu          , Xu          , Xu          , Xu          , Xu          
Xu          , Xu          , Xu          , Xu          , Xu          , Xu          , Xu          , Xu          , Xu          , Xu          , Xu          , Xu          , Xu          , Xu          , Xu          , Xu          , Xu          , Xu          , Xu          , Xos         , Xu          , Xos         , Xos         , Yhl         , Yhl         , Yhl         , Xos         , Xu          , Xu          , Xu          , Yhl^Uf      , Yhl^Uf      , Yhl         , Xu          , Xu          , Xu          , Yhl         , Yhl         , Yhl^Xp      , Yhl         , Yhl         , Xu          , Xu          , Xu          , Xos         , Xos         , Ryd         , Ryd         , Ryd         , Xos         , Uu^Uf       , Uu          , Yhl^Xp      , Uh          , Xu          , Xu          , Xu          , Xu          , Xu          
Xu          , Xu          , Xu          , Xu          , Xu          , Xu          , Xu          , Xu          , Xu          , Xu          , Xu          , Xu          , Xu          , Xu          , Xu          , Xu          , Xu          , Xu          , Xu          , Xos         , Yhr^Xp      , Yhr^Xp      , Yhr         , Yhl^Xp      , Yhr         , Yhl         , Xos         , Xu          , Xu          , Xu          , Uu          , Uu^Uf       , Xu          , Yhl         , Yhl         , Yhl^Z\      , Xu          , Xu          , Xu          , Yhl         , Yhl         , Yhl^Xp      , Yhl         , Xu          , Xu          , Xos         , Xos         , Ryd         , Xos         , Xos         , Uu          , Yhl^Uf      , Yhl         , Yhl         , Yhl         , Xu          , Xu          , Xu          , Xu          
Xu          , Xu          , Xu          , Xu          , Xu          , Xu          , Xu          , Xu          , Xu          , Xu          , Xu          , Xu          , Xu          , Xu          , Xu          , Xu          , Xu          , Xu          , Xu          , Xos         , Yhr^Xp      , Yhr^Uf      , Xu          , Yhr         , Yhr         , Yhr         , Yhr         , Xos         , Xu          , Xu          , Uu          , Uu          , Xu          , Xu          , Xu          , Yhl^Xp      , Xos         , Xu          , Xu          , Xu          , Xu          , Yhl         , Yhl^Xp      , Yhl         , Yhl^Z/      , Xu          , Yhl         , Xos         , Yhl         , Uu^Uf       , Yhl         , Yhl         , Yhl         , Yhl         , Yhl^Z/      , Yhl^Z/      , Ss          , Ss          , Ss          
Xu          , Xu          , Xu          , Xu          , Xu          , Xu          , Xu          , Xu          , Xu          , Xu          , Xu          , Xu          , Xu          , Xu          , Xu          , Xu          , Xu          , Xu          , Xu          , Xos         , Xu          , Xu          , Xu          , Xos         , Xos         , Uu^Uf       , Uu          , Uu          , Uu          , Uu          , Yhr         , Yhr^Xp      , Yhr         , Xu          , Xu          , Xos         , Xos         , Xu          , Xu          , Xu          , Xu          , Xu          , Xu          , Yhl^Z/      , Yhl         , Yhl         , Yhl         , Yhl^Xp      , Cud         , Yhl         , Yhl         , Yhl         , Rd^Uf       , Xu          , Zw          , Zw          , Zw          , Ss          , Ss          
Xu          , Xu          , Xu          , Xu          , Xu          , Xu          , Xu          , Xu          , Xu          , Xu          , Xu          , Xu          , Xu          , Xu          , Xu          , Xu          , Xu          , Xu          , Xu          , Xos         , Xu          , Xu          , Xu          , Xos         , Xos         , Xos         , Xos         , Uu          , Uu          , Yhr         , Xos         , Yhr         , Yhr         , Yhr         , Yhr^Xp      , Xos         , Xos         , Xu          , Xu          , Xu          , Xu          , Xu          , Xu          , Xu          , Rd          , Yhl^Uf      , Yhl         , Cud         , Kud         , Cud         , Yhl^Xp      , Rd          , Rd^Uf       , Xu          , Ss          , Zw          , Zw          , Zw          , Zw          
Xu          , Xu          , Xu          , Xu          , Xu          , Xu          , Xu          , Xu          , Xu          , Xu          , Xu          , Xu          , Xu          , Xu          , Xu          , Xos         , Xu          , Xu          , Xu          , Xu          , Uu          , Uu^Uf       , Uh          , Ss^Uf       , Uu^Uf       , Xos         , Xos         , Xos         , Xos         , Xos         , Xos         , Xos         , Yhr         , Yhr         , Xu          , Xos         , Xos         , Xos         , Xos         , Xu          , Xu          , Xu          , Xu          , Rd^Uf       , Yhl^Uf      , Yhl         , Yhl         , Cud         , Cud         , Cud         , Yhl         , Rd^Uf       , Xu          , Xu          , Ss          , Ss          , Ss          , Zw          , Zw          
Xu          , Xu          , Xu          , Xu          , Xu          , Xu          , Xu          , Xu          , Xu          , Xu          , Xu          , Xu          , Xu          , Xu          , Xu          , Xos         , Uh          , Xu          , Yhr^Uf      , Uu          , Ss          , Ss          , Yhr^Uf      , Uu          , Uh          , Uh          , Xos         , Xos         , Xos         , Xos         , Yhr         , Yhr^Xp      , Yhr         , Yhr         , Xu          , Xu          , Xos         , Xos         , Xos         , Xos         , Xos         , Xu          , Xu          , Yhl^Uf      , Yhl^Xp      , Yhl         , Yhl^Uf      , Yhl         , Yhl         , Yhl         , Yhl^Uf      , Rd^Uf       , Xu          , Xu          , Xu          , Ss          , Ss          , Ss          , Ss          
Xu          , Xu          , Xu          , Xu          , Xu          , Xu          , Xu          , Xu          , Xu          , Xu          , Xu          , Xu          , Xu          , Xu          , Xos         , Xos         , Ss          , Uu^Uf       , Uu^Uf       , Yhr^Xp      , Uu          , Yhr^Xp      , Yhr^Xp      , Yhr^Xp      , Yhr^Xp      , Uh          , Yhr         , Xos         , Xos         , Yhr         , Xos         , Xos         , Yhr         , Yhr         , Uu          , Xos         , Xos         , Xos         , Xos         , Xos         , Xos         , Xos         , Xos         , Yhl         , Yhl         , Yhl         , Xos         , Yhl         , Yhl         , Yhl^Uf      , Rd^Uf       , Rd^Uf       , Xos         , Xos         , Xu          , Xu          , Xu          , Ss          , Ss          
Xu          , Xu          , Xu          , Xu          , Xu          , Xu          , Xos         , Xu          , Xu          , Xu          , Xu          , Xu          , Xu          , Xos         , Cud         , Cud         , Cud         , Uu^Uf       , Yhr^Uf      , Yhr^Xp      , Uu^Uf       , Uu          , Yhr^Uf      , Yhr^Xp      , Uu^Uf       , Yhr^Xp      , Yhr         , Uu          , Uu          , Yhr         , Xos         , Xos         , Yhr         , Uu          , Uu          , Xos         , Xos         , Xos         , Xos         , Xos         , Xu          , Xu          , Xu          , Xos         , Xos         , Yhr^Z/      , Yhr^Xp      , Yhr^Z\      , Xos         , Xos         , Xos         , Xos         , Xu          , Xu          , Xu          , Xu          , Xu          , Xu          , Xu          
Xu          , Xu          , Xu          , Xu          , Xos         , Xos         , Ss          , Xos         , Xos         , Xu          , Xu          , Xu          , Xu          , Xu          , Cud         , Cud         , Xos         , Xos         , Xos         , Uu^Uf       , Uh          , Uu^Uf       , Ss^Uf       , Yhr^Uf      , Xos         , Xos         , Xos         , Uu          , Uu          , Yhr         , Yhr         , Xos         , Yhr         , Uu          , Uu          , Xos         , Xos         , Xos         , Xu          , Xu          , Xu          , Xu          , Cud         , Uh          , Uu          , Yhr         , Yhr         , Yhr         , Yhr         , Uu          , Uh          , Xu          , Xu          , Xu          , Xu          , Xu          , Xu          , Xu          , Xu          
Xu          , Xu          , Xu          , Xu          , Xos         , Ss          , Ss          , Ss          , Yhr         , Xos         , Xos         , Xu          , Xos         , Xos         , Yhr         , Xos         , Xos         , Xos         , Xos         , Xos         , Xos         , Uh          , Xos         , Xos         , Xos         , Xos         , Xos         , Xos         , Xos         , Yhr         , Yhr         , Yhr         , Uu          , Uu          , Xu          , Xos         , Xos         , Xu          , Xu          , Xu          , Xu          , Uh          , Yhr         , Uu          , Uu^Uf       , Cud         , Yhr         , Yhr^Xp      , Yhr         , Uu          , Uu^Uf       , Uh          , Xu          , Xu          , Xu          , Xu          , Xu          , Xu          , Xu          
Xu          , Xu          , Xu          , Xu          , Xos         , Ss          , Yhr         , Yhr         , Xos         , Yhr         , Xos         , Xos         , Yhr         , Yhr         , Yhr         , Xos         , Xos         , Xos         , Xos         , Xos         , Xos         , Xos         , Xos         , Xos         , Xos         , Xos         , Xos         , Xos         , Xos         , Xos         , Yhr^Z\      , Yhr         , Xu          , Xu          , Xu          , Xos         , Xos         , Xu          , Xu          , Xu          , Uu          , Uu          , Yhr^Xp      , Yhr         , Yhr^Xp      , Yhr         , Yhr         , Yhr         , Cud         , Uu^Uf       , Uh^Uf       , Uh          , Uu          , Xu          , Xu          , Xu          , Xu          , Xu          , Xu          
Xu          , Xu          , Xu          , Xos         , Ss          , Ss          , Yhr         , Xos         , Xos         , Yhr         , Yhr         , Yhr         , Yhr         , Yhr         , Xos         , Xos         , Xos         , Xos         , Yhr         , Xos         , Xos         , Xos         , Xos         , Xos         , Yhr         , Xos         , Yhr         , Xos         , Yhr         , Yhr^Xp      , Xu          , Xu          , Xu          , Xu          , Xu          , Xos         , Xos         , Xu          , Zw          , Zw          , Yhr         , Yhr         , Xu          , Yhr         , Uu          , Yhr         , Yhr         , Uu          , Uu          , Uu^Uf       , Uu          , Uh          , Uh          , Xu          , Xu          , Xu          , Xu          , Xu          , Xu          
Xu          , Xu          , Ss          , Ss          , Xos         , Ss          , Yhr         , Xos         , Xos         , Yhr         , Yhr         , Yhr         , Xos         , Xos         , Xos         , Xos         , Yhr         , Yhr         , Xos         , Yhr         , Yhr         , Xos         , Yhr         , Yhr         , Yhr         , Yhr         , Yhr         , Yhr         , Yhr         , Xu          , Yhr         , Yhr^Xp      , Xu          , Xu          , Xos         , Xos         , Xos         , Yhr^Xp      , Yhr         , Yhr         , Xos         , Xu          , Xu          , Xu          , Uh          , Uu^Uf       , Yhr^Uf      , Yhr^Xp      , Yhr         , Yhr^Xp      , Cud         , Yhr^Xp      , Uu          , Xu          , Xu          , Xu          , Xu          , Xu          , Xu          
Ss          , Ss          , Xos         , Xos         , Xos         , Ss          , Yhr         , Xos         , Ss          , Xos         , Xos         , Xos         , Yhr         , Yhr         , Yhr         , Yhr         , Yhr         , Yhr         , Xos         , Xos         , Xos         , Yhr         , Yhr         , Yhr         , Xos         , Xu          , Xu          , Yhr         , Yhr         , Yhr         , Yhr         , Xu          , Xos         , Xos         , Xos         , Xos         , Xos         , Yhr         , Yhr         , Xos         , Xos         , Xu          , Xu          , Xu          , Uh          , Uu^Uf       , Uu          , Uu          , Uu          , Uu          , Uh          , Uh          , Xu          , Xu          , Xu          , Xu          , Xu          , Xu          , Xu          
Xu          , Ss          , Xos         , Xos         , Xos         , Ss          , Yhr         , Yhr         , Yhr         , Ss          , Yhr         , Yhr         , Yhr         , Yhr         , Yhr         , Yhr         , Yhr         , Yhr         , Xos         , Xos         , Yhr         , Yhr         , Xos         , Xos         , Xu          , Xu          , Xu          , Xu          , Yhr         , Yhr         , Yhr         , Yhr         , Yhr         , Yhr         , Yhr         , Yhr         , Yhr         , Yhr         , Yhr^Xp      , Xos         , Xos         , Xu          , Xu          , Xu          , Xu          , Uh          , Xu          , Uu          , Xu          , Uh          , Xu          , Xu          , Xu          , Xu          , Xu          , Xu          , Xu          , Xu          , Xu          
Xu          , Ss          , Xos         , Xos         , Xos         , Xos         , Xos         , Yhr         , Ss          , Yhr         , Ss          , Ss          , Xos         , Xos         , Yhr         , Yhr         , Yhr         , Yhr         , Yhr         , Yhr^Z\      , Yhr^Z\      , Yhr         , Xos         , Xos         , Xu          , Xu          , Yhr^Xp      , Yhr         , Xu          , Xu          , Xos         , Yhr         , Xos         , Yhr         , Xos         , Yhr         , Xos         , Yhr         , Xos         , Xos         , Xos         , Xu          , Xu          , Xu          , Xu          , Xu          , Xu          , Xu          , Xu          , Xu          , Xu          , Xu          , Xu          , Xu          , Xu          , Xu          , Xu          , Xu          , Xu          
Xu          , Ss          , Ss          , Xos         , Ss          , Xos         , Xos         , Xos         , Ss          , Ss          , Xos         , Xos         , Xos         , Xos         , Xos         , Yhr         , Yhr         , Yhr         , Yhr         , Yhr         , Xos         , Xos         , Xos         , Xos         , Xu          , Xu          , Xu          , Xu          , Xu          , Xu          , Xos         , Xos         , Xos         , Xos         , Xos         , Xos         , Xos         , Xos         , Xos         , Xos         , Xos         , Xu          , Xu          , Xu          , Xu          , Xu          , Xu          , Xu          , Xu          , Xu          , Xu          , Xu          , Xu          , Xu          , Xu          , Xu          , Xu          , Xu          , Xu          
Xu          , Xu          , Xu          , Ss          , Xu          , Ss          , Ss          , Ss          , Ss          , Xos         , Xos         , Xos         , Xos         , Xos         , Xos         , Xos         , Xos         , Yhr         , Xos         , Xos         , Xos         , Xos         , Xos         , Xos         , Xos         , Xu          , Xu          , Xu          , Xos         , Xos         , Xos         , Xos         , Xos         , Xos         , Xos         , Xos         , Xos         , Xos         , Xos         , Xos         , Xos         , Xu          , Xu          , Xu          , Xu          , Xu          , Xu          , Xu          , Xu          , Xu          , Xu          , Xu          , Xu          , Xu          , Xu          , Xu          , Xu          , Xu          , Xu          
Xu          , Xu          , Xu          , Xu          , Xu          , Xu          , Xos         , Xos         , Xos         , Ss          , Xos         , Xos         , Xos         , Xos         , Xos         , Xos         , Xos         , Xos         , Xos         , Xos         , Xos         , Xos         , Xos         , Xos         , Xos         , Xos         , Xos         , Xos         , Xos         , Xos         , Xos         , Xos         , Xos         , Xos         , Xos         , Xos         , Xos         , Xos         , Xos         , Xos         , Xos         , Xu          , Xu          , Xu          , Xu          , Xu          , Xu          , Xu          , Xu          , Xu          , Xu          , Xu          , Xu          , Xu          , Xu          , Xu          , Xu          , Xu          , Xu          
