border_size=1
usage=map

Rr          , Urb         , Urb         , Xol         , Xol         , Xos         , Xu          , Xu          , Xu          , Xu          , Qxe         , Qxe         , Xu          , Xos         , Xos         , Xos         , Xos         , Xos         , Xos         , Xos         , Wog         , Wog         , Xos         , Xos         , Xos         , Xos         , Xos         , Xos         , Xos         , Xos         , Xos         , Xos         
Urb         , Rr          , Re          , Urb         , Urb         , Xu          , Xu          , Xu          , Xu          , Qxe         , Qxe         , Qxe         , Xu          , Xu          , Xu          , Xos         , Xos         , Xos         , Wog         , Wog         , Xos         , Xos         , Xos         , Xos         , Xos         , Xos         , Xos         , Xos         , Xos         , Xos         , Xos         , Xos         
Xos         , Urb         , Re          , Re          , Re^Es       , Urb         , Re          , Uh          , Uu^Uf       , Uhe         , Qxe         , Xu          , Xu          , Xu          , Xu          , Xu          , Xu          , Wog         , Xos         , Xos         , Xos         , Xos         , Xos         , Xos         , Xos         , Xos         , Xos         , Xos         , Xos         , Xos         , Xos         , Xos         
Xos         , Xu          , Xu          , Urb         , Re          , Rr          , Rr          , Uh          , Uue         , Uue^Es      , Uhe         , Qxe         , Xu          , Xu          , Xu          , Xu          , Uh          , Wog         , Xu          , Xos         , Xos         , Xos         , Xos         , Xos         , Xos         , Xos         , Xos         , Xos         , Xos         , Xos         , Xos         , Xos         
Xos         , Xu          , Xu          , Xu          , Uh          , Re          , Uh          , Re          , Re^Es       , Uue         , Uu^Em       , Xu          , Xu          , Xu          , Xu          , Xu          , Xu          , Wog         , Xu          , Xu          , Xu          , Xos         , Xos         , Xos         , Xos         , Xos         , Xos         , Xos         , Xos         , Xos         , Xos         , Xos         
Xos         , Xu          , Xos         , Xu          , Xu          , Xu          , Xu          , Re          , Rb          , Ur          , Rr^Em       , Uu^Dr       , Wwf         , Xu          , Xu          , Xu          , Uu          , Wwg         , Uu^Uf       , Xu          , Xu          , Xu          , Xu          , Xos         , Xos         , Xos         , Xos         , Xos         , Xos         , Xos         , Xos         , Xos         
Xos         , Xos         , Xos         , Xos         , Qxu         , Qxu         , Qxu         , Uh          , Uh          , Uu^Em       , Uu^Emf      , Wwf         , Wwf         , Wwf^Es      , Wwg         , Xu          , Wwg         , Wwg         , Uu^Em       , Uu^Emf      , Uh          , Xu          , Xu          , Xos         , Xos         , Xos         , Xos         , Xos         , Xos         , Xos         , Xos         , Xos         
Xos         , Xos         , Xos         , Xos         , Qxu         , Qxu         , Xu          , Uh          , Uh          , Xu          , Xu          , Wwf^Es      , Urb         , Rr          , Wwg         , Wwg         , Wwg         , Wwg         , Uu^Ii       , Uu^Ii       , Uh          , Xu          , Xu          , Xu          , Xu          , Xos         , Xos         , Xos         , Xos         , Xos         , Xos         , Xos         
Xos         , Xos         , Xos         , Xos         , Qxu         , Qxu         , Xu          , Xu          , Xu          , Xos         , Xu          , Xu          , Wwg^Es      , Wwf         , Uu          , Wwf         , Uu          , Uu          , Uue         , Uue^Ii      , Uue^Em      , Xu          , Uh          , Xu          , Xos         , Xos         , Xos         , Xos         , Xos         , Xos         , Xos         , Xos         
Xos         , Xos         , Xos         , Xos         , Xos         , Xos         , Xos         , Xu          , Xu          , Xu          , Xu          , Wwg         , Wwg^Es      , Wwf         , Xu          , Wwf         , Uu          , 1 Uu        , Re          , Uhe         , Uue^Dr      , Uh          , Xu          , Xu          , Xos         , Xos         , Xos         , Xos         , Xos         , Xos         , Xos         , Xos         
Xos         , Xos         , Xos         , Xos         , Xos         , Xos         , Xos         , Xu          , Xu          , Xu          , Xu          , Qxu         , Qxu         , Xu          , Xu          , Wwf         , Wwf         , Uu          , Uue         , Re          , Re          , Uue         , Xu          , Xu          , Xol         , Xos         , Xos         , Xos         , Xos         , Xos         , Xos         , Xos         
Xos         , Xos         , Xos         , Xos         , Xos         , Xos         , Xos         , Xu          , Xu          , Xu          , Qxu         , Qxu         , Qxu         , Xu          , Uu^Ii       , Uh          , Wwf         , Uhe         , Uue^Em      , Uue         , Uhe         , Uue         , Ur          , Uh          , Uh          , Xol         , Xos         , Xos         , Xos         , Xos         , Xos         , Xos         
Xos         , Xos         , Xos         , Xos         , Xos         , Xos         , Xos         , Xu          , Xu          , Qxu         , Qxu         , Qxu         , Xu          , Uh          , Uu^Ii       , Uu^Ii       , Wwg         , Uue         , Uue         , Uue         , Xu          , Uu          , Uh          , Ur          , Rr          , Urb         , Urb         , Xol         , Xol         , Xos         , Xos         , Xos         
Xos         , Xos         , Xos         , Xos         , Xos         , Xos         , Xos         , Xu          , Xu          , Qxu         , Xu          , Xu          , Xu          , Xu          , Wog         , Wog         , Xu          , Uhe         , Uhe         , Uue^Dr      , Qxu         , Xu          , Xos         , Urb         , Urb         , Rr          , Rr          , Urb         , Urb         , Xos         , Xol         , Xos         
Xos         , Xos         , Xos         , Xos         , Xos         , Xos         , Xos         , Xu          , Xu          , Xu          , Xu          , Xu          , Xu          , Xu          , Wog         , Wog         , Xu          , Xu          , Xu          , Xu          , Xu          , Xu          , Xos         , Xos         , Xos         , Urb         , Urb         , Rr          , Cud         , Cud         , Urb         , Xol         
Xos         , Xos         , Xos         , Xos         , Xos         , Xos         , Xos         , Xos         , Xos         , Xu          , Xos         , Xos         , Xos         , Xos         , Wog         , Wog         , Xos         , Xos         , Xos         , Xu          , Xos         , Xos         , Xos         , Xos         , Xos         , Xos         , Xos         , Cud         , Urb         , Rr          , Rr          , Urb         
Xos         , Xos         , Xos         , Xos         , Xos         , Xos         , Xos         , Xos         , Xos         , Xos         , Xos         , Xos         , Xos         , Xos         , Xos         , Wog         , Wog         , Xos         , Xos         , Xos         , Xos         , Xos         , Xos         , Xos         , Xos         , Xos         , Xos         , Xos         , Xos         , Urb         , Urb         , Rr          
Xos         , Xos         , Xos         , Xos         , Xos         , Xos         , Xos         , Xos         , Xos         , Xos         , Xos         , Xos         , Xos         , Xos         , Xos         , Xos         , Xos         , Wog         , Wog         , Xos         , Xos         , Xos         , Xos         , Xos         , Xos         , Xos         , Xos         , Xos         , Xos         , Xos         , Xos         , Urb         
Xos         , Xos         , Xos         , Xos         , Xos         , Xos         , Xos         , Xos         , Xos         , Xos         , Xos         , Xos         , Xos         , Xos         , Xos         , Xos         , Xos         , Xos         , Xos         , Wog         , Xos         , Xos         , Xos         , Xos         , Xos         , Xos         , Xos         , Xos         , Xos         , Xos         , Xos         , Xos         
Xos         , Xos         , Xos         , Xos         , Xos         , Xos         , Xos         , Xos         , Xos         , Xos         , Xos         , Xos         , Xos         , Xos         , Xos         , Xos         , Xos         , Xos         , Xos         , Wog         , Xos         , Xos         , Xos         , Xos         , Xos         , Xos         , Xos         , Xos         , Xos         , Xos         , Xos         , Xos         
Xos         , Xos         , Xos         , Xos         , Xos         , Xos         , Xos         , Xos         , Xos         , Xos         , Xos         , Xos         , Xos         , Xos         , Xos         , Xos         , Xos         , Xos         , Xos         , Wog         , Xos         , Xos         , Xos         , Xos         , Xos         , Xos         , Xos         , Xos         , Xos         , Xos         , Xos         , Xos         
Xos         , Xos         , Xos         , Xos         , Xos         , Xos         , Xos         , Xos         , Xos         , Xos         , Xos         , Xos         , Xos         , Xos         , Xos         , Xos         , Xos         , Xos         , Xos         , Wog         , Xos         , Xos         , Xos         , Xos         , Xos         , Xos         , Xos         , Xos         , Xos         , Xos         , Xos         , Xos         
Xos         , Xos         , Xos         , Xos         , Xos         , Xos         , Xos         , Xos         , Xos         , Xos         , Xos         , Xos         , Xos         , Xos         , Xos         , Xos         , Xos         , Xos         , Wog         , Wog         , Xos         , Xos         , Xos         , Xos         , Xos         , Xos         , Xos         , Xos         , Xos         , Xos         , Xos         , Xos         
Xos         , Xos         , Xos         , Xos         , Xos         , Xos         , Xos         , Xos         , Xos         , Xos         , Xos         , Xos         , Xos         , Xos         , Xos         , Xos         , Wog         , Wog         , Xos         , Xos         , Xos         , Xos         , Xos         , Xos         , Xos         , Xos         , Xos         , Xos         , Xos         , Xos         , Xos         , Xos         
Xos         , Xos         , Xos         , Xos         , Xos         , Xos         , Xos         , Xos         , Xos         , Xos         , Xos         , Xos         , Xos         , Xos         , Xos         , Xos         , Wog         , Xos         , Xos         , Xos         , Xos         , Xos         , Xos         , Xos         , Xos         , Xos         , Xos         , Xos         , Xos         , Xos         , Xos         , Xos         
Xos         , Xos         , Xos         , Xos         , Xos         , Xos         , Xos         , Xos         , Xos         , Xos         , Xos         , Xos         , Xos         , Xos         , Xos         , Xos         , Wog         , Xos         , Xos         , Xos         , Xos         , Xos         , Xos         , Xos         , Xos         , Xos         , Xos         , Xos         , Xos         , Xos         , Xos         , Xos         
