Rr, Urb, Urb, Xos^Efs, Xos^Efs, Xos, Xu, Xu, Xuc, Xu, Qxu, Qxu, Xu, Xos, Xos, Xos, Xos, Xos, Xos, Xos, Wog, Xu, Xu, Xos, Xos, Xos, Xos, Xos, Xos, Xos, Xos, Xos
Urb, Rr, Re, Urb, Urb, Xu, Xu, Xuc, Xuc, Qxe, Qxe, Qxu, Xu, Xu, Xu, Xos, Xos, Xos, Wog, Wog, Xos, Xos, Xos, Xos, Xos, Xos, Xos, Xos, Xos, Xos, Xos, Xos
Xos, Urb, Re, Re, Re^Es, Urb, Re, Uh, Uue^Tf, Uhe, Qxe, Xu, Xu, Xu, Xu, Xu, Xu, Wog, Xos, Xos, Xos, Xos, Xos, Xos, Xos, Xos, Xos, Xos, Xos, Xos, Xos, Xos
Xos, Xu, Xu, Urb, Re, Rr, Rr, Uh, Uue, Uue^Es, Uhe, Qxe, Xuc, Xu, Xu, Xu, Uh, Wog, Xu, Xos, Xos, Xos, Xos, Xos, Xos, Xos, Xos, Xos, Xos, Xos, Xos, Xos
Xos, Xu, Xu, Xu, Uh, Re, Uh, Re, Re^Es, Uue, Uu^Em, Xuc, Xuc, Xu, Xom, Xom, Xom, Wog, Xu, Xu, Xu, Xos, Xos, Xos, Xos, Xos, Xos, Xos, Xos, Xos, Xos, Xos
Xos, Xu, Xos, Xu, Xu, Xu, Xuc, Re, Rb, Ur, Rr^Em, Uu^Dr, Wwf, Xu, Xuc, Xom, Uu, Wwg, Uu^Tf, Xuc, Xuc, Xu, Xu, Xos, Xos, Xos, Xos, Xos, Xos, Xos, Xos, Xos
Xos, Xos, Xos, Xos, Qxu, Qxu, Qxu, Uh, Uh, Uu^Em, Uu^Emf, Wwf, Wwf, Wwf^Es, Wwrg, Xuc, Wwg, Wwrg, Uu^Em, Uu^Emf, Uh, Xu, Xu, Xos, Xos, Xos, Xos, Xos, Xos, Xos, Xos, Xos
Xos, Xos, Xos, Xos, Qxu, Qxu, Xu, Uh, Uh, Xu, Xu, Wwf^Es, Urb, Rr, Wwg, Wwg, Wwrg, Wwrg, Uu^Ii, Uu^Ii, Uh, Xuc, Xuc, Xu, Xu, Xos, Xos, Xos, Xos, Xos, Xos, Xos
Xos, Xos, Xos, Xos, Qxu, Qxu, Xu, Xu, Xu, Xos, Xu, Xu, Wwrg, Wwf, Uu, Wwf, Uu, Uu, Uue, Uue^Ii, Uue^Em, Xuc, Uh, Xom, Xom, Xos, Xos, Xos, Xos, Xos, Xos, Xos
Xos, Xos, Xos, Xos, Xos, Xos, Xos, Xu, Xu, Xu, Xu, Wwg, Wwg^Es, Wwf, Xuc, Wwf, Uu, 1 Uu, Re, Uhe, Uue^Dr, Uh, Xu, Xom, Xos, Xos, Xos, Xos, Xos, Xos, Xos, Xos
Xos, Xos, Xos, Xos, Xos, Xos, Xos, Xu, Xu, Xu, Xu, Qxu, Qxu, Xu, Xu, Wwf, Wwf, Uu, Uue, Re, Re, Uue, Xu, Xu, Xos^Efs, Xos, Xos, Xos, Xos, Xos, Xos, Xos
Xos, Xos, Xos, Xos, Xos, Xos, Xos, Xu, Xu, Xu, Qxu, Qxu, Qxu, Xu, Uu^Ii, Uh, Wwf, Uhe, Uue^Em, Uue, Uhe, Uue, Ur, Uh, Uh, Xos^Efs, Xos, Xos, Xos, Xos, Xos, Xos
Xos, Xos, Xos, Xos, Xos, Xos, Xos, Xu, Xu, Qxu, Qxu, Qxu, Xu, Uh, Uu^Ii, Uu^Ii, Wwg, Uue, Uue, Uue, Xu, Uu, Uh, Ur, Rr, Urb, Urb, Xos^Efs, Xos^Efs, Xos, Xos, Xos
Xos, Xos, Xos, Xos, Xos, Xos, Xos, Xu, Xu, Qxu, Xu, Xu, Xu, Xu, Wog, Wog, Xuc, Uhe, Uhe, Uue^Dr, Qxu, Xu, Xos, Urb, Urb, Rr, Rr, Urb, Urb, Xos, Xos^Efs, Xos
Xos, Xos, Xos, Xos, Xos, Xos, Xos, Xu, Xu, Xu, Xu, Xu, Xu, Xu, Wog, Wog, Xuc, Xuc, Xu, Xu, Xu, Xu, Xos, Xos, Xos, Urb, Urb, Rr, Cud, Cud, Urb, Xos^Efs
Xos, Xos, Xos, Xos, Xos, Xos, Xos, Xos, Xos, Xu, Xos, Xos, Xos, Xos, Wog, Wog, Xos, Xos, Xos, Xu, Xos, Xos, Xos, Xos, Xos, Xos, Xos, Cud, Urb, Rr, Rr, Urb
Xos, Xos, Xos, Xos, Xos, Xos, Xos, Xos, Xos, Xos, Xos, Xos, Xos, Xos, Xos, Wog, Wog, Xos, Xos, Xos, Xos, Xos, Xos, Xos, Xos, Xos, Xos, Xos, Xos, Urb, Urb, Rr
Xos, Xos, Xos, Xos, Xos, Xos, Xos, Xos, Xos, Xos, Xos, Xos, Xos, Xos, Xos, Xos, Xos, Wog, Wog, Xos, Xos, Xos, Xos, Xos, Xos, Xos, Xos, Xos, Xos, Xos, Xos, Urb
Xos, Xos, Xos, Xos, Xos, Xos, Xos, Xos, Xos, Xos, Xos, Xos, Xos, Xos, Xos, Xos, Xos, Xos, Xos, Wog, Xos, Xos, Xos, Xos, Xos, Xos, Xos, Xos, Xos, Xos, Xos, Xos
Xos, Xos, Xos, Xos, Xos, Xos, Xos, Xos, Xos, Xos, Xos, Xos, Xos, Xos, Xos, Xos, Xos, Xos, Xos, Wog, Xos, Xos, Xos, Xos, Xos, Xos, Xos, Xos, Xos, Xos, Xos, Xos
Xos, Xos, Xos, Xos, Xos, Xos, Xos, Xos, Xos, Xos, Xos, Xos, Xos, Xos, Xos, Xos, Xos, Xos, Xos, Wog, Xos, Xos, Xos, Xos, Xos, Xos, Xos, Xos, Xos, Xos, Xos, Xos
Xos, Xos, Xos, Xos, Xos, Xos, Xos, Xos, Xos, Xos, Xos, Xos, Xos, Xos, Xos, Xos, Xos, Xos, Xos, Wog, Xos, Xos, Xos, Xos, Xos, Xos, Xos, Xos, Xos, Xos, Xos, Xos
Xos, Xos, Xos, Xos, Xos, Xos, Xos, Xos, Xos, Xos, Xos, Xos, Xos, Xos, Xos, Xos, Xos, Xos, Wog, Wog, Xos, Xos, Xos, Xos, Xos, Xos, Xos, Xos, Xos, Xos, Xos, Xos
Xos, Xos, Xos, Xos, Xos, Xos, Xos, Xos, Xos, Xos, Xos, Xos, Xos, Xos, Xos, Xos, Wog, Wog, Xos, Xos, Xos, Xos, Xos, Xos, Xos, Xos, Xos, Xos, Xos, Xos, Xos, Xos
Xos, Xos, Xos, Xos, Xos, Xos, Xos, Xos, Xos, Xos, Xos, Xos, Xos, Xos, Xos, Xos, Wog, Xos, Xos, Xos, Xos, Xos, Xos, Xos, Xos, Xos, Xos, Xos, Xos, Xos, Xos, Xos
Xos, Xos, Xos, Xos, Xos, Xos, Xos, Xos, Xos, Xos, Xos, Xos, Xos, Xos, Xos, Xos, Wog, Xos, Xos, Xos, Xos, Xos, Xos, Xos, Xos, Xos, Xos, Xos, Xos, Xos, Xos, Xos
