border_size=1
usage=map

Ms, Ms, Ha, Ms, Ms, Ms, Ms, Ms, Ms, Ms, Ha, Ms, Ms, Ha, Ha, Ms, Ms, Ms, Mm, Mm, Mm, Hh, Mm, Ms, Ms, Ww, Aa, Ms, Ms, Ms, Ms, Mm, Mm, Hh, Mm, Mm, Ww, Mm, Mm, Mm, Mm^Xm, Mm^Xm, Mm^Xm, Gg, Mm^Xm, Gll^Fp, Mm^Xo, Mm^Xm, Mm, Hhd^Fmw, Hhd^Fmw, Gll^Fp, Gll^Fp, Hhd^Fmw, Hhd, Hhd, Rr, Gll^Fp, Hh, Mm, Mm, Hh
Ms, Ms, Ha, Ha, Ha, Ms, Ha^Fma, Ms, Chr, Chr, Chr, Ms, Ha, Ha, Ms, Ha, Ha, Ms, Ha, Mm, Mm, Mm, Hhd, Ms, Ha, Ww, Ww, Aa, Ms, Ha, Ms, Ms, Mm, Hh, Ww, Mm, Ww, Mm, Mm, Mm, Mm, Mm, Hhd, Mm^Xm, Mm^Xm, Mm, Mm^Xo, Mm, Hhd, Hhd^Fmw, Hhd^Fmw, Hhd^Fdw, Mm, Mm, Hh, Hh, Gll^Fp, Rr, Hh, Hh, Hh, Hh^Fp
Ha, Ha, Aa, Ha, Ha, Ha^Fma, Ha, Ha, Ha, Ha, Ha, Ha^Fpa, Aa^Fda, Ms, Ha, Ha, Aa, Ha, Ha, Mm, Mm, Ha, Ha, Ha, Mm, Ha, Hhd, Ww, Ha, Ha, Ha, Mm, Mm, Ww, Mm, Ww, Hh, Mm, Mm, Mm, Mm^Xm, Mm, Hhd, Hhd, Hhd^Xo, Mm^Xo, Mm, Mm, Hh^Fp, Hhd, Hh^Fp, Hhd^Fdw, Mm, Hh, Hhd^Vhhr, Hhd^Fmw, Hh, Rr, Ww, Ww, Hh^Fp, Hh^Fp
Aa, Aa, Ha^Fpa, Ha, Aa^Fda, Ha^Fma, Ha, Ha, Gd, Ha^Vhha, Aa^Fda, Ha^Fpa, Aa^Fda, Ha, Hhd, Aa, Aa, Aa^Vla, Ha, Ha, Ha, Ha, Ha, Chr, Mm, Mm, Hhd, Wwf^Es, Mm, Ha, Hh, Hhd^Fmw, Wwf, Ww, Hh, Hh, Hh^Fp, Hh, Mm, Hh, Mm, Mm, Hhd^Xo, Hh^Xo, Hh, Mm, Mm, Hhd^Fmw, Hh^Fp, Mm, Mm, Mm, Mm, Hh, Hh^Fmw, Hhd^Fmw, Rr, Rr, Ww, Ww, Mm, Hh^Fp
Rr, Aa, Rr, Aa, Ha^Fma, Ha^Fma, Cea, Cea, Cea, Aa, Aa, Aa, Gd, Gd, Rp, Rr, Aa, Aa, Aa, Mm, Ha, Aa, Ha^Fma, Hhd, Hhd, Mm, Wwf^Es, Ww, Mm, Hh, Hh^Fp, Hhd, Wwf, Hh, Mm, Hh, Hh^Fp, Hh, Hhd, Hh, Hhd, Hhd, Hhd^Xo, Hhd, Gs, Hh, Hh, Hh, Hhd^Fp, Mm, Mm, Mm, Hh^Fp, Hh^Fp, Hh^Fmw, Gll^Fp, Rr, Ww, Ww, Mm, Mm, Hh
Ha^Fpa, Aa, Aa, Rr, Aa, Aa, Cea, 3 Kea, Cea, Cea, Aa, Aa, Aa, Aa, Hhd, Ha, Ha, Aa, Aa, Rp, Rp, Aa, Aa^Fpa, Hhd^Fp, Hhd, Hhd, Hhd^Fp, Ww, Ww, Hh, Gs, Hh^Fp, Ww^Es, Mm, Mm, Hh, Hh, Hhd, Hh, Hh, Gs, Hhd, Gs^Xo, Gs, Gs, Hh, Hh, Hhd, Hhd^Fdw, Hhd^Fdw, Hh^Fp, Hh^Fp, Gs^Fdw, Hh^Fp, Rp, Rp, Gll^Fp, Rr, Hh, Hh, Mm, Mm
Ha^Fpa, Aa, Ha^Fma, Ha^Vhha, Aa, Rr, Rr, Cea, Aa, Aa, Gd, Aa, Gd, Aa, Hhd, Ha, Ha, Ms, Ha, Ha^Fma, Aa, Rp, Rp, Hh^Fp, Gd^Fmw, Hhd^Fmw, Gll^Fp, Ww, Ww, Ww, Ww, Ww, Wwf, Mm, Mm, Hh^Fp, Gll^Fp, Gg, Hh, Hh, Hh, Gs, Gg^Xo, Gll^Fp, Gll^Fp, Gg, Gg, Hh, Hh, Hh, Hh, Hh^Fp, Gs^Fdw, Rp, Gll^Fp, Gd^Fmw, Hhd^Fdw, Gd^Fmw, Hh, Hh, Mm, Mm
Aa, Aa, Ha, Aa, Aa, Aa^Vha, Aa, Aa, Aa, Aa^Vha, Ha, Gd, Gd, Ha, Ha, Ha, Chr, Ms, Ms, Ha^Fma, Ha^Vhha, Hh, Gs, Rp, Gs, Gs, Ww, Ww, Hh, Ww, Gll^Fp, Ww^Es, Hh^Fp, Hh, Hh, Hh, Gs, Gs, Hh, Hh^Fp, Gs, Gd^Vhr, Gg^Xo, Gg, Gll^Fp, Gg^Em, Gg, Hh, Hhd, Hh, Hh, Gll^Fp, Rp, Rp, Gg, Gs^Fdw, Hhd^Fdw, Hhd^Fmw, Hh, Hh, Hhd, Hhd
Ha, Ms, Ha, Aa, Aa, Aa, Gd, Aa, Aa, Ha, Ha, Ha, Ha, Ha, Ha, Hhd, Chr, Khr, Ms, Ms, Hh^Fp, Hh, Gll^Fp, Rp, Rp, Gs, Ww, Ww, Hh^Fp, Gll^Fp, Gll^Fp, Hh, Hh, Mm, Gs, Gs, Gs, Gg, Hh^Fp, Hh, Gg, Re^Xo, Gg, Gll^Fp, Gg^Em, Gll^Fp, Gll^Fp, Gg, Hhd, Hh, Gg, Gg, Rp, Rp, Gg, Gs^Fdw, Hhd, Hhd, Hhd, Mm, Hhd, Hhd
Ms, Ms, Chr, Chr, Aa, Aa, Ha, Gd, Aa, Aa, Ha, Hhd, Hhd, Hhd, Hhd, Hhd, Hhd, Hhd^Fp, Hhd, Hhd^Fp, Gll^Fp, Hh, Hhd^Fp, Gll^Fp, Ww, Ww^Bw\r, Ww^Bw\, Ww, Gs, Hh, Hh, Hh, Mm, Hh, Gs, Gs, Gg, Hh^Fp, Gg^Em, Hh, Re^Xo, Rp^Xo, Gg, Gll^Fp, Gs, Gll^Fp, Gll^Fp, Gg, Gg, Gg, Gs^Vh, Rp, Rp, Gg^Vh, Gg, Gg, Hhd, Hhd, Gg, Gg, Gg, Gg
Ha, Ha, Chr, Aa, Aa, Ms, Ha, Ha, Ha, Ha, Ha, Hhd, Ha, Mm, Mm, Hhd, Hhd, Hhd, Hhd, Hhd^Fp, Gll^Fp, Hhd^Fp, Hhd, Gll^Fp, Ww, Ww, Gs, Rp, Rp, Gs^Vh, Rp, Hh, Rp, Hh, Gs, Gg, Gs, Hh, Gs^Xo, Gs^Xo, Re, Gs^Xo, Gg^Xo, Gg, Gg^Es, Gs, Gll^Fp, Gs, Gg, Gg, Gg, Rr, Rp, Gg, Gg, Gg, Ce, Gg, Ce, Ce, Ce, Ce
Mm, Ha, Mm, Mm, Ms, Ms, Ms, Ms, Ms, Ms, Mm, Ha, Mm, Mm, Mm, Mm, Mm, Mm, Hh, Hhd, Hh, Hh, Ww, Ww, Ww, Ww, Gs, Gs, Hh, Rp, Gll^Fp, Rp, Hh, Rp, Rp, Rp, Rp, Gs^Xo, Re, Rp, Gs, Rp, Rp, Gg^Xo, Gg, Gll^Fp, Gs, Gs, Gs, Gg, Ket, Rr, Rp, Ce, Ce, Ket, Gd^Fmw, Ce, Gd^Fmw, Gd^Fmw, Gd^Fmw, Gd^Fmw
Mm, Mm, Mm^Xm, Mm^Xm, Mm^Xm, Ms, Ms, Ms, Ms, Ms, Mm, Mm, Mm, Mm, Mm, Mm, Mm, Mm, Mm, Mm, Mm, Mm, Wwf, Ww, Hh, Hh^Fp, Hh, Hh, Hh, Gs, Gll^Fp, Hhd^Fmw, Hhd^Fp, Hh, Gs, Gs, Gs^Xo, Rp^Xo, Gg, Gll^Fp, Gll^Fp, Gs, Gs, Rp^Xo, Rp, Gs^Vh, Gs, Gs, Ce, Ce, Gll^Fp, Rr, Rr, Gs^Fdw, Gd^Fmw, Gll^Fp, Gg^Vh, Gll^Fp, Rr, Rr, Rr, Rr
Ms^Xm, Mm, Mm^Xm, Ms^Xm, Ms^Xm, Ms^Xm, Ms^Xm, Ms^Xm, Ms^Xm, Ms, Ms, Mm, Ms, Mm, Ms, Mm, Mm, Mm, Mm, Mm, Mm, Mm, Ww^Es, Ww, Hh, Hh, Mm, Mm, Mm, Hh, Hh^Fp, Hh^Fp, Hhd^Fp, Gll^Fp, Gs, Gs^Xo, Gs, Gs, Gg, Gg^Em, Gll^Fp, Gll^Fp, Gs, Gs^Xo, Gs^Vh, Rp, Rp, Ce, Gll^Fp, Gll^Fp, Rp, Rr, Rp, Rp, Gs, Gll^Fp, Rp, Rr, Ww, Ww, Ww, Rr
Ms^Xm, Mm^Xm, Ms^Xm, Ms^Xm, Ms, Ms, Ha, Ha, Ms^Xm, Ms^Xm, Ms^Xm, Ms^Xm, Ms^Xm, Ms^Xm, Ms^Xm, Ms^Xm, Ms^Xm, Ms^Xm, Ms^Xm, Mm, Mm, Mm, Mm, Wwf, Ww, Mm, Mm, Mm, Hh^Fp, Mm, Gll^Fp, Gg^Em, Gg^Em, Hhd^Fmw, Gll^Xo, Gs^Xo, Gs, Gs^Fp, Gll^Fp, Gll^Fp, Gll^Fp, Gs, Gll^Fp, Gs^Xo, Gs^Es, Gg, Ket, Rp, Rr, Rp, Ce, Ce, Ce, Rp, Rr, Rp, Rp, Rr^Vhc, Gll^Fp, Ww, Rr, Rr
Ms^Xm, Ms^Xm, Ms^Xm, Ms^Xm, Ms^Xm, Ms, Ms, Ms^Xm, Ms^Xm, Ha, Aa^Fpa, Aa^Fpa, Aa, Ms, Ms, Ms, Ha^Fda, Ms, Ms, Ms^Xm, Ms, Mm, Mm, Ww, Ww, Mm, Hh, Hh, Hh^Fp, Hh^Fp, Hh^Fp, Gll^Fp, Gg^Em, Gg^Xo, Gll^Fp, Gs, Gs^Fmw, Gs, Gll^Fp, Gs^Fmw, Gd^Fmw, Gll^Fp, Gll^Fp, Gs^Xo, Gs^Xo, Gs, Ce, Gs^Fdw, Gd^Fmw, Rr, Ce, 2 Ket, Ce, Rp, Rp, Gs^Fdw, Gs^Vh, Gd^Fp, Gd^Fp, Rr, Rr, Rr
Ms^Xm, Ms^Xm, Ms^Xm, Ms^Xm, Ms, Ms, Ha, Ha, Ha, Aa^Fpa, Aa^Fpa, Ha^Fma, Ha, Ai, Ha, Ms, Ha^Fda, Aa^Fma, Ms, Ms^Xm, Ms^Xm, Ms, Mm^Xm, Ww, Ww, Wwf^Es, Ww, Ww, Ww, Gll^Fp, Hh, Gg, Gg, Hh^Xo, Gll^Fp, Gll^Fp, Gd^Fmw, Gg, Hh^Fp, Gll^Fmw, Gd^Fmw, Gll^Fp, Gll^Fp, Gll^Fp, Gg^Xo, Gg, Ce, Gd^Fmw, Gd^Fmw, Rr, Rp, Ce, Rp, Rp, Gs, Rp, Rp, Gs^Fp, Rr, Rr, Gs^Fp, Gll^Fp
Ms^Xm, Ms^Xm, Ms, Ms, Ms, Ha, Ha, Aa^Fpa, Aa^Fpa, Aa^Fpa, Ha^Fma, Ha^Fda, Wwt, Wwt, Ai, Ha, Aa^Fma, Ha^Fpa, Ha^Fpa, Ms^Xm, Ms^Xm, Mm^Xm, Mm^Xm, Mm, Mm, Ww, Mm, Ww, Wwf, Hh, Hh^Xo, Gg, Hh^Xo, Hh^Xo, Hh^Xo, Gll^Fp, Gd^Fmw, Hh^Fmw, Hh^Fp, Gll^Fp, Gll^Fp, Gs^Xo, Gg^Xo, Gg^Xo, Gg, Gg, Gg, Ce, Gg, Rp, Gg, Rr, Gll^Fp, Rp, Gs, Gs, Gs^Vh, Rr, Gs^Fp, Gs^Fp, Gd^Fp, Gll^Fp
Ms^Xm, Ms^Xm, Ms^Xm, Ms^Xm, Ms^Xm, Ms, Ha, Ha, Ha, Ha, Ha^Fda, Ha, Ai, Wwt, Ai, Ai, Ha, Ha^Fpa, Ms^Xm, Ms, Ms^Xm, Mm^Xm, Mm, Mm, Mm, Mm, Mm, Mm, Hh^Xo, Wwf^Xo, Hh, Mm^Xo, Mm, Mm^Xo, Mm^Xo, Hh^Xo, Hh^Xo, Hh^Fmw, Gll^Xo, Gll^Fp, Gg^Xo, Gs^Xo, Gs, Gg, Gg, Gs^Vh, Gg, Gg, Rp, Rp, Gg, Gg, Gll^Fp, Gll^Fp, Ket, Gg, Gg, Gg, Ce, Ce, Ce, Ce
Ms, Ms^Xm, Ms^Xm, Ms^Xm, Ms, Ms, Ms, Ms, Ms, Ha, Ha, Ms^Xm, Ms, Ha, Ha, Ha, Ha^Fpa, Ms, Ms^Xm, Ms^Xm, Mm^Xm, Mm^Xm, Mm, Mm, Hh, Mm, Mm^Xo, Mm^Xo, Hh, Ww, Ww, Hh, Ww, Mm, Mm, Hh^Xo, Hh^Xo, Hh^Xo, Gs^Em, Gs^Xo, Gg, Gg, Ce, Gs, Gs, Gs, Rp, Rp, Gd, Gd, Gg, Ce, Ce, Ce, Gs, Ce, Ce, Ce, Gll^Fp, Gll^Fp, Gll^Fp, Gll^Fp
Ms, Ms^Xm, Ms^Xm, Ms^Xm, Ms^Xm, Ms, Ms, Ms, Ms, Ha, Ha, Ms, Ms, Ms, Ms^Xm, Ha, Ms^Xm, Ms^Xm, Mm^Xm, Mm^Xm, Mm, Mm, Hh, Mm, Hh, Mm, Mm^Xo, Mm, Mm, Hh, Ww, Ww, Wo, Ww, Ww, Mm, Mm, Gll^Fp, Gll^Fp, Gg^Fmw, Hh, Gg, Gg, Gg, Re, Re, Gs, Gs, Gg, Gs^Vh, Gs, Gs, Gs, Gs, Gg^Es, Gll^Fp, Gll^Fp, Gll^Fp, Hhd^Fp, Gll^Fp, Hhd, Gll^Fp
Ms^Xm, Ms, Ms^Xm, Ms^Xm, Ms^Xm, Ms^Xm, Ms^Xm, Ms^Xm, Ms^Xm, Ms^Xm, Ms, Ms, Ms^Xm, Ms^Xm, Ms^Xm, Ms^Xm, Ms^Xm, Mm^Xm, Mm^Xm, Mm^Xm, Mm, Mm, Mm, Hh, Hh, Mm, Mm, Mm^Xo, Mm, Hh, Hh, Ww, Wo, Wo, Ww, Mm, Hh, Hh^Fp, Gll^Fp, Gll^Fp, Hh, Hh^Fp, Gg, Gg, Gs, Gs, Ce, Gs, Gg, Gs, Gg, Gs, Gd^Fmw, Gs, Gd, Gll^Fp, Hh, Hh^Fp, Hhd^Fmw, Hhd^Fp, Ha, Hhd
Ms^Xm, Ms^Xm, Ms^Xm, Ms^Xm, Ms^Xm, Ms^Xm, Ms^Xm, Ms^Xm, Ms^Xm, Ms^Xm, Ms^Xm, Ms^Xm, Ms^Xm, Ms^Xm, Mm^Xm, Mm^Xm, Mm^Xm, Mm^Xm, Mm^Xm, Mm^Xm, Mm^Xm, Mm^Xm, Mm^Xm, Hh, Hh, Hh, Hh, Hh^Xo, Mm, Hh, Wwf, Ww, Ww, Ww, Wwf, Mm, Hh^Fp, Hh^Fp, Gd^Fmw, Gd^Fmw, Gs, Hh, Gs^Fdw, Re, Gs, Gs, Gs, Gs, Gs, Gg, Gs, Gd^Fmw, Gd^Fmw, Gd, Gll^Fp, Gll, Gg, Hhd, Ha, Hhd, Ha, Ms
Mm^Xm, Mm^Xm, Ms^Xm, Ms^Xm, Ms^Xm, Ms^Xm, Ms, Ms^Xm, Mm^Xm, Mm^Xm, Mm^Xm, Mm^Xm, Mm^Xm, Mm^Xm, Mm^Xm, Mm^Xm, Mm^Xm, Mm^Xm, Mm^Xm, Mm, Mm, Mm, Mm, Mm^Xm, Mm^Xm, Hh, Mm^Xo, Hh^Xo, Mm, Mm, Hh, Ww, Hh, Wwf, Gg, Hh, Gg, Hh, Gs, Gs^Fdw, Re, Re, Gg, Gs^Fdw, Hh, Hh, Hh^Fp, Gs, Gll^Fp, Gll^Fp, Gd, Gd, Gd, Gd, Gll^Fp, Gll^Fp, Gll^Fp, Hhd, Hhd, Ha, Ms^Xm, Ms
Mm^Xm, Mm^Xm, Ms^Xm, Mm^Xm, Mm^Xm, Mm^Xm, Mm^Xm, Ms^Xm, Mm^Xm, Mm^Xm, Mm^Xm, Mm^Xm, Mm^Xm, Mm^Xm, Mm, Mm, Mm^Xm, Mm^Xm, Mm^Xm, Hhd, Hhd, Hhd, Hhd, Mm, Mm^Xm, Mm^Xo, Mm, Mm, Mm^Xm, Mm, Hh, Hh, Hh, Hh, Hh, Gg, Gg, Gg, Re, Gs, Gs^Fdw, Gs, Gs, Gs^Fdw, Hh, Mm, Hh, Hh^Fp, Gll, Gll^Fp, Gll, Gd, Gll, Gll^Fp, Gll^Fp, Hhd^Fmw, Hhd, Hhd, Ha, Ms, Ms^Xm, Ms
Mm^Xm, Mm^Xm, Mm^Xm, Mm^Xm, Mm^Xm, Mm^Xm, Mm^Xm, Mm^Xm, Mm^Xm, Mm^Xm, Mm^Xm, Mm^Xm, Mm^Xm, Mm^Xm, Mm, Hhd, Hhd, Mm^Xm, Mm^Xm, Mm, Hhd, Hhd, Gs, Mm, Mm, Mm^Xm, Mm^Xm, Mm^Xm, Hh, Mm, Hh, Hh, Gg, Hh, Gs, Gg, Gg, Re, Gg, Gs, Gs^Fdw, Gs, Hhd^Fmw, Hh, Mm, Mm, Hh, Hh^Fp, Gll^Fp, Gll, Gll, Gd, Gll^Fp, Gll^Fp, Hhd^Fmw, Hhd^Fp, Mm, Mm, Ha, Ms^Xm, Ha, Ha
Mm^Xm, Mm^Xm, Mm^Xm, Mm^Xm, Mm^Xm, Mm^Xm, Mm^Xm, Mm^Xm, Mm^Xm, Mm, Mm, Mm^Xm, Hhd, Mm, Mm, Hhd, Hhd, Hhd, Hhd, Mm^Xm, Mm, Hhd, Gs, Gs, Gs, Hh, Hh, Hh, Gs, Hh, Gs^Fdw, Gs^Fdw, Gs, Gs, Gs, Re, Gll^Fp, Gg, Gg, Gs^Fdw, Gg, Hh, Hh^Fmw, Hhd^Fmw, Mm, Mm, Mm, Hh, Hhd^Fmw, Gll^Fp, Gll, Gll^Fp, Hhd^Fdw, Hhd^Fdw, Hhd, Hhd, Hhd, Ha, Ha, Ha, Ha^Fpa, Ha
Mm, Mm^Xm, Mm, Mm^Xm, Mm^Xm, Mm^Xm, Mm^Xm, Mm^Xm, Mm^Xm, Mm, Mm, Mm, Hhd, Mm, Mm, Hhd, Hhd, Hhd, Hhd, Mm, Mm, Hhd, Hhd, Hh, Gs, Gs, Hh, Gs, Re, Gs, Gd^Fmw, Gs, Gd, Gs, Gll^Fp, Gs, Gll^Fp, Gg, Gg, Hh, Hh, Hh, Hh^Fmw, Hhd^Fmw, Hh, Hh, Mm, Hh, Hhd^Fmw, Gll^Fp, Gll^Fp, Hh, Hhd, Mm, Mm^Xm, Hhd, Hhd, Ha, Ha, Aa, Aa, Aa
Mm, Mm, Mm^Xm, Mm^Xm, Mm, Mm^Xm, Mm, Mm, Mm, Mm, Mm, Hh, Mm, Mm, Hhd, Hhd, Hh, Hh, Gll^Fp, Gs, Mm, Mm, Mm, Mm, Hh, Gs, Gg, Gs, Re, Gll^Fp, Gll^Fp, Gs, Re^Es, Gs^Fdw, Gll^Fp, Gs, Gll^Fp, Gll^Fp, Gll^Fp, Hh, Hh, Gll^Fp, Gll^Fp, Hhd^Fmw, Hhd^Fmw, Hh, Hh, Hhd^Fmw, Hh, Hh, Hhd, Hhd, Mm, Mm^Xm, Mm, Ha, Ha, Ha, Ms, Aa, Ha^Fpa, Ha^Fpa
Mm, Mm^Xm, Mm^Xm, Mm^Xm, Mm, Mm, Hhd, Hhd, Hhd, Hhd, Hh, Hh, Mm, Mm, Hhd, Hh, Gll^Fp, Gll^Fp, Gs^Fp, Gs, Hh, Hh, Hh, Hh, Gll^Fp, Hh, Gll, Re, Gll, Gll, Gll^Fp, Gs, Gs, Gs, Gs, Gs, Gs, Gll^Fp, Gs^Fdw, Gll^Fp, Hh, Hh, Gll^Fp, Hhd^Fmw, Hh, Gll^Fp, Gs, Hh, Gs, Mm, Hhd, Mm, Mm^Xm, Mm^Xm, Ms^Xm, Ms, Ms, Ms, Ms, Ms^Xm, Ms, Ha^Fpa
Mm, Mm, Hhd, Hhd, Mm, Mm, Mm, Hhd, Mm, Mm, Mm, Mm, Hh, Hhd, Hh, Hh, Gll^Fp, Gs, Gs, Gs^Fp, Gll^Fp, Gll^Fp, Gll^Fp, Gll^Fp, Gll^Fp, Gll^Fp, Gll^Fp, Gll, Gll^Fp, Gll^Fp, Gll^Fp, Gll^Fp, Gll, Gll^Fp, Gll^Fp, Gs, Gs^Es, Gs^Fdw, Gs^Fdw, Hh, Gll^Fp, Hh, Gs, Gll^Fp, Gll^Fp, Gg, Gll^Fp, Gll^Fp, Gs, Hhd, Mm, Mm^Xm, Mm, Ms, Ms, Ha, Ha^Fpa, Ha^Fpa, Ha, Ms, Ms^Xm, Ms
Mm, Mm, Hhd, Hhd, Mm, Mm, Mm, Hhd, Hhd, Hhd, Hh^Fp, Hh, Gs, Hh, Gll^Fp, Gll^Fp, Gll^Fp, Gll^Fp, Gll^Fp, Gg, Gg, Gll^Fp, Gg, Gg, Gg, Gll^Fp, Gll^Fp, Gll^Fp, Gll^Fp, Gll^Fp, Gll, Gll^Fp, Gll^Fp, Gll^Fp, Gll^Fp, Gs^Fdw, Gs, Gd^Dr, Gg^Em, Hh, Gll^Fp, Gll^Fp, Gs, Gg, Gg, Gs, Gll^Fp, Gll^Fp, Gs, Hhd, Hhd, Mm, Mm, Hhd, Ms, Ha, Ms, Ms, Ms^Xm, Ms^Xm, Ms, Ms^Xm
Hh, Hhd, Hh, Hhd, Hhd, Mm, Mm, Hhd, Mm, Mm, Hh^Fp, Hh^Fp, Gll^Fp, Gs, Gs, Gll^Fp, Gll^Fp, Gll^Fp, Gll^Fp, Gll^Fp, Gg, Gs^Fdw, Gs^Fdw, Gg, Gs^Fdw, Gs^Fdw, Gg^Em, Gg, Gll, Gll, Gll^Fp, Gll^Fp, Gll^Fp, Hh, Gll^Fp, Gg, Gs, Gs^Es, Gll^Fp, Gg^Em, Gll^Em, Gll^Fp, Gll^Fp, Gll^Fp, Gll^Fp, Gll^Fp, Gll, Gs, Gll^Fp, Hhd, Mm, Mm, Hhd, Hhd, Hhd, Hhd, Hhd, Ha, Ms, Ha, Ms, Ms^Xm
Hh^Fp, Hh, Hhd, Hhd, Hhd, Hhd, Mm, Mm, Hhd, Mm, Hh, Gs, Gg, Gll^Fp, Gs, Gll^Fp, Gd^Fmw, Gd^Fmw, Gd^Fmw, Gll^Fp, Gg^Em, Gs, Gd^Fmw, Gd^Fmw, Gs^Fdw, Gs^Fdw, Gg^Em, Gg, Gll^Fp, Gll, Gll^Fp, Hh, Hh, Gll^Fp, Gll^Fp, Gg^Fet, Gd^Fmw, Gs^Fdw, Gd^Fmw, Gll^Fp, Gll^Fp, Gll^Fp, Hh, Gll^Fp, Gll^Fp, Gll^Fp, Gll^Fp, Gll, Gll^Fp, Gs, Hh, Mm, Gs, Gll^Fp, Gs, Hh, Hhd, Hhd, Ms, Hhd, Hhd, Ms
Hh, Hh, Hhd, Hhd, Hh, Hh, Hhd, Hhd, Hh, Hh, Gs, Gs, Gll^Fp, Gg, Gg, Gll^Fp, Gd^Fmw, Gd^Fmw, Gd^Fmw, Gll^Fp, Gll^Fp, Gs, Gd^Fmw, Gs^Fdw, Gd^Fmw, Gs^Fdw, Gll^Fp, Gg, Gll^Fp, Gll^Fp, Gll^Fp, Hh, Gll^Fp, Gll^Fp, Gd^Fmw, Gll^Fp, Wwf, Gd^Fmw, Gll^Fp, Wwf, Wwf, Hh, Mm, Hh, Hh, Hh, Gll^Fp, Gll^Fp, Gll^Fp, Gll^Fp, Gs, Gg, Gll^Fp, Hh^Fp, Gll^Fp, Hh, Hhd, Hhd, Hhd, Hhd, Hhd, Hhd
Gg, Gg, Gg, Gg, Gll^Fp, Gll^Fp, Gll^Fp, Hhd, Gll^Fp, Hh, Gg, Gll^Fp, Gd^Fmw, Gll^Fp, Gg, Gg^Em, Gd^Fmw, Gd^Fmw, Gd^Fmw, Gd^Fmw, Gd^Fmw, Gll^Fp, Gs, Gs, Gs, Gd^Fmw, Gll, Gll, Gll^Fp, Gll^Fp, Hh, Gll^Fp, Gll^Fp, Gll^Fp, Gd^Fmw, Wwf, Wwf, Ww, Ww, Ww, Ww, Mm, Ww, Mm, Hh^Fp, Hh^Fp, Gll^Fp, Gll, Gll^Fp, Gll^Fp, Hh, Hh^Fp, Gll^Fp, Gs, Hh, Hhd, Mm, Mm, Mm, Mm, Mm^Xm, Mm
Gll^Fp, Gll^Fp, Gll^Fp, Gll^Fp, Gll^Fp, Gll^Fp, Gll^Fp, Gll^Fp, Gll^Fp, Gll^Fp, Gll^Fp, Gll^Fp, Gd^Fmw, Gd^Fmw, Gg, Gs, Gll^Fp, Gd^Fmw, Gll^Fp, Gll^Fp, Gs, Gll^Fp, Gg, Gs, Gs, Gs, Gll^Fp, Gll, Gll^Fp, Gll^Fp, Gll^Fp, Hh, Gll^Fp, Gd^Fmw, Gd^Fmw, Gll^Fp, Wwf, Ww, Wwf, Ww, Hh^Fp, Ww, Mm, Mm, Hhd, Hh^Fp, Gs^Fp, Gll^Fp, Gll^Fp, Gll^Fp, Hh^Fp, Hh^Fp, Hh^Fp, Hh, Hh, Mm, Mm, Mm, Mm, Mm, Mm^Xm, Mm^Xm
Gll^Fp, Gll^Fp, Gll^Fp, Gll^Fp, Gll^Fp, Gll^Fp, Gll^Fp, Gll^Fp, Gll^Fp, Gll^Fp, Gll^Fp, Gll^Fp, Gd^Fmw, Gd^Fmw, Gd^Fmw, Gll^Fp, Gll^Fp, Gs, Gll^Fp, Gs, Gs, Gs, Gll^Fp, Gg, Gll^Fp, Gll^Fp, Gll^Fp, Gll^Fp, Gll^Fp, Gll^Fp, Gll^Fp, Hh, Gll^Fp, Gll^Fp, Gll^Fp, Gll^Fp, Gll^Fp, Gll^Fp, Hh, Hh^Fp, Hh, Mm, Mm, Mm, Hhd, Hhd, Gs, Gs^Fdw, Gs^Fdw, Gll^Fp, Hh^Fp, Hhd^Fmw, Hh, Hh, Mm, Mm, Mm^Xm, Mm, Mm, Mm, Mm^Xm, Mm^Xm
Gll^Fp, Gll^Fp, Gll^Fp, Gll^Fp, 1 Gll^Fp, Gll^Fp, Gll^Fp, Gll^Fp, Gll^Fp, Gll^Fp, Gll^Fp, Gll^Fp, Gll^Fp, Hh, Gll^Fp, Gll^Fp, Gll^Fp, Gs, Gs, Gs, Gs, Gg, Gll^Fp, Gll^Fp, Hh, Gll^Fp, Hh, Hh, Gll^Fp, Hh, Hh, Gll^Fp, Gs, Gll^Fp, Gll^Fp, Hh, Hh, Hh^Fp, Hh^Fp, Hh^Fp, Hh^Fp, Hh, Hhd^Fmw, Hh^Fp, Hhd, Gs^Es, Gd^Dr, Gs^Es, Gs^Fdw, Hh^Fp, Hh^Fp, Hhd^Fmw, Hh, Mm, Mm, Hh, Hh, Hh, Mm, Mm^Xm, Mm^Xm, Mm^Xm
Gll^Fp, Gll^Fp, Gll^Fp, Gll^Fp, Gll^Fp, Gll^Fp, Gll^Fp, Gll^Fp, Gll^Fp, Gll^Fp, Gll^Fp, Gll^Fp, Gll^Fp, Hh, Hh, Gll^Fp, Gll^Fp, Gll^Fp, Gll^Fp, Gg, Gll^Fp, Gll^Fp, Gll^Fp, Gll^Fp, Gll^Fp, Gll^Fp, Hh, Hh, Gll^Fp, Gll^Fp, Hh, Gll^Fp, Gs^Em, Gll, Gll^Fp, Gll^Fp, Gll^Fp, Hh, Hh, Hh^Fp, Hh^Fp, Hhd^Fmw, Hhd^Fmw, Hhd^Fmw, Gll^Fp, Gd^Es, Gd^Es, Gs^Fdw, Gll^Fp, Hh^Fp, Hh^Fp, Gll^Fp, Hh, Mm, Mm, Mm, Mm^Xm, Mm, Mm^Xm, Mm^Xm, Mm^Xm, Mm^Xm
Gll^Fp, Gll^Fp, Gll^Fp, Gll^Fp, Gll^Fp, Gll^Fp, Gll^Fp, Gll^Fp, Gll^Fp, Gll^Fp, Gll^Fp, Gll^Fp, Gll^Fp, Gll^Fp, Gll^Fp, Gll^Fp, Hh, Gll^Fp, Gll^Fp, Gll^Fp, Gll^Fp, Gll^Fp, Gll^Fp, Gll^Fp, Hh, Gll^Fp, Hh, Gll^Fp, Gll^Fp, Gll^Fp, Hh, Hh, Gs, Gll^Em, Gll^Fp, Gll^Fp, Gll^Fp, Hh, Hh, Hh^Fp, Hh^Fp, Hhd^Fmw, Hhd^Fmw, Hhd^Fmw, Gll^Fp, Gs^Fdw, Hh, Gs^Fdw, Hhd^Fmw, Hhd^Fmw, Gll^Fp, Hh, Hh, Mm, Hh, Mm, Mm, Mm^Xm, Mm, Mm^Xm, Mm^Xm, Mm^Xm
Gll^Fp, Gll^Fp, Gll^Fp, Gll^Fp, Gll^Fp, Gll^Fp, Gll^Fp, Gll^Fp, Gll^Fp, Gll^Fp, Gll^Fp, Gll^Fp, Gll^Fp, Gll^Fp, Hh, Hh, Hh, Gll^Fp, Gll^Fp, Hh, Hh, Gll^Fp, Gll^Fp, Hh, Gll^Fp, Hh, Hh, Hh, Hh, Gll^Fp, Hh, Hh, Hh, Hh, Gll^Fp, Gll^Fp, Gll^Fp, Hh, Hh, Hh^Fp, Hh^Fp, Hhd^Fmw, Hhd^Fmw, Hhd^Fmw, Gll^Fp, Gll^Fp, Gll^Fp, Gll^Fp, Gll^Fp, Gll^Fp, Gll^Fp, Gll^Fp, Hh, Mm, Hh, Hh, Mm, Mm, Hh, Mm, Mm, Mm^Xm
