Xoc, Xoc, Xoc, Xoc, Xoc, Xoc, Cv, Cv, Wwt, Wwt, Wwrt, Wwrt, Wwrt, Wwrt, Wwrt, Wwt, Wwt, Cv, Cv, Xoc, Xoc, Xoc, Xoc, Xoc, Xoc
Xoc, Xoc, Xoc, Xoc, Cv, Cv, Wwt, Wwt, Irs, Irs, Irs, Irs, Gg^Fet, Irs, Irs, Irs, Irs, Wwt, Wwt, Cv, Cv, Xoc, Xoc, Xoc, Xoc
Xoc, Xoc, Cv, Cv, Wwt, Wwt, Irs, Irs, Gs^Fds, Irs, Xoc, Irs, Irs, Irs, Xoc, Irs, Gs^Fms, Irs, Irs, Wwt, Wwt, Cv, Cv, Xoc, Xoc
Xoc, Cv, Wwt, Wwt, Irs, Irs, Irs, Gs^Fms, Gg^Fet, Irs, Icr, Irs, Irs, Irs, Icr, Irs, Gg^Fet, Gs^Fds, Irs, Irs, Irs, Wwt, Wwt, Cv, Xoc
Xoc, Cv, Wwt, Wwrt, Wwrt, Irs, Irs, Gs^Fds, Irs, Irs, Irs, Irs, 3 Icr^Ii, Irs, Irs, Irs, Irs, Gs^Fds, Irs, Irs, Wwrt, Wwrt, Wwt, Cv, Xoc
Xoc, Cv, Wwt, Irs, Irs, Gg^Fet, Irs, Irs, Icr, Irs, Gg^Fet, Irs, Irs, Irs, Gg^Fet, Irs, Icr, Irs, Irs, Gg^Fet, Irs, Irs, Wwt, Cv, Xoc
Xoc, Cv, Wwt, Irs, Irs, Irs, Gs^Fds, Irs, Irs, Irs, Irs, Irs, Wwt, Irs, Irs, Irs, Irs, Irs, Gs^Fds, Irs, Irs, Irs, Wwt, Cv, Xoc
Xoc, Cv, Wwt, Irs, Irs, Xoc, Gs^Fds, Irs, Irs, 1 Icr^Ii, Irs, Wwt, Wwt, Wwt, Irs, 2 Icr^Ii, Irs, Irs, Gs^Fms, Xoc, Irs, Irs, Wwt, Cv, Xoc
Xoc, Cv, Wwt, Irs, Irs, Irs, Irs, Irs, Icr, Irs, Gg^Fet, Irs, Irs, Irs, Gg^Fet, Irs, Icr, Irs, Irs, Irs, Irs, Irs, Wwt, Cv, Xoc
Xoc, Cv, Wwt, Irs, Wwrt, Gg^Fet, Irs, Irs, Irs, Irs, Irs, Irs, 4 Icr^Ii, Irs, Irs, Irs, Irs, Irs, Irs, Gg^Fet, Wwrt, Irs, Wwt, Cv, Xoc
Xoc, Cv, Wwt, Wwrt, Irs, Irs, Irs, Gs^Fms, Gg^Fet, Irs, Icr, Irs, Irs, Irs, Icr, Irs, Gg^Fet, Gs^Fds, Irs, Irs, Irs, Wwrt, Wwt, Cv, Xoc
Xoc, Cv, Cv, Wwt, Wwt, Irs, Irs, Gs^Fds, Gs^Fms, Irs, Xoc, Irs, Irs, Irs, Xoc, Irs, Gs^Fms, Gs^Fds, Irs, Irs, Wwt, Wwt, Cv, Cv, Xoc
Xoc, Xoc, Xoc, Cv, Cv, Wwt, Wwt, Irs, Irs, Irs, Irs, Irs, Gg^Fet, Irs, Irs, Irs, Irs, Irs, Wwt, Wwt, Cv, Cv, Xoc, Xoc, Xoc
Xoc, Xoc, Xoc, Xoc, Xoc, Cv, Cv, Wwt, Wwt, Irs, Irs, Irs, Wwrt, Irs, Irs, Irs, Wwt, Wwt, Cv, Cv, Xoc, Xoc, Xoc, Xoc, Xoc
Xoc, Xoc, Xoc, Xoc, Xoc, Xoc, Xoc, Cv, Cv, Wwt, Wwt, Irs, Wwrt, Irs, Wwt, Wwt, Cv, Cv, Xoc, Xoc, Xoc, Xoc, Xoc, Xoc, Xoc
