border_size=1
usage=map

Gg          , Gg          , Gg          , Gs          , Gs          , Gd          , Gs          , Rr          , Gs          , Gg          , Gg          , Gg          , Rr          , Gg          , Gg          , Gg          , Gg          , Gg          , Gg          , Gg          , Gg          , Gg          , Gd          , Gd          , Gll^Fp      , Gll^Fp      , Gd          , Gs          , Gg          , Gg          , Rr          , Rr          , Gg          , Gg          , Rb          , Re          , Re          , Gs^Vh       , Gg          , Re          , Re          , Gg          
Gg          , Gg          , Gg          , Gs          , Gg          , Gs          , Gs          , Rr          , Ce          , Gg          , Gs^Fdw      , Gg          , Rr          , Gg          , Gg          , Gg          , Gs^Fdw      , Gs^Fdw      , Gs^Fdw      , Gg          , Gg          , Gs          , Gs          , Gs          , Gll^Fp      , Gd^Fmw      , Gg^Em       , Ch          , Rr          , Rr          , Gg          , Gg          , Re^Gvs      , Rb^Gvs      , Rb^Gvs      , Rb^Gvs      , Rb          , Re          , Gg          , Gs          , Gs^Wm       , Re          
Gg          , Gg          , Ket         , Gg          , Ce          , Gg          , Rr          , Rr          , Gs          , Gs^Fdw      , Gs^Fdw      , Gg^Em       , Rr          , Gg          , Ce          , Gs          , Ce          , Gs^Fdw      , Ce          , Gg          , Gg          , Gg          , Gs          , Gs^Fdw      , Gg          , Gs          , Rr          , Rr          , Ch          , Re          , Re          , Re^Gvs      , Rb^Gvs      , Rb          , Re          , Rb^Gvs      , Gg          , Gg          , Re^Gvs      , Re^Gvs      , Re          , Gg          
Gg          , Ce          , Gg          , Ce          , Gg^Fet      , Ce          , Rrc         , Rr          , Ce          , Ket         , Ce          , Ce          , Rr          , Gg          , Gg^Ve       , Ce          , Gs          , Ket         , Gs^Fdw      , Ce          , Gs^Fdw      , Gg          , Ce          , Gg          , Rr          , Rr          , Gg          , Gg          , Gg          , Gs^Fdw      , Re          , Gs^Vh       , Re          , Re          , Re          , Gs^Vh       , Rb^Gvs      , Re^Gvs      , Rb^Gvs      , Re^Gvs      , Re          , Re          
Ww          , Gg          , Gs^Fmw      , Gs^Fmw      , Gs^Fmw      , Gs^Fdw      , Rrc         , Rrc         , Gs^Fms      , Wwf         , Wwf         , Wwf         , Rrc         , Gs          , Gs          , Gs^Fp       , Gs^Fdw      , Gg          , Gs^Fdw      , Ket         , Ce          , Ce          , Rrc         , Rrc         , Ce          , Ce          , Ce          , Gg          , Gs^Fdw      , Gs          , Gs          , Re          , Gs^Vh       , Gs^Vh       , Gs^Vh       , Rb^Gvs      , Rb          , Rb          , Re^Gvs      , Re^Gvs      , Gg          , Gg          
Ww          , Ww          , Ww          , Gs^Fdw      , Gs          , Gs          , Rrc         , Gs^Fdw      , Wwf         , Wwf         , Gs^Fmw      , Wwf         , Gs^Fmw      , Rrc         , Rrc         , Gs          , Gs^Fmw      , Gs^Fmw      , Rrc         , Gs^Fp       , Rrc         , Rrc         , Gs          , Gs          , Gs          , Gg          , Ce          , Gg          , Gg          , Gd^Fmw      , Gs          , Re          , Rb^Gvs      , Rb^Gvs      , Rb^Gvs      , Re          , Re          , Re^Gvs      , Gll^Fp      , Gll^Fp      , Gll^Fp      , Gll^Fp      
Ww          , Ww          , Wo          , Ww          , Ww          , Gg^Ve       , Ww^Bsb|     , Gs^Fdw      , Wwf         , Gs^Fmw      , Gs^Fmw      , Rrc^Vhc     , Gs^Fmw      , Gs^Fmw      , Rrc         , Gg^Wm       , Rrc         , Rrc         , Gs^Fmw      , Rrc         , Rrc         , Gs          , Rr^Vhc      , Ch          , Gg          , Gg          , Gg          , Ce          , Wwf         , Gg          , Gs          , Gs^Vh       , Gs          , Rb^Gvs      , Rb          , Rb^Gvs      , Gg          , Re          , Re          , Gg^Em       , Gll^Fp      , Gll^Fp      
Gg          , Ww          , Ss          , Wo          , Wo          , Ww          , Ww^Bsb|     , Ww          , Ss          , Ss          , Gg          , Rrc         , Rrc         , Gg^Eza      , Rrc         , Rrc         , Rrc         , Gg^Vh       , Gs^Fmw      , Gs^Fmw      , Gs          , Rrc         , Rrc         , Gs^Vh       , Gs          , Gg          , Gg          , Ket         , Wwf         , Gg          , Gg          , Gg          , Gg          , Gg^Wm       , Gs          , Gg          , Gg          , Gs          , Gd^Fmw      , Gs^Vl       , Gd^Fmw      , Gll^Fp      
Gg          , Gg          , Chs         , Ss          , Ww          , Wo          , Rrc         , Ww          , Ww          , Ss          , Gg          , Rrc         , Rrc^Vhc     , Rrc         , Rrc         , Rrc^Vhc     , Rrc         , Gg          , Gg          , Gs^Fmw      , Gs^Fmw      , Gs          , Gg          , Rrc         , Gg          , Ww          , Ww          , Ww          , Ww          , Ww          , Ww          , Ww          , Ww          , Gs          , Gg          , Gg          , Gs          , Gs          , Gg          , Gd^Fmw      , Gd^Fmw      , Gll^Fp      
Gg          , Gg          , Gg          , Ww          , Ww          , Gg          , Rrc         , Ss          , Ww          , Ww          , Gg^Vh       , Rrc         , Rp^Vhc      , Rrc         , Rrc         , Rrc^Vhc     , Ss          , Ss          , Ss          , Gs^Fmw      , Ww          , Ww^Es       , Ww          , Ww^Bsb|     , Ww          , Ww          , Ww          , Wo          , Wo          , Ww          , Wo          , Wo          , Ww          , Ww          , Ww          , Wwf^Es      , Wwf         , Gg          , Gg          , Gs^Fdw      , Gll^Fp      , Gll^Fp      
Gg^Efm      , Ket         , Ce          , Gg^Ve       , Ww          , Gg^Wm       , Rrc         , Ss          , Ww          , Ww          , Ww          , Gs^Fmw      , Gs^Fmw      , Rrc         , Rrc         , Gg          , Ww          , Ww          , Wo          , Wo          , Ww          , Ww          , Ww          , Ww^Bsb|     , Ww          , Ww          , Gg          , Ww          , Ww^Bw/      , Wo          , Ww          , Wo          , Ww          , Wo          , Wo          , Ww          , Ww^Es       , Gg          , Gg          , Gg          , Gg          , Gg          
Rr          , Gg          , Rr          , Gg          , Rr          , Rrc         , Rp^Vhc      , Gg^Fet      , Gg^Vh       , Ww          , Wo          , Ww          , Ww          , Gg^Ve       , Ww^Bsb|     , Ww          , Wo          , Wo          , Ww          , Ss          , Ss          , Ww          , Rrc         , Rrc         , Gll^Fp      , Gg          , Gg          , Gg^Ve       , Gg          , Ww          , Gg          , Ww          , Gg          , Ww          , Ww          , Wo          , Wo          , Ww          , Ww          , Wwf         , Gg          , Gg          
Gg          , Rr          , Ce          , Rr          , Gg^Vh       , Rrc         , Rrc         , Gs^Fmw      , Gs^Fmw      , Ch          , Ww          , Wo          , Ch          , Ww          , Ww^Bsb|     , Ww          , Ch          , Kh          , Gs^Fmw      , Gs^Fmw      , Rrc         , Rrc         , Gll^Fp      , Rrc         , Gll^Fp      , Gll^Fp      , Gg          , Rrc         , Gg          , Ket         , Gg          , Gg          , Gs^Em       , Gll^Fp      , Gll^Fp      , Ww          , Ww          , Wo          , Wo          , Ww          , Ww          , Gg          
Gg          , Gg          , Ce          , Gs^Fmw      , Ww          , Gs^Fmw      , Rrc         , Rrc         , Rrc         , Gg          , Ww          , Wo          , Gg^Fet      , Gs^Fmw      , Rrc         , Gg          , Rp^Vhc      , Gs^Fmw      , Rrc         , Rrc         , Gg          , Gg          , Gll^Fp      , Rrc         , Rrc         , Gll^Fp      , Gs^Vh       , Rrc         , Ce          , Ce          , Gg          , Gll^Fp      , Gll^Fp      , Gll^Fp      , Gll^Fp      , Wwf         , Ww          , Wo          , Wo          , Wo          , Ww          , Ww          
Gg          , Gg          , Gg          , Gs^Fdw      , Rrc         , Rrc         , Ch          , Gs^Fmw      , Ww          , Ww^Bsb\     , Ww^Bsb\     , Ww          , Gg^Ve       , Gg          , Ch          , Rrc         , Rrc         , Rrc         , Gg^Ve       , Ch          , Ss          , Ss          , Gg          , Gll^Fp      , Gg^Ve       , Rrc         , Rrc         , Rrc         , Ce          , Gg          , Gg          , Gll^Fp      , Gll^Fp      , Gll^Fp      , Gs^Vl       , Gs          , Gs          , Ww          , Ww          , Wo          , Wo          , Ww          
Rr          , Rr          , Rr          , Rrc         , Gs^Fmw      , Rp^Vhc      , Ww^Es       , Ww          , Ww          , Ww          , Ss          , Gg          , Ch          , Ch          , Ch          , Rrc         , Rrc         , Gg^Fet      , Gs^Fp       , Kh          , Ss          , Ss          , Gg          , Gg^Em       , Gg          , Rrc         , Gs^Vh       , Gg          , Gg          , Ce          , Gg          , Gg          , Gll^Fp      , Gs          , Gs          , Re          , Gg          , Wwf^Es      , Ww^Es       , Wo          , Wo          , Wo          
Gg          , Ce          , Ww          , Gg^Wm       , Ww          , Gs^Fmw      , Ww          , Ww          , Gs^Fmw      , Gs^Fmw      , Ss          , Gg^Ve       , Ch          , 2 Kh        , Ch          , Gg^Fet      , Gs^Fdw      , Rrc         , Gg          , Ch          , Gs^Fmw      , Ss          , Gll^Fp      , Gll^Fp      , Gg          , Rrc         , Rrc         , Gg          , Gg          , Ket         , Ce          , Gg          , Gg          , Gg          , Gll^Fp      , Re          , Gll^Fp      , Wwf         , Wwf^Es      , Ww^Es       , Ww          , Ww          
Ww          , Ww          , Ket         , Ww          , Gs^Fdw      , Ww          , Ww          , Ch          , Gs          , Gs^Fdw      , Rrc         , Ss          , Rrc         , Ch          , Gs^Fdw      , Ch          , Rrc         , Rrc         , Gg          , Ch          , Gs^Fdw      , Gs^Fmw      , Gd^Fmw      , Gd^Fmw      , Gll^Fp      , Gg          , Gs^Vh       , Rrc         , Rrc         , Gg          , Gg          , Ce          , Ce          , Gg          , Gll^Fp      , Re          , Re          , Gs          , Gd          , Gs          , Gg          , Ww          
Gg          , Gg          , Ce          , Gs^Vht      , Rrc         , Rrc         , Rrc         , Ww          , Ww^Bsb/     , Rrc         , Gs^Fdw      , Rrc         , Rp^Vhc      , Rrc         , Rrc         , Gs^Fdw      , Rrc         , Rrc         , Rrc         , Gs^Fdw      , Gg^Ve       , Gs^Fmw      , Gs^Fdw      , Gd^Fmw      , Gg^Em       , Gg          , Rrc         , Rrc         , Rrc         , Gs^Vh       , Gll^Fp      , Gll^Fp      , Ce          , Gg          , Gll^Fp      , Gll^Fp      , Gg          , Re          , Re          , Gs          , Gs          , Gg          
Gg          , Gs          , Rr          , Rrc         , Ce          , Gs^Fmw      , Gg          , Rrc         , Ss          , Ww          , Ww          , Ch          , Gs^Fdw      , Gg          , Rrc         , Rrc         , Kh          , Ch          , Gg          , Rrc         , Rrc         , Gs^Fdw      , Gg^Fet      , Gg          , Rrc         , Rrc         , Gd^Fmw      , Gg          , Gg          , Rrc         , Gs^Vh       , Gll^Fp      , Ce          , Gg          , Gs          , Gs          , Gg^Eff      , Gg^Eff      , Re^Eff      , Re          , Gg          , Gs          
Rr          , Rr          , Gs          , Gs          , Ce          , Gs^Fmw      , Gs^Fmw      , Gg^Em       , Ss          , Ss          , Ww          , Gg          , Gs^Fdw      , Gs^Fmw      , Rrc         , Rp^Vhc      , Gs^Fdw      , Gs^Fdw      , Gs^Fdw      , Gg          , Gg          , Rrc         , Rrc         , Rrc         , Gg^Fet      , Gs^Fdw      , Gd^Fmw      , Gd^Fmw      , Gll^Fp      , Gll^Fp      , Gll^Fp      , Gll^Fp      , Ce          , Gg          , Gs          , Gg^Eff      , Gs^Vh       , Re          , Re          , Gg^Eff      , Gg          , Gg          
Gg          , Gs          , Gd          , Gs          , Ce          , Gs^Fmw      , Gs^Fmw      , Gs^Fdw      , Wwf         , Ww          , Ww          , Gs^Fdw      , Gs^Fmw      , Gs^Fdw      , Rrc         , Gs^Fmw      , Gs^Fdw      , Gs^Fmw      , Gs^Fdw      , Gg          , Gg          , Gg          , Rrc         , Gg          , Gg          , Gll^Fp      , Gll^Fp      , Gll^Fp      , Gll^Fp      , Gll^Fp      , Ce          , Ce          , Gll^Fp      , Gd^Fmw      , Gd^Fmw      , Gg          , Rb          , Rb^Gvs      , Rb^Gvs      , Re          , Gg          , Gg          
Gg          , Gd          , Gd          , Gg          , Ce          , Gll^Fp      , Gll^Fp      , Gll^Fp      , Wwf^Es      , Ww          , Ww          , Gll^Fp      , Gg^Fet      , Rrc         , Gg^Fet      , Gll^Fp      , Gll^Fp      , Gd^Fmw      , Gd^Fmw      , Gs^Fdw      , Gs^Fdw      , Gg^Fet      , Rrc         , Gg          , Gg          , Gg          , Ket         , Ce          , Ce          , Ce          , Gll^Fp      , Gll^Fp      , Gll^Fp      , Gll^Fp      , Re          , Re          , Rb          , Rb^Gvs      , Re^Gvs      , Re          , Gs^Wm       , Gg          
Gg          , Gs          , Ket         , Ce          , Gll^Fp      , Gd^Fmw      , Gd^Fmw      , Wwf         , Ww          , Ww          , Ss          , Ss          , Gg          , Rrc         , Ww          , Gll^Fp      , Gll^Fp      , Gll^Fp      , Gd^Fmw      , Gd^Fmw      , Gs^Fdw      , Gd^Fmw      , Gd^Fmw      , Rrc         , Rr          , Ce          , Gll^Fp      , Gll^Fp      , Gll^Fp      , Gll^Fp      , Gll^Fp      , Gll^Fp      , Gd^Fmw      , Re          , Re          , Rb^Gvs      , Rb^Gvs      , Rb          , Gs          , Re          , Gg          , Gg          
Gll^Fp      , Gll^Fp      , Ce          , Gll^Fp      , Gd^Fmw      , Gll^Fp      , Gs          , Wwf^Es      , Wwf         , Ww          , Ww          , Ss          , Ww          , Ww^Bsb|     , Ww          , Ww          , Ww          , Wwf         , Ww          , Ww          , Wwf         , Gd^Fmw      , Ket         , Ce          , Gg          , Rr          , Gll^Fp      , Gll^Fp      , Gs^Vl       , Gll^Fp      , Gll^Fp      , Gd^Fmw      , Gs^Fdw      , Gs^Fdw      , Gs^Vh       , Rb^Gvs      , Gg^Eff      , Gg^Eff      , Rb          , Re          , Gg          , Gg          
Gs          , Gll^Fp      , Ce          , Gll^Fp      , Gg          , Rr          , Rr          , Gs^Vh       , Gg          , Ww          , Ww          , Ww          , Ww          , Ww^Bsb|     , Ww          , Ww          , Wo          , Ww          , Ww          , Ww          , Ww          , Ce          , Gll^Fp      , Gll^Fp      , Gg          , Rr          , Gg          , Gg          , Gll^Fp      , Gll^Fp      , Gll^Fp      , Gd^Fmw      , Gs^Fdw      , Gg^Eff      , Gg^Eff      , Gs^Eff      , Gg          , Rb          , Gs^Eff      , Gg          , Gs          , Gg          
Gs          , Gg          , Gll^Fp      , Ce          , Ket         , Gg          , Gll^Fp      , Rr          , Rr          , Gs^Vh       , Gg          , Gg          , Gs^Vh       , Rrc         , Wwf         , Ww          , Wo          , Wo          , Wo          , Wo          , Wo          , Ce          , Gll^Fp      , Gll^Fp      , Gll^Fp      , Rr          , Gll^Fp      , Ch          , 3 Kh        , Gll^Fp      , Gs^Vh       , Gll^Fp      , Gs          , Gg          , Gs          , Gs          , Re          , Re          , Gs          , Gs^Eff      , Gs^Eff      , Gg          
Gg          , Gs          , Gll^Fp      , Gll^Fp      , Ce          , Gs          , Gll^Fp      , Gd^Fmw      , Gll^Fp      , Rr          , Rr          , Gs^Vh       , Rrc         , Rrc         , Gg          , Ww          , Wo          , Wo          , Wo          , Wo          , Ce          , Ce          , Gll^Fp      , Gll^Fp      , Gll^Fp      , Rr          , Rr          , Ch          , Ch          , Gg          , Gll^Fp      , Gll^Fp      , Gg          , Gg          , Re          , Re          , Gs^Vh       , Gs^Vh       , Re^Gvs      , Gs          , Gs          , Gg^Eff      
Gll^Fp      , Gs          , Gll^Fp      , Gll^Fp      , Ce          , Gll^Fp      , Gll^Fp      , Gd^Fmw      , Gll^Fp      , Gll^Fp      , Gg          , Rrc         , Gs          , Gg          , Gg          , Ww          , Ww          , Wo          , Wo          , Ket         , Gll^Fp      , Gll^Fp      , Gll^Fp      , Gll^Fp      , Gd^Fmw      , Gd^Fmw      , Gs          , Rr          , Rr          , Gg          , Gg          , Gll^Fp      , Rb          , Rb          , Gg^Eff      , Gg          , Rb^Gvs      , Re^Gvs      , Rb^Gvs      , Re^Gvs      , Re          , Gg          
Gll^Fp      , Gll^Fp      , Gg          , Gs          , Ket         , Gll^Fp      , Ce          , Ce          , Ce          , Ce          , Gg          , Rr          , Ce          , Ce          , Ket         , Ce          , Ce          , Ww          , Ce          , Ce          , Gll^Fp      , Gll^Fp      , Gll         , Gll^Fp      , Gd          , Gd^Fmw      , Gs          , Gg          , Gg          , Rr          , Rr          , Re          , Gg^Eff      , Gg^Eff      , Re^Gvs      , Rb^Gvs      , Rb          , Rb^Gvs      , Rb          , Re^Gvs      , Gg          , Gg          
Gll^Fp      , Gd^Fmw      , Gll^Fp      , Gs          , Gs          , Ce          , Gg          , Gg          , Gs          , Gd^Fmw      , Rr          , Rr          , Gs          , Gg          , Gll^Fp      , Gg          , Gg          , Ce          , Gg          , Gll^Fp      , Gd^Fmw      , Gll^Fp      , Gll         , Gd          , Gll^Fp      , Gd          , Gs          , Gs          , Gg          , Gs          , Gg          , Rr          , Rr          , Gg^Eff      , Gg^Eff      , Rb          , Re^Gvs      , Rb^Gvs      , Re          , Gg          , Gg          , Gs          
Gll^Fp      , Gll^Fp      , Gd^Fmw      , Gs          , Gll^Fp      , Gg          , Gs          , Gll^Fp      , Gll^Fp      , Rr          , Gs          , Gll^Fp      , Gll^Fp      , Gll^Fp      , Gll^Fp      , Gg          , Gll^Fp      , Gg          , Gll^Fp      , Gg          , Gd^Fmw      , Gll^Fp      , Gd^Fmw      , Gll         , Gll^Fp      , Gll^Fp      , Gll^Fp      , Gll         , Gll^Fp      , Gg          , Gg          , Rr          , Ch          , Rr          , Gs          , Gg^Eff      , Gg^Eff      , Gg          , Gs          , Gg^Wm       , Rb^Gvs      , Re^Gvs      
Gll^Fp      , Gll^Fp      , Gd^Fmw      , Gll^Fp      , Gs          , Gll^Fp      , Gs          , Gll^Fp      , Gll^Fp      , Rr          , Gs          , Gs          , Gg          , Gll^Fp      , Gd^Fmw      , Gll^Fp      , Gll^Fp      , Gs          , Gll^Fp      , Gd^Fmw      , Gll^Fp      , Gll^Fp      , Gll^Fp      , Gll^Em      , Gd^Fmw      , Gll^Fp      , Gll^Fp      , Gll^Fp      , Gd^Fmw      , Gg          , Gs          , Gg          , Re          , Rr          , Rr          , Gg          , Gg^Eff      , Gg^Eff      , Re          , Re^Gvs      , Rb^Gvs      , Rb^Gvs      
Gll^Fp      , Gll^Fp      , Gll^Fp      , Gll^Fp      , Gll^Fp      , Gll^Fp      , Gll^Fp      , Gg          , Gll^Fp      , Rr          , Rr          , Gg^Ve       , Gll^Fp      , Gll^Fp      , Gd^Fmw      , Gd^Fmw      , Gll^Fp      , Gs          , Gs          , Gll^Fp      , Gll^Fp      , Gll^Fp      , Gll^Fp      , Gll^Fp      , Gll^Fp      , Gll^Fp      , Gd^Fmw      , Gd^Fmw      , Gs^Em       , Gs          , Gs          , Gs^Vh       , Re          , Re          , Gs          , Rr          , Rr          , Gg^Eff      , Gg^Eff      , Re          , Rb^Gvs      , Rb          
Gll^Fp      , Gd^Fmw      , Gd^Fmw      , Hh          , Hh          , Gll^Fp      , Hh          , Gll^Fp      , Gll^Fp      , Gll^Fp      , Rr          , Gll^Fp      , Gd^Fmw      , Gll^Fp      , Gd^Fmw      , Gd^Fmw      , Gll^Fp      , Gs          , Gll^Fp      , Gll^Fp      , Gd^Fmw      , Gll^Fp      , Gll^Fp      , Gll^Fp      , Gs^Em       , Re^Vl       , Re          , Gll^Fp      , Gs          , Gg          , Gs^Wm       , Re          , Re^Gvs      , Re^Gvs      , Re^Gvs      , Gs          , Gg          , Rr          , 1 Rr        , Gg^Eff      , Gg^Eff      , Gs^Vh       
Gll^Fp      , Gll^Fp      , Gll^Fp      , Hh          , Hh          , Hh          , Hh          , Gll^Fp      , Gll^Fp      , Gll^Fp      , Rr          , Gll^Fp      , Gll^Fp      , Gll^Fp      , Gll^Fp      , Gll^Fp      , Gg          , Gll^Fp      , Gll^Fp      , Gll^Fp      , Gll^Fp      , Gll^Fp      , Gll^Fp      , Gd^Fmw      , Re          , Re          , Gs          , Re          , Re          , Gg          , Re^Gvs      , Re^Gvs      , Re^Gvs      , Re^Gvs      , Re^Gvs      , Re^Gvs      , Gg          , Gg          , Gg          , Rr          , Rr          , Gg^Eff      
