Gll^Fp, Gll^Fp, Gll^Fp, Gg, Gg, Gll^Fp, Gg, Gs, Rp, Gg, Gg, Gg, Gs, Gs, Gs, Gg, Gll^Fp, Gll^Fp, Gll^Fp, Gll^Fp, Gg, Gg, Hh, Hh, Mm^Xm, Mm^Xm, Hh, Gg, Gll^Fp, Gll^Fp, Gll^Fp, Gll^Fp, Gll^Fp, Gd^Fmw, Gd^Fmw, Chr, Gll^Fp, Gll^Fp, Gll^Fp, Gll^Fp, Gll^Fp, Gll^Fp, Chs, Chr, Gd^Fmw, Gll^Fp, Gll^Fp, Gll^Fp, Gll^Fp, Gll^Fp, Gll^Fp, Gll^Fp, Gll^Fp, Gll^Fp, Gll^Fp, Gll^Fp
Gll^Fp, Gll^Fp, Gll^Fp, Gll^Fp, Gll^Fp, Gll^Fp, Gll^Fp, Gg, Gg, Rr, Gg, Gg, Gs, Gs, Gs, Gg, Gll^Fp, Gll^Fp, Gd^Fmw, Gll^Fp, Gg, Gg, Mm, Mm, Mm^Xm, Mm, Hh^Fp, Gg, Gll^Fp, Gll^Fp, Gll^Fp, Gll^Fp, Gd^Fmw, Gll^Fp, Gd^Fmw, Chr, Chs, Ss, Ss, Gll^Fp, Ss, Ss, Ss, Ss, Ss, Gll^Fp, Gll^Fp, Gd^Fmw, Gll^Fp, Gs^Fp, Gs^Fp, Gll^Fp, Gs^Em, Gs^Fp, Gll^Fp, Gll^Fp
Gs, Gll^Em, Gll, Gll^Fp, Gll^Fp, Gll^Fp, Gs, Gs, Gll^Fp, Rp, Rp, Gll^Fp, Re^Vh, Gs, Gll^Fp, Gg, Gs, Gll^Fp, Gd^Fmw, Gll^Fp, Gg, Hh, Mm, Hh, Mm, Hh, Gg, Gg, Gll^Fp, Gll^Fp, Gg^Em, Gll^Fp, Gll^Fp, Gd^Fmw, Gll^Fp, Gd^Fmw, Ss, Ss, Ss^Vhs, Ss, Ss, Ss, Gll^Fp, Ss, Gll^Fp, Ss, Ss, Ss, Ss, Gll^Fp, Gs^Fp, Gll^Fp, Gs^Fp, Gll^Em, Gll^Fp, Gll^Fp
Gs, Gll^Fp, Gll^Fp, Gll^Fp, Gll^Fp, Gll^Fp, Gll^Em, Gll^Fp, Gll^Fp, Rp, Rr, Gs, Re, Gs, Gll^Fp, Gs, Gg, Re^Em, Gll^Fp, Gll^Fp, Gs, Hh, Mm, Hh, Mm, Gg, Hh, Gll^Fp, Hh, Gs^Em, Gg^Em, Gg, Gd^Fmw, Gd^Fmw, Gll^Fp, Gll^Fp, Ss, Ss, Gll^Fp, Ss, Ss, Ss, Gll, Gll^Fp, Gll^Fp, Ss, Gll^Fp, Gd^Fmw, Ss, Ss, Gll^Fp, Gll^Fp, Gs^Fp, Gll^Fp, Gd^Fmw, Gll^Fp
Gs, Gd^Fmw, Gll^Fp, Gll^Fp, Gll^Fp, Gll^Fp, Gll^Em, Gll^Fp, Gll^Em, Gll, Gs, Rr^Ve, Gll, Gll^Fp, Gll^Fp, Re, Gg, Gll^Fp, Gll^Fp, Gs, Gs, Hh^Fp, Gg, Hh, Hh, Hh, Hh, Hh^Fp, Chr, Hh^Fp, Gll^Fp, Gll^Fp, Gll^Fp, Gll^Fp, Gs, Ss, Gll^Fp, Chr, Gd^Fmw, Gll^Fp, Ss, Ss, Ss, Gll^Fp, Ss, Ss, Gll^Fp, Gll^Fp, Gd^Fezo, Ss, Gll^Fp, Gll^Fp, Gll^Fp, Gll^Em, Gs^Em, Gll^Fp
Gll^Fp, Gll, Gs^Em, Gll^Fp, Re, Gll^Fp, Gs, Gg, Gll^Fp, Gll^Fp, Gll^Fp, Gs, Gll^Fp, Gll^Fp, Gll^Fp, Gg, Gg, Gs, Gs, Gs, Gg, Hh^Fp, Gg, Hh^Fp, Hh^Vhhr, Mm, Hh, Hh, Gs, Gs, Gll^Fp, Gd^Fmw, Gll^Fp, Gll^Fp, Gs, Gll^Fp, Gll^Fp, Gll^Fp, Gll^Em, Ss, Ss, Gll^Fp, Gll^Fp, Ss, Ss, Ss, Ss, Chs, Chs, Ss, Gll^Fp, Gll^Fp, Gll^Fp, Gll^Em, Gll^Em, Gll^Fp
Gll^Fp, Gll^Fp, Gll, Gll^Fp, Gs, Gg, Gll^Fp, Gg, Gs, Gd, Gs, Gll^Fp, Gs, Re, Gg, Gg, Gg, Gs, Gs, Gg, Gs, Hh, Gg, Hh, Hh, Mm, Mm, Gg, Hh, Gg, Gg, Gd^Fmw, Gd^Fmw, Gg^Em, Gg, Gs, Gll^Fp, Gll^Fp, Gll^Fp, Ss, Gg, Gll^Fp, Ss, Ss, Gg, Gll, Gs, Ss, Ss, Ss, Gll, Gll^Em, Gll^Fp, Gd^Fmw, Gs^Fmw, Gs^Fp
Gg, Gll^Fp, Gll^Fp, Gs, Gs, Gg, Gg, Gg, Gs, Gd, Gll, Re, Gd, Gs, Gs, Gg, Gll^Fp, Gs, Hh, Hh, Gg, Gg, Gg, Gg, Hh, Mm^Xm, Mm, Hh^Fp, Hh^Fp, Hh^Fp, Hh, Gll^Fp, Gd^Fmw, Gg, Gg, Gg, Gg, Gg, Gg, Gg, Gg, Gg, Chs, Ss, Gll, Gs, Chr, Gs, Gs, Gd^Vhr, Gs, Gll^Em, Gg^Em, Gll^Fp, Gs^Fp, Gs^Fp
Hh^Fp, Gll, Gll^Fp, Gg, Hh, Gg, Gg, Gs, Gll^Fp, Re, Gll, Gs, Gll^Fp, Gg, Gll^Fp, Gd, Gll^Fp, Gg, Hh, Hh^Fp, Gg, Hh, Hh, Hh, Hh, Mm, Hh, Hh^Fp, Gg, Hh, Gg, Gg, Gs, Gs, Gll^Fp, Gll^Fp, Gg, Gg, Gll^Fp, Gll^Fp, Re, Re, Chr, Ss, Gg, Chr, 2 Khr, Chr, Gs, Gg, Chr, Gg, Gll, Gll^Fp, Gs^Fp, Gll^Fp
Hh^Fp, Gll^Fp, Gg, Gg, Mm, Hh, Gg, Gg, Gll^Fp, Re^Fp, Gll^Fp, Gll, Gll^Fp, Gs, Gll^Fp, Gll^Fp, Gll^Fp, Gll^Fp, Hh, Hh, Gs, Gg, Gg, Gg, Gg, Hh, Gs, Gs, Gs, Gg, Gg, Gg, Gs, Gg, Gll^Fp, Gll^Fp, Re, Re, Gg, Gll^Fp, Gg, Ch, Gg^Fet, Gg^Dr, Gg, Ch, Chr, Chr, Gg, Gg^Fet, Chr, Gg, Gs, Gll^Fp, Gll^Fp, Gll^Fp
Gg, Hh^Fp, Hh, Mm, Hh, Hh, Hh^Fp, Gll^Fp, Gll^Fp, Gll^Fp, Gll, Gll^Fp, Gll^Fp, Gll, Hh, Gll^Fp, Gll, Hh^Fp, Hh, Gg, Gg, Gs, Gs, Gg, Re, Gg, Gg, Gg, Gs^Vhr, Gg, Gg, Gs, Gg, Gg, Gg, Gll^Fp, Re, Ch, Gll^Fp, Gll^Fp, Gg, Rp, Rp^Vhcr, Gg^Es, Rp, Rp, Rp, Gg, Rp^Vhcr, Re, Gg^Es, Gg^Dr, Gll, Gll^Em, Gll^Fp, Gll^Fp
Hh, Hh, Hh, Hh, Hh, Mm, Hh, Hh, Gll^Fp, Gll^Fp, Gll, Gll^Fp, Hh, Hh^Fp, Gll^Fp, Gll^Fp, Gll, Gs, Gg, Gg, Gg, Re, Re, Re, Gg, Re, Gg, Gs, Re, Re, Gg, Re, Re, Gg, Gs, Gg, Chr, Chr, Gg, Gll^Fp, Gll^Fp, Gg, Rp^Es, Re, Gg, Chr, Chr, Gg, Re^Es, Re, Gg, Gs, Gs, Gll^Fp, Gll^Fp, Gs
Hh, Hh, Mm, Mm, Hh, Hh^Fp, Hh, Gll^Fp, Gll^Fp, Gll^Fp, Gll^Fp, Gs, Gs, Hh, Gll^Fp, Gll^Fp, Gll^Fp, Gll, Gll^Fp, Gg, Re, Gs, Re, Gs, Gll^Fp, Gs, Gg, Re, Gg, Re, Gg, Gs, Gg, Gg, Re, Gs, Gg, Gg^Es, Gg, Gll^Fp, Rp, Gg, Gg, Re, Gs^Es, Gs^Fet, Rp, Gg, Re, Rp, Gs^Dr, Gg, Gs^Fdw, Gd^Fmw, Gll, Gd^Fmw
Hh, Hh, Mm, Hh, Hh^Fp, Gll^Fp, Gll^Fp, Gg, Hh, Gs, Gg, Gg, Gll^Fp, Gll, Gll^Fp, Gd^Fetd, Gll^Fp, Gll^Fp, Gll^Fp, Gg, Gs, Gs, Gs, Gg, Gs^Fdw, Gll^Fp, Gs, Gg, Gll, Gll^Fp, Gd^Fmw, Gll^Fp, Gg, Gg, Gg, Gs, Re, Re, Gs, Re, Gg^Dr, Re, Rp, Ch, Rp, Re, Rp^Vhcr, Gg, Gg, Gg, Gs, Gg, Gg, Gs, Gd^Fmw, Gll^Fp
Mm, Mm, Mm, Hh, Hh^Fp, Gll^Fp, Gs, Hh, Hh, Gs, Gg, Gs, Gll^Fp, Gll^Fp, Gll, Gll^Fp, Gg, Gg^Em, Gg, Gg, Gs, Re, Gs^Vhr, Gg, Gd^Fmw, Gll^Fp, Gs^Fdw, Gg, Gll, Gll^Fp, Gll^Fp, Gll^Fp, Gd, Gll^Fp, Gll^Fp, Re, Gg, Gg, Re, Gs, Gg, Re^Es, Rp, Rr, Rp^Es, Re, Rp, Re, Rp, Ch, Rp, Gg, Chr, Gs, Gll^Fp, Gll
Hh, Hh, Hh, Hh, Hh, Gll^Fp, Hh, Gg, Hh, Hh, Hh, Mm, Hh, Gg, Gg, Gll^Fp, Gg, Gg, Gg, Gg, Re, Gg, Gg, Gs, Gll^Fp, Gll^Fp, Gd^Fmw, Gs^Fdw, Gll, Gll, Gd^Fmw, Gs, Gd, Gll^Fp, Gll, Gs, Gll^Fp, Gs, Gs^Fdw, Gs, Gg, Re, Gg, Re, Re, Rp, Gs, Gs^Fdw, Gd^Fmw, Rr, Rp, Rp, Rp, Gg, Rp, Gg
Hh, Hh, Hh^Fp, Hh, Hhd, Hhd, Mm, Hh, Mm, Mm, Hhd^Fmw, Hh, Chr, Gg, Re, Re, Gg, Re, Gs, Re, Gg, Gg, Gs^Fdw, Gs, Khr, Chr, Gll^Fp, Gll^Fp, Gd^Fmw, Gs, Gg, Gs, Gg, Gd, Gll^Fp, Gll, Gll^Fp, Gll^Fp, Gd^Fmw, Gll^Fp, Gg, Gg, Gg, Chr, Re, Gg, Gll^Es, Gll, Gs^Fdw, Gg, Gs^Es, Gs^Dr, Gg, Rp, Gg, Rp
Hh, Hh, Hh^Fp, Hh^Fp, Hh, Mm, Mm, Hh, Hh^Fp, Hhd^Fmw, Hhd^Fdw, Hhd, Gg, Gg, Re, Re, Chr, Gg, Gg, Gs, Gs, Gg, Gs^Fdw, Gd^Fmw, Chr, Chr, Gs, Gll^Fp, Gs, Gg, Ww, Gg, Chw, Gs, Wwf^Es, Gll^Fp, Gs, Gs^Fdw, Gs^Fdw, Gs^Fdw, Gs, Gg, Wwf^Es, Wwf, Re, Gs^Es, Gll^Dr, Hh^Fp, Hh^Fmw, Gs, Gg, Gs, Hh^Fmw, Gg, Hh, Gg
Hh, Hh, Hh, Gll^Fp, Gll^Fp, Hhd, Hhd^Fdw, Hhd^Fmw, Gg, Hh^Fp, Gg, Gg, Re, Gg, Gg, Gg, Hh, Hh, Hh, Gs, Gs, Gs^Vh, Gs, Gll^Fp, Gd^Fmw, Gs, Ww, Gs, Wwr, Wwr, Wo, Ww, Wwr, Wwf, Gg, Gll^Fp, Gg, Gll^Fp, Gs, Gd^Fmw, Gs, Wwr, Wwf^Es, Gll, Gg, Re, Gs, Hh, Hh, Gs, Hh, Hh, Gg, Hh, Hh, Hh
Hh, Hh, Gs, Gll^Fp, Gll, Re, Gs, Re^Vl, Gg, Gg, Re, Rb, Gg, Gg, Hh, Hh^Fp, Hh, Mm, Mm, Gg, Gg, Gg, Gg, Gll^Fp, Gll^Fp, Gs, Wwf, Ww, Ww, Wo, Wo, Ww^Ewl, Ww, Chr, Gg, Gg, Ww, Gg, Ww, Gs, Wwf^Es, Ww, Gs, Gll^Fp, Gs, Re, Re, Gs, Gs, Gg, Hh, Gg, Gs^Vh, Gs, Gs, Gg
Gs, Gs, Gs, Gs, Gg, Gg, Ce, Re, Gg, Re, Re, Gg, Gg, Gg, Hh, Hh, Mm, Mm^Xm, Mm, Gg, Hh, Gs, Gs, Gs, Gg, Wwf^Es, Ww, Ww, Wo, Wo, Wo, Ww^Ewf, Ww, Gg, Ww^Ewl, Ww^Ewl, Ww, Ww, Ww, Wwf^Es, Ww, Wwr, Gll, Gll, Gs, Hh, Gs, Re^Es, Gll, Hh, Gll^Fp, Gll^Fp, Gg^Em, Gs, Gll^Fp, Gg
Gs, Gg, Gg, Gs, Gg, Ce, 1 Ke, Ce, Re, Re, Gs, Re, Gg, Hh, Mm, Mm, Mm, Mm, Mm^Xm, Mm, Mm, Hh, Gs, Gg, Gg, Wwf, Wwr, Ww^Ewl, Ww, Wo, Wo, Ww, Ww, Ww, Wo, Ww^Ewl, Wo, Ww, Ww, Wwf^Es, Gll, Gs, Gll^Fp, Gll^Fp, Hh^Fp, Gs, Hh, Re, Gs^Es, Gll^Fp, Gll^Fp, Gll^Fp, Gll^Em, Gg^Es, Gll^Fp, Gll^Fp
Gg, Gg, Gs, Gs, Re, Ce, Ce, Ce, Gg, Gg, Gs, Gs, Hh, Hh, Mm, Mm, Mm, Mm, Mm, Mm, Hh, Gll^Fp, Hh, Gs, Gs^Es, Rb, Re^Vl, Ww^Ewf, Ww, Wo, Wo^Ewl, Wo, Wo, Wo, Wo, Wo, Ww, Ww^Ewl, Wwr, Gll, Gll^Fp, Gs^Em, Gll^Fp, Hh^Fp, Hh^Fp, Hh, Hh^Fp, Gs, Hh, Chr, 4 Kte, Chr, Chr, Gll^Fp, Gll^Fp, Gg^Em
Gg, Gg, Gs, Re, Re, Gs, Gg, Re, Re, Gg, Gll^Fp, Gs, Gg, Mm, Hh, Mm, Hh, Mm, Mm, Hh, Hh^Fp, Gll^Fp, Gll^Fp, Gll^Fp, Gs, Re, Gll^Fp, Ww, Wo, Ww, Ww^Ewl, Ww^Ewf, Ww, Wo, Ww, Ww, Wwr, Ww^Ewf, Gll^Em, Gll, Gd^Fmw, Gll, Hh, Hh, Hh, Hh, Mm, Hh^Fp, Hh, Chr, Hh^Fp, Gll^Fp, Gll^Fp, Hh^Fp, Hh, Gg
Gg, Gg, Re, Re, Gs, Gs, Gs, Gs^Vl, Re, Gg, Gd^Fmw, Gll^Em, Gg, Hh, Hh^Fp, Hh, Hh^Fp, Mm, Mm, Hh, Hh^Fp, Hh, Gll^Em, Gll^Fp, Gll^Fp, Gll, Gs, Wwr, Wwr, Ww^Ewl, Ww^Ewf, Ww, Ww, Ww, Wwf^Es, Chw, 3 Khr, Rr, Gll^Fp, Gll^Fp, Gll^Fp, Hh, Hh, Hh^Vhhr, Mm, Mm^Xm, Mm, Hh, Mm, Hh, Hh, Hh^Fp, Hh, Hh^Fp, Hh, Gll^Fp
Gg, Gg, Re, Re, Gs, Gg, Gs, Gs, Gg, Gll^Fp, Gd^Fmw, Gs, Gs, Hh, Gs, Hh, Hh^Fp, Hh, Hh, Hh, Gll, Gs, Gs, Gs, Gll^Em, Gll, Hh^Fp, Gs, Gs, Gs, Gs, Gll^Fp, Wwr, Ww, Rr, Wwf, Chr, Rr, Gd^Fmw, Hh, Hh^Fp, Hh^Fp, Mm, Mm, Mm, Mm, Hh, Hh, Mm, Hh, Mm^Vhhr, Hh, Hh^Fp, Chr, Gll^Fp, Gll^Fp
Gg, Gs^Vl, Re, Gs, Gg, Gg, Gg, Hh, Hh, Gg, Gg, Gg, Hh^Fp, Gs, Gs, Gs, Gs, Hh, Hh, Mm, Hh, Gs, Gll^Fp, Gll, Hh^Fp, Gs, Hh, Hh, Hh, Gs, Hh^Vhhr, Gs, Gll, Wwf, Ww, Chr, Gg, Gll^Fp, Gll^Fp, Gd^Fmw, Hh^Fp, Hh^Vhhr, Hh, Mm, Hh, Mm, Hh, Mm, Hh, Hh, Hh^Fp, Hh, Gll^Fp, Hh^Fp, Gll^Fp, Gll^Fp
Gg, Re, Gg, Gg, Gg, Gs, Gs, Gg, Gg, Hh, Hh, Hh, Hh, Gs, Hh, Gs, Gs, Hh^Fp, Hh, Mm, Mm, Hh^Fp, Gll^Fp, Hh, Hh, Mm, Mm, Mm, Mm, Hh, Hh, Gd^Fetd, Gd^Fmw, Wwf^Es, Ww, Wwr, Wwr, Gg, Gll^Fp, Hh, Mm, Hh, Hh, Mm, Hh, Hh, Hh, Hh, Hh, Hh, Gll^Fp, Gll^Fp, Gll^Fp, Gll^Fp, Gll^Fp, Gll^Fp
