Gll, Gg, Gg, Gll, Gll, Gll^Fp, Gll^Fp, Gll^Fp, Gll^Fp, Gll^Fp, Gll^Fp, Gll^Fp, Gll^Fp, Gll^Fp, Gll^Fp, Gg, Gll^Fp, Gg, Gg, Hh, Hh, Hh, Gg, Gg, Gg, Gg, Gg, Hh, Hh, Gg, Gg, Gg, Gg, Gg, Gg^Efm, Gg, Gg, Gg, Gg, Gg^Es, Gg, Gs, Gg, Gg, Gg, Gg, Gg, Gg, Gs, Gg
Gll, Gll, Gll^Fp, Gll, Gll^Fp, Gll^Fp, Gs^Fms, Gll^Fp, Gll^Fp, Gll^Fp, Gs^Fms, Gll^Fp, Gll^Fp, Gll^Fp, Gll^Fp, Gll^Fp, Gll^Fp, Gg, Gg, Gg, Gg, Hh, Gg, Gg, Gg, Gg, Gg, Gg, Hh, Hh, Gg, Gg, Gg, Gg^Efm, Gg, Gg, Gs, Gg, Gg, Gg, Gg^Es, Gg, Gg, Gg, Gg, Hh, Gg, Gg, Gg, Gg
Gll^Fp, Gs^Fms, Gll^Fp, Gll^Fp, Gll^Fp, Gll^Fp, Gs^Vh, Gll^Fp, Gll^Fp, Gll^Fp, Gll^Fp, Gll^Fp, Gg, Gll, Gg, Gll^Fp, Gg, Gg, Gg, Gg, Gg, Gg, Gg, Gg, Gg, Gg, Gg^Es, Gg, Gg, Gg, Gg^Efm, Gg, Gg, Gg^Efm, Gg, Gg, Gg, Gg, Gg, Gg, Gg, Gg, Gg, Gg, Hh^Vhhr, Hh, Gs, Gg, Gs, Hh
Gll^Fp, Gll^Fp, Gll^Fp, Gg, Gg, Gll^Fp, Gs^Em, Gs, Ce, Gs, Gs, Gll^Fp, Gg, Gg, Gg, Gg, Gg, Gg, Gg, Gg, Gll^Fp, Gg, Gg, Gg, Gs, Gg, Gg, Gg, Gg, Gg, Gs^Efm, Gg, Gg, Gg, Gg, Gg, Gg^Efm, Gg, Gg, Gg, Gg, Hh, Hh, Hh, Hh, Hh, Hh, Hh, Hh, Hh
Gll^Fp, Gg^Efm, Gg, Gg, Gll^Fp, Gs^Fms, Gg, Ce, 4 Ket, Ce, Gg, Gg, Gg, Gll^Fp, Gll^Fp, Gll^Fp, Gg, Gg^Efm, Gg, Gg, Gs, Gg, Gll^Fp, Gg, Gs, Gg, Gg, Gg, Gg, Gg^Efm, Gg, Gg, Gg, Gg, Gg, Gg, Gg, Gg, Gg, Gg, Gg^Efm, Gg, Hh, Hh, Gg, Gg, Hh, Hh, Hh, Hh
Gll^Fp, Gg, Gg, Gg, Gs^Fms, Gg, Gg, Ce, Ce, Ce, Gg, Gg, Gg, Gs^Fms, Gll^Fp, Gg, Gg, Gg^Efm, Gg, Gg, Gs, Gs, Gll^Fp, Gll^Fp, Gs, Gg, Gg, Gg, Gg, Gg, Gg, Gg, Gg, Gg, Gg^Es, Gg, Gg, Gg, Gg, Gg, Gg, Gg, Gg, Gg, Gg, Gg, Gg, Hh, Hh, Hh
Gg, Gg, Gg, Gll^Fp, Gg, Gg, Gg, Gs, Gs, Gg, Gg, Gd^Vhr, Gg, Gg, Gll^Fp, Gg, Gg, Gg, Gg^Efm, Gg, Gg, Gg, Gg, Gs, Gs, Gg, Gg, Gg, Gg, Gg, Gg, Gg, Gg, Gg, Gg, Gg, Gg, Gg, Gg, Gg, Gll^Fp, Gll, Gg, Gg, Gll^Fp, Gg, Hh, Hh, Gg, Hh
Gg, Gg, Gll^Fp, Gg, Gg, Gg, Gg, Gg, Gg, Gg, Gll^Fp, Gg, Gg, Gg, Gg, Gg, Gg, Gg, Gg, Gg, Gg, Gg^Efm, Gg, Gg, Gg, Gs, Gg^Eff, Gg, Gg, Gg, Gg, Gs^Vh, Gs, Gg, Gg, Gg, Gg, Gg^Em, Gs, Gll, Gll^Fp, Gll, Hh, Hh, Gll^Fp, Hh, Hh, Hh, Gg, Gg
Gs, Gll^Fp, Gll^Fp, Gs^Vh, Gs, Gg, Gs, Gs, Gg, Re, Re, Gg, Gg, Gg, Gg, Gg, Gll^Fp, Gll^Fp, Gg, Gg, Gg, Gg, Gg, Gg, Gs^Eff, Gs^Eff, Re, Gg^Eff, Gg^Eff, Gg, Gg, Gll^Fp, Gg, Gg, Gg, Gg, Gll^Fp, Gg, Gll, Gs, Gs^Fms, Gll^Fp, Gll^Fp, Gll^Fp, Gll^Fp, Gll^Fp, Hh, Gll^Fp, Hh, Gg
Gll^Fp, Gll^Fp, Gll^Fp, Gll^Fp, Gg, Gg, Gg, Gg, Gg, Gg, Gg, Gg, Gs, Gs^Vh, Gg, Gg, Gll^Fp, Gg^Efm, Gg, Gg, Gg, Gg, Gs^Eff, Gs^Eff, Re, Re, Re^Gvs, Re^Gvs, Re^Gvs, Gg, Gll^Fp, Gll^Fp, Gg, Gg, Gg, Gg, Gll^Fp, Gll, Gll^Fp, Gs, Gll^Fp, Gll^Fp, Gs^Fms, Gll^Fp, Gll^Fp, Gll^Fp, Gll^Fp, Gll^Fp, Hh, Gg
Gll^Fp, Gll^Fp, Gs^Fms, Gll^Fp, Gll^Fp, Gg, Gg^Efm, Gg, Gg, Gg, Gg, Gs, Gs, Re, Gg, Gg, Gg, Gg, Gg^Eff, Gg, Gg, Gg^Efm, Gg, Gg^Wm, Gg, Re^Gvs, Re, Re^Gvs, Gg, Gg, Gg, Gg, Gg, Gg, Gg, Gg, Gg^Efm, Gll^Fp, Gll^Fp, Gll^Fp, Gll^Fp, Gll^Fp, Gll^Fp, Gll^Fp, Gll, Gs^Vct, Gll^Fp, Hh^Fp, Hh^Fp, Hh
Gs^Fms, Gll^Fp, Gs^Fms, Gll^Fp, Gll^Fp, Gg, Gg, Gg, Gll^Fp, Gll^Fp, Gs, Gs, Gs, Gs, Gs, Gg, Gg^Eff, Gg^Eff, Re^Gvs, Re^Gvs, Re^Gvs, Gg, Gg, Gg, Gg, Gs^Vh, Gg, Gg^Efm, Gg, Gg, Gg, Gg, Gg, Gg, Gg, Gg, Gg, Gll^Fp, Gs^Fms, Gll^Fp, Gs^Vct, Gll^Fp, Gll^Fp, Gll^Fp, Ce, Gs, Gll^Fp, Gll^Fp, Hh^Fms, Hh
Gll^Fp, Gs^Fms, Gs^Fms, Gll^Fp, Gs^Fms, Gll^Fp, Gg, Gg, Gll^Fp, Gs^Fms, Gs, Gll^Fp, Gs, Gll^Fp, Gs, Gg^Eff, Gg^Eff, Gg, Gg, Re^Gvs, Re^Gvs, Re^Gvs, Gg, Gg, Gg, Gg, Gg, Gg^Efm, Re, Re, Gg, Re^Es, Re, Gg, Gg, Gll^Fp, Gll^Fp, Gll^Fp, Gll^Fp, Gll^Fp, Gg, Gll^Em, Gll, Ce, 3 Ket, Ce, Gll^Fp, Gs^Fms, Hh, Hh
Gg, Gs^Fms, Gll, Gs, Gs^Fms, Gll^Fp, Gs^Fms, Gg, Gll^Fp, Gs, Gll^Fp, Gll^Fp, Re, Re, Gs, Gg, Gg, Gg^Eff, Gg^Eff, Gs^Vh, Gg, Gg, Re, Re, Gg, Gg, Re, Gg, Gg, Gg, Gg, Re, Gg, Re, Gg, Gg, Gg, Gg, Gg, Gg, Gg, Gll^Fp, Gll, Ce, Ce, Ce, Gll, Gll^Fp, Gll^Fp, Hh
Gg, Gll^Fp, Gll^Fp, Gll, Gll^Fp, Gs^Fms, Gll^Fp, Gll^Fp, Gs, Gs, Gs, Gs, Re, Gs, Gg, Gg, Gg, Gg, Gg, Gg, Gg, Gg, Gg^Eff, Gg, Gg^Efm, Gg, Gg, Gg, Gg, Gg, Gg, Gll^Fp, Gg, Gg, Gd, Re, Gg, Re, Gg, Gg, Re, Gll^Vct, Gll^Fp, Gs^Fms, Gll^Fp, Gll, Gs, Gll^Fp, Gll^Fp, Gg
Gg, Gg, Gg, Gs, Gg, Gll^Fp, Gg, Gg, Gs, Gs, Gg, Gg, Gg, Gg, Gg, Gll^Fp, Gll^Fp, Gg, Gg, Re, Gg, Gg, Gg, Gg^Eff, Gg^Eff, Gg, Gg, Gg, Gg, Gll^Fp, Gll^Fp, Gll^Fp, Re, Gs, Re, Gg, Gg, Gg, Gs^Fms, Gg, Gg, Re, Re, Gll^Fp, Gg, Gll^Em, Gs, Gs^Vct, Gs^Fms, Gll^Fp
Gg, Gg, Gg, Gg, Gg, Gll^Fp, Gg, Gs, Re, Gg, Gg, Gg, Gg^Efm, Gg, Gg, Gll^Fp, Gg, Gg, Re, Re, Gg, Gg, Gg, Gg^Efm, Gg, Gg, Gg, Gg, Gg, Gg, Gg, Gg, Gg, Gg, Gg, Gs, Gg, Gll^Fp, Gs^Fms, Gll^Fp, Gg, Rp, Re, Re, Gg, Gg, Gll^Fp, Gll^Fp, Gg, Gll^Fp
Gg, Gg, Gg, Gg, Gs, Gll^Fp, Gg, Gs, Gg, Gg, Gll^Fp, Gg, Gg, Gg, Gg, Gs, Gg, Gg, Gg, Gg, Gg, Gg, Gg, Gg, Gg, Gg, Gg, Gg, Gll^Fp, Gll^Fp, Gg, Gg, Gg, Gll^Fp, Gll^Fp, Gs, Gs, Gs^Fms, Gs^Fms, Gll^Fp, Gll^Fp, Gg, Gg, Gg, Re, Gg, Gg, Gg, Gg, Gll^Fp
Gg, Gg, Gg, Gll^Fp, Gs, Gg, Gg, Gg, Gg, Gg, Gll^Fp, Gg, Gg, Gg, Gg, Gs^Vct, Gg, Re, Gg, Gg^Efm, Gg, Gg^Efm, Gg^Efm, Gg, Gll^Fp, Gs^Fms, Gs^Fds, Gg, Gll^Fp, Gll^Fp, Gs, Wwf^Ewl, Wwf, Ww, Ww, Gll^Fp, Gll^Fp, Gs^Fms, Gg^Fet, Gs^Fms, Gll^Fp, Gg^Efm, Gg, Gg, Re, Gg, Gg, Gg, Gg, Gg
Gll^Fp, Gg, Gll^Fp, Gll^Fp, Gs, Gs, Gs, Gg, Gg, Gg, Gg, Gg, Gg^Efm, Gg, Gg, Gg, Gg, Gg, Gg, Gg^Efm, Gg^Efm, Gg, Gg^Efm, Gg, Gg, Gll^Fp, Gs^Fms, Gll^Fp, Gs, Gs, Gll^Eff, Gg, Wwr, Wo, Ww, Gll^Fp, Gll^Fp, Gs^Fms, Gll^Fp, Gs^Fms, Gs^Fms, Gll^Fp, Gll^Fp, Gg, Gg, Rp, Re, Re, Rp, Re
Gll^Fp, Gll^Fp, Gs^Fms, Gll^Fp, Gs^Em, Gs, Gs, Gs, Gg, Gg, Gg, Gg, Gg^Efm, Gg, Gg, Gg, Ce, Ce, Ce, Gg, Gg, Gg^Efm, Gg, Gg, Gg, Gg, Gll^Fp, Gll^Fp, Gs^Eff, Gs^Eff, Gs^Vl, Wwf^Ewl, Wwf^Ewf, Wo, Wo, Wwf, Gll^Fp, Gs, Gll, Gs^Fms, Gs, Gs^Fms, Gs^Fms, Gll^Fp, Gg, Gg, Gg, Gg, Gg, Rp
Gll^Fp, Gll^Fp, Hh, Gs^Fms, Gll^Fp, Gs, Gll^Fp, Gs, Re, Gs, Gg, Gg, Gg, Gg, Gg, Ce, Ce, 1 Ke, Ce, Ce, Gg, Gg^Efm, Gg, Gg, Gg, Gg, Gg, Gll^Fp, Gs^Fms, Gll^Eff, Gll^Eff, Ww, Wwf^Ewl, Ww, Ww, Ww, Gs^Fms, Gll^Fp, Gs^Fms, Gs^Fms, Gll^Fp, Gll^Fp, Gs^Fms, Gg^Efm, Gg, Gg, Gg, Gs^Vh, Gg, Gg
Gll^Fp, Hh, Gs^Fds, Gs^Fms, Gll^Fp, Gs^Fms, Gs^Fms, Gll^Fp, Gll^Fp, Gs, Gs, Gg, Gg, Gg^Vct, Gg, Gg, Re, Ce, Gg, Gg, Gg, Gg, Gg^Vct, Gg, Gs^Fms, Gs^Fms, Gg, Gg, Gs^Fms, Gs^Fms, Gs^Fms, Gll^Fp, Gll^Fp, Gll^Fp, Gll^Fp, Gs^Fms, Gs^Fms, Gs^Fms, Gll^Fp, Gg^Fet, Gll^Fp, Gll^Fp, Gg, Gg^Efm, Gg, Hh, Hh, Gg, Gg, Hh
Gll^Fp, Gs^Fms, Gs^Fds, Gs^Fms, Gll^Em, Gll^Fp, Gs^Fms, Gll^Fp, Gs, Gg, Gs, Gg, Gg, Gg, Gg, Gg, Re, Re, Gg, Gg, Gg, Gg, Gg, Gg, Gg, Gs^Fms, Gs^Fms, Gll^Fp, Gg, Gll^Fp, Gg, Gll^Fp, Gg^Fet, Gs^Fds, Gs^Fms, Gs^Fms, Gll^Fp, Gs^Fms, Gs^Fms, Gs^Fms, Gs^Fms, Gll, Gg, Gg, Gg, Hh, Hh, Gg, Hh, Hh^Fp
Hh, Gll^Fp, Hh, Gll^Fp, Gll, Gs^Fms, Gll^Fp, Gs, Gg, Gll^Fp, Gll^Fp, Gg^Efm, Gg, Gg, Re, Gg, Gg, Gg, Gg, Gg, Gg, Gg^Efm, Gg, Gg, Gg^Efm, Gs^Fms, Gs^Fms, Gg, Gs^Fms, Gs^Fms, Gg, Gll^Fp, Gs^Fms, Gs^Fds, Gs, Gll^Fp, Gg^Em, Gll^Fp, Gll^Fp, Gs^Fms, Gs^Fms, Gll^Fp, Gll^Fp, Gg, Gg, Hh, Hh^Fp, Hh, Hh, Hh
Hh, Hh^Fms, Gs^Fms, Gs, Gll^Fp, Gs^Fms, Gg, Gs, Gll^Fp, Gll^Fp, Gg, Gg, Gg, Gg, Gg, Gg, Re, Re, Gg, Gg, Gg, Gg, Gg, Gg, Gg^Efm, Gg, Gs^Fds, Gll^Fp, Gs^Fms, Gs^Fms, Hh, Gll^Fp, Gs^Fms, Gs^Fms, Gll^Fp, Gs, Gg, Gg, Gll, Gs^Fms, Gll^Fp, Gs, Gg, Gg, Gg, Gg, Hh, Hh, Hh^Fp, Hh
Gll^Fp, Hh, Gll^Fp, Gs, Gll^Em, Gll^Fp, Gg^Efm, Gg, Gg, Gg, Re, Gg, Gg, Gg, Gg, Re, Gg, Re^Es, Re, Gg, Re, Gg, Gg, Gg, Gs^Fms, Gs^Fms, Gs^Fms, Gll^Fp, Gll^Fp, Gg, Hh, Gg, Gll^Fp, Gg, Gg, Gg, Hh, Gg, Hh, Gg, Gg, Gs, Gg, Gg^Efm, Gg, Hh, Hh, Hh^Fp, Hh, Hh
Gll^Fp, Gll^Fp, Re^Gvs, Gll^Fp, Gs^Vh, Gll^Fp, Gg, Gg, Gg, Gg, Re, Re, Gg, Re, Gg, Gg, Gg, Re, Gg, Gg, Gg, Gg, Gg, Gll^Fp, Gs^Fms, Gs^Fds, Gs^Fms, Gs^Fms, Gg, Hh, Hh, Hh, Gg, Gll, Gg, Gg, Gg, Hh, Gg, Hh, Gg, Gg, Gg, Gg, Hh, Hh, Gg, Hh^Fp, Hh, Hh
Gg, Re^Gvs, Re^Gvs, Re^Gvs, Gg, Re, Re, Gg, Re, Re, Re, Gg, Gg, Gg, Gll^Fp, Gg, Gll^Fp, Gg, Gg, Gg, Gg, Gg, Gll^Fp, Gs^Fms, Gll^Fp, Gs^Fms, Gs^Fms, Gll^Fp, Gg, Gg, Gg, Hh^Vhh, Hh, Hh, Gg, Gg, Gg, Gs, Gll^Fp, Gs, Gg, Gg, Gg, Gg, Gg, Gg, Gg, Gg, Hh, Hh^Fp
Gg, Gll^Fp, Gll^Fp, Gll^Fp, Gg, Gs, Re, Gs, Gg, Gg, Gg, Gs, Re, Gll^Fp, Gll^Fp, Gg, Gs^Fms, Gll^Fp, Gs^Fms, Gg, Gg, Gg, Gll^Fp, Gg^Efm, Gg, Gs^Fms, Gll^Fp, Gll^Fp, Gg, Hh, Hh, Hh, Hh^Fp, Gg, Gg, Gg, Gll, Gll^Fp, Gs^Fms, Gs, Hh, Gll^Fp, Gg, Gg, Chr, Gg, Gg^Efm, Gg, Hh, Hh
Gg, Gs, Re, Re, Gs, Gg, Gg, Gg, Gg, Gg^Efm, Gg, Gg, Gg, Gs^Vh, Re^Gvs, Gll^Fp, Gs^Fms, Gs^Fds, Gll^Fp, Gll^Fp, Gg, Gg, Gg^Vh, Gg, Gg, Gg, Gg, Gg, Gg, Hh, Gs, Hh, Gg, Gg, Gg, Gg, Gll^Fp, Gs^Fms, Hh^Fp, Hh^Fms, Hh^Fms, Gll^Fp, Gll^Fp, Hh, Hh, Gg, Gll^Fp, Gg, Gg, Gg
Re, Gg, Gg, Gg, Gs, Gg, Re, Gg, Gg^Efm, Gg, Gll^Fp, Gs^Fms, Gll^Fp, Re^Gvs, Gg, Gll^Fp, Gs^Fds, Gd^Fmw, Gll^Fp, Gll^Fp, Gll^Fp, Gg, Gg, Gg, Gg, Hh, Hh, Hh, Gs, Gs, Hh, Hh, Gg, Gs, Gs, Gll^Fp, Gs^Fms, Gs^Fms, Hh^Fp, Hh^Fp, Hh, Hh^Fp, Hh, Hh, Gll^Fp, Gg, Gg^Fet, Gll^Fp, Gg, Gg
Re, Re, Re, Re, Gs, Re, Gs, Gg, Gg, Gll^Fp, Gg, Gg, Gg, Gg, Gll^Fp, Gs^Fms, Gg, Gg, Gg, Gll^Fp, Gg, Gg, Gg, Hh, Gs, Gg, Hh, Hh, Gs, Gg, Hh, Gg, Gll^Fp, Gs, Gll^Fp, Gll^Fp, Gg, Gll^Fp, Gs^Fds, Hh^Fms, Gll^Fp, Hh, Hh, Hh, Gll^Fp, Gll^Fp, Rb^Fmw, Gll^Fp, Rb^Fp, Gg
Gs, Gs, Re, Gg, Gg, Gg, Gg, Gg, Gg, Gg, Gg, Gg, Gg, Gg^Efm, Gg, Gg, Gg, Gg, Gg, Gll^Fp, Gll^Fp, Gg, Gg, Gs, Gg, Gg, Hh, Hh^Fp, Gs, Gg, Gs, Gs, Gg, Gs, Gll^Fp, Gs^Fms, Gg, Gll^Fp, Gll^Em, Gll^Fp, Gll^Fp, Hh^Vhh, Gll^Fp, Gll^Fp, Gd^Fmw, Rb^Fmw, Rb^Fmw, Tb^Tf, Rb^Fdw, Gll^Fp
Gs, Gg, Gg, Rp, Gs^Vh, Gg, Re^Gvs, Re^Gvs, Re, Gg^Efm, Gg, Gg, Gs, Gg, Gg, Gg, Gg, Gg, Gll^Fp, Hh^Fp, Hh, Gg, Gs, Gs, Gg, Gg, Gg, Hh, Gll^Fp, Gll^Fp, Gg, Gs, Gs, Gs, Gs, Chr, Gg, Gg, Gll^Fp, Gll^Fp, Gll^Fp, Gg, Chr, Chs, Ss, Rb^Fdw, Rb^Tf, Ss^Tf, Gd^Fmw, Gll^Fp
Gg, Gs, Gg, Re, Gg^Wm, Re^Gvs, Re^Gvs, Re, Gg, Gg, Gg, Gg, Gg, Gg, Gg^Efm, Gg^Efm, Gll^Fp, Gg, Gg, Gg, Hh, Gg, Gg, Gg, Gs, Gg, Gg, Gg, Gg, Gll^Fp, Gs, Gs, Gg, Gg, Gg, Re, Gg, Gs, Gll, Gll^Fp, Gll^Fp, Chr, 2 Khr, Chr, Ss, Sm, Ss, Ss^Emf, Sm, Rb^Fdw
Gg, Gg, Gg^Efm, Re, Gg, Gg, Gs, Gs, Gg, Gg, Re^Gvs, Gs, Gg, Gg, Gll^Fp, Gs, Gs^Fds, Gg, Gs^Fms, Gg, Gg, Gg, Gg, Gg, Gg, Gg, Gg, Gg, Gs, Gg, Gs, Gs, Gs, Gg, Gg, Gg, Gs, Gll, Gll^Fp, Gd^Fp, Rb, Chs, Chr, Chs, Rb, Ss, Ss, Ss, Ss, Ss
Gg, Gg, Gg, Re, Rp, Gg^Efm, Gs, Gs, Re, Re^Gvs, Re^Gvs, Re, Gg^Efm, Gg, Gs^Fms, Gs^Fds, Gs^Fms, Gll^Fp, Gs^Fms, Gll^Fp, Gg, Gg, Gg, Gg, Gg, Gg, Gg, Gg, Gg, Gs, Gs, Gs, Gd, Re^Es, Gg, Gs, Rb^Vhr, Gd, Rb, Rb, Rb^Es, Chs, Rb^Es, Rb^Es, Rb, Ss^Vhs, Rb, Sm, Sm, Ss
Gg, Gg, Gg, Gg, Gg, Rp, Re, Gg, Gg^Wm, Re^Gvs, Gg, Gg, Gg^Efm, Gs^Fms, Gll^Fp, Gg^Fet, Gs^Fds, Gs^Fms, Gs^Fms, Gs^Fms, Gs^Fms, Gg, Gll^Fp, Gg, Gg^Vh, Gll^Fp, Gs, Gg, Gg, Gs, Gs, Gd, Gd, Gs, Chr, Re, Rb, Rb, Sm, Rb^Fetd, Rb^Fdw, Rb, Rb^Fdw, Rb^Fdw, Rb^Fdw, Rb, Sm, Rb^Es, Sm, Ss
Gg, Gg, Gg, Gs^Fms, Gs^Fms, Gs, Gll^Fp, Rp, Rp, Gs^Vh, Re, Gg, Gg^Efm, Gg^Efm, Gs^Fms, Gll^Fp, Gll^Fp, Gs^Fms, Gll^Fp, Gg, Gg, Gg, Gll^Fp, Gg, Gg, Gg^Efm, Gg, Gg, Gg, Gg, Gd, Gd^Es, Gs, Re, Re, Re, Rb^Fdw, Rb^Es, Sm, Sm, Yhs, Yhs^Xp, Yhs, Yhs, Rb^Fetd, Rb^Fdw, Sm, Sm, Ss, Ss
Gg, Gg, Gg^Efm, Gll^Fp, Gg^Fet, Gs^Fds, Gll^Fp, Gg, Gs, Re, Gg, Re, Gs^Vh, Gg, Gll^Fp, Gll^Fp, Gll, Gll^Fp, Gll^Fp, Gll, Gg, Gll^Fp, Gll^Fp, Gg, Gs, Gg, Gg, Gg, Gg, Re, Gd, Gs, Gs, Gd, Gd, Re^Es, Rb^Fdw, Rb^Es, Re, Sm, Sm, Ss^Vhs, Yhs, Yhs^Xp, Yhs, Rb^Fdw, Rb^Fdw, Sm, Ss, Ss
Gg, Gg, Gll^Fp, Gll^Fp, Gs^Fds, Gs^Fms, Gll^Fp, Gg, Gg, Gg, Re, Re^Gvs, Re, Gg, Gg, Gg, Gll^Em, Gll^Fp, Gll^Fp, Gll^Fp, Gll^Fp, Gg, Gll^Fp, Gll^Fp, Gs^Em, Re^Es, Re^Es, Gs, Gd, Gd, Gd, Gs, Gs, Gs, Gd, Gd^Fdw, Gd^Fdw, Gs, Gd, Sm, Sm, Ss, Ss, Ss, Ss, Ss, Ss, Ss, Ss, Ss
Gg, Gg, Gll^Fp, Gs^Fds, Gll, Gll^Fp, Gll^Fp, Gll^Fp, Gg, Re^Gvs, Re^Gvs, Re, Gg, Gg^Efm, Gll^Fp, Gll, Gll^Fp, Gll^Fp, Gll^Fp, Gll^Fp, Gll^Fp, Gll^Fp, Gll^Fp, Gll^Fp, Gll^Fp, Gs, Gs, Gs, Gs, Re^Es, Gs, Gg, Gs, Re, Gd, Gd, Gs, Gs, Gd^Fdw, Rb^Fdw, Rb^Fdw, Sm, Gd^Fdw, Ss, Gd^Fdw, Sm, Ss, Ss, Ss, Ss
Gg, Gg, Gg, Gg, Gg, Gg, Gg, Gll^Fp, Gg, Gg, Gg, Gg, Gll^Fp, Gll^Fp, Gll^Fp, Gll^Fp, Gll^Fp, Gll^Fp, Gll^Fp, Gll^Fp, Gll^Fp, Gll^Fp, Gll^Fp, Gll^Fp, Gg, Gs, Gs, Gs, Gg, Gs, Gg, Gg, Gg, Gs, Re, Gs, Re, Gd^Fdw, Gd^Fdw, Rb^Fdw, Gd^Fdw, Gd^Fdw, Gs, Ss, Gd^Fdw, Gd^Fdw, Gd^Fdw, Ss, Gg, Ss
