border_size=1
usage=map

Gll^Fp, Gll^Fp, Gll^Fp, Gll^Fp, Gs^Fms, Gs^Fds, Gs^Fds, Gll^Fp, Gll^Fp, Gll^Fp, Gg, Gg, Re, Re, Gg, Gll^Fp, Gll^Fp, Gll^Fp, Gs^Fms, Gs^Fds, Gs^Fds, Gll^Fp, Gll^Fp
Gs^Fms, Gs^Fms, Gg^Fet, Gll^Fp, Gs^Fms, Gs^Fds, Gs^Fds, Gs^Fms, Gll^Fp, Gs^Vh, Gg, Gg, Re, Re, Gg, Gll^Fp, Gs^Vh, Gll^Fp, Gll^Fp, Gs^Fms, Gll^Fp, Gll^Fp, Gs^Fms
Gll^Fp, Gs^Fms, Gs^Fms, Gll^Fp, Gs^Fms, Gll^Fp, Ce, Gll^Fp, Gll^Fp, Gg, Gg, Gg, Gg, Re, Re, Gg, Gg, Gg, Gg^Em, Gs^Fms, Gs^Vh, Gll^Fp, Gll^Fp
Gs^Fms, Gs^Fds, Gs^Fms, Gll^Fp, Ce, Ce, Gg, Ce, Ce, Ce, Ce, Ce, Ke, Ce, Ket, Re, Re, Gg, Gll^Fp, Gll^Fp, Gll^Fp, Gll^Fp, Gll^Fp
Gs^Fms, Gs^Fds, Gll^Fp, Ce, Gll^Fp, Gg, Gs^Vct, Gg, Gg, Gs^Fds, Gs^Fms, Gs^Fms, Gg, Gg^Efm, Gg, Re^Es, Re, Gg, Gs, Gs^Fms, Gs^Fms, Gg^Fet, Gll^Fp
Gll^Fp, Gs^Fms, Wwf^Es, Ce, Gg, Re, Re, Re, Gs^Vct, Gg, Gg, Gg, Ce, Gg, Re, Re, Re, Ket, Ce, Gll^Fp, Gs^Fms, Gll^Fp, Gll^Fp
Gll^Fp, Gll^Fp, Wwf, Ww, Gg, Gs^Vct, Re, Re, Re, Gg, Ce, Ce, Ket, Ce, Ce, Re, Gg^Es, Gs, Ket, Gll^Fp, Gll^Fp, Gll^Fp, Gll^Fp
Gll^Fp, Wwf^Es, Ww, Gg, Wwf^Ewf, Gs, Re, Gs^Vct, Gs, Re, Ce, 1 Ket, Ket, 2 Ket, Ce, Re, Re, Gs, Gg, Gll^Fp, Gg, Gg, Gll^Fp
Ww, Ww, Ww, Ww^Ewl, Wwf, Gs^Vct, Re, Gs, Gg^Efm, Re, Re, Ce, Ce, Ce, Re, Re, Gs, Re, Gd, Gg, Gg, Gll^Fp, Gll^Fp
Ww, Ww, Wwf^Ewl, Ww^Ewf, Ww, Gll^Fp, Gll^Fp, Gg, Gg, Re, Re, Gg^Es, Re, Re, Re, Gs^Vct, Gd, Gg, Ket, Re, Gg^Efm, Gg^Efm, Gg
Gll^Fp, Gll^Fp, Gll^Fp, Ww, Ce, Gll^Fp, Gs^Fms, Gg, Gg, Gg^Efm, Re, Re, Re, Re, Gs^Vct, Re, Gd, Gg, Ce, Re, Gg^Efm, Gg, Gll^Fp
Gll^Fp, Gll^Fp, Gll^Fp, Gll^Fp, Ce, Gll^Fp, Ce, Gg, Ket, Gg, Re, Re, Gg, Gg, Gs, Gs, Gg, Ce, Gll^Fp, Re, Re, Gll^Fp, Gll^Fp
Gll^Fp, Gs^Fms, Gs^Fms, Gll^Fp, Gll^Fp, Ce, Gll^Fp, Ce, Gg, Re, Re, Re, Gg, Gll^Fp, Ce, Gll^Fp, Ce, Ce, Gll^Fp, Gll^Fp, Gs^Vh, Gll^Fp, Gll^Fp
Gll^Fp, Gs^Fds, Gs^Fms, Gg^Fet, Gll^Fp, Gll^Fp, Gs^Fms, Gg^Es, Gs, Re, Re, Ket, Ce, Ce, Gll^Fp, Ce, Gll^Fp, Gll^Fp, Gll^Fp, Gll^Fp, Gll^Fp, Gll^Fp, Gll^Fp
Gll^Fp, Gg^Ve, Gs^Fds, Gs^Fms, Gll^Fp, Gll^Fp, Gll^Fp, Gg, Re, Re, Gg, Gs, Gll^Fp, Gll^Fp, Gs^Fds, Gll^Fp, Gs^Fms, Gll^Fp, Gll^Fp, Gg^Fet, Gs^Fds, Gs^Fms, Gll^Fp
Gll^Fp, Gll^Fp, Gs^Fds, Gs^Fms, Gg^Efm, Gs^Fms, Gg, Gg^Efm, Re, Re, Gg^Efm, Gll^Fp, Gll^Fp, Gs^Fms, Gs^Fds, Gll^Fp, Gll^Fp, Gs^Fms, Gs^Fms, Gs^Fds, Gs^Fds, Gs^Fms, Gll^Fp
Gll^Fp, Gll^Fp, Gll^Fp, Gg, Gg, Gg, Re, Re, Gg, Gg, Gll^Fp, Gll^Fp, Gs^Fms, Gs^Fds, Gll^Fp, Gs^Vh, Gll^Fp, Gll^Fp, Gll^Fp, Gs^Fds, Gll^Fp, Gs^Fms, Gll^Fp
