Dd, Rd, Rd, Dd, Dd, Dd, Dd, Dd, Hd, Dd, Dd, Dd, Hd, Dd, Dd, Dd, Ds, Ds, Ds, Dd, Dd, Hd, Mdd, Mdd, Mdd, Mdd, Hd, Hd, Hd, Dd, Dd, Dd, Dd, Dd, Dd, Dd, Dd, Dd, Dd, Dd, Dd, Dd, Dd^Es, Dd, Dd, Dd, Rd, Rd, Dd, Dd, Dd, Dd, Dd, Dd, Ds, Ds, Ds, Dd, Dd, Dd, Dd, Dd
Dd, Dd, Dd^Es, Dd, Rd, Dd, Dd^Edpp, Dd, Hd, Dd, Mdd, Mdd, Hd, Hd, Dd, Ds, Hd, Hd, Hd, Hd, Ds, Hd, Hd, Mdd, Hd, Ds, Dd^Es, Hd, Hd, Dd, Dd, Dd^Edpp, Dd, Dd, Dd, Dd, Dd, Dd, Dd, Dd, Dd, Dd, Dd, Dd, Dd, Dd, Dd, Rd, Dd, Dd, Dd, Dd, Dd, Dd, Dd, Ds^Es, Ds, Ds^Edpp, Dd, Dd, Dd, Dd
Dd, Dd, Dd, Dd, Rd, Dd, Dd, Dd, Dd, Hd, Hd, Hd, Dd, Dd, Dd, Ds, Dd, Mdd, Hd, Dd, Ds, Ds, Ds, Hd, Dd, Ds^Es, Dd, Ds, Hd, Dd, Dd^Vdt, Dd, Dd, Dd^Edpp, Dd, Dd^Edpp, Dd, Dd, Dd, Dd, Dd, Dd, Dd, Dd, Dd, Dd^Edpp, Dd, Dd, Dd, Dd, Dd, Dd, Dd, Dd, Ds, Ds, Dd, Ds, Ds, Dd, Dd, Dd
Dd, Dd, Dd, Dd, Dd, Rd, Rd, Dd, Dd, Hd, Hd, Dd, Dd, Dd, Hd, Hd, Mdd, Mdd, Hd, Dd, Dd, Ds^Dr, Ds, Ds, Ds, Ds, Hd, Dd, Dd, Dd, Dd, Dd, Dd^Edpp, Dd, Dd, Dd, Rd, Rd, Rd, Dd, Dd, Dd, Dd, Dd, Dd, Dd, Dd, Dd, Dd, Dd, Dd, Dd, Dd, Dd, Ds, Dd, Dd, Dd, Dd, Dd, Ds, Dd
Dd, Dd, Dd^Vdt, Dd, Dd, Dd^Vdt, Rd, Dd, Dd, Dd, Dd, Dd, Dd, Dd, Hd, Mdd, Hd, Dd, Dd, Dd, Dd, Dd, Ds, Ds, Rd, Ds, Hd, Dd, Dd, Rd, Rd, Dd, Rd, Dd, Dd, Rd, Rd, Dd, Dd, Dd, Dd, Dd, Dd, Dd, Ds, Dd, Dd, Dd, Ds, Dd, Dd, Rd, Dd, Dd, Dd, Dd, Dd, Hd, Hd, Dd, Ds, Dd
Dd, Gs, Gs, Dd, Ce, Dd, Dd, Rd, Dd, Dd^Es, Dd, Dd, Dd, Dd, Dd, Hd, Dd, Hd, Dd, Dd, Dd, Rd, Rd, Rd, Rd, Rd, Ds, Hd, Hd, Dd, Dd, Rd, Rd, Dd, Dd, Dd, Dd, Dd, Dd, Dd, Dd, Dd, Rd, Dd, Ds, Dd, Ds^Es, Ds, Ds, Ds, Dd, Dd, Dd, Dd, Dd, Dd, Dd, Dd, Hd, Hd, Ds, Dd
Gs, Gs, Gs, Ce, 1 Ke, Ce, Dd, Dd^Vdt, Dd, Dd, Rd, Dd, Rd, Dd, Dd, Dd, Dd, Dd, Dd, Dd^Edpp, Dd, Dd, Ds, Ds, Ds, Ds, Ds, Hd, Hd, Hd, Dd, Dd, Dd, Dd, Dd, Dd, Dd, Dd, Ds, Dd, Rd, Dd, Rd, Dd, Dd, Ds, Ds, Ds, Ds, Ds, Dd, Dd, Dd, Dd, Dd, Dd^Edpp, Hd, Dd, Ds, Hd, Hd, Dd
Gs, Gs, Gs, Ce, Ce, Ce, Ds, Rd, Dd, Rd, Dd, Rd, Rd, Dd, Dd, Dd, Dd, Dd, Dd, Rd, Dd, Ds, Hd, Ds, Ds, Dd, Dd, Ds, Ds, Hd, Dd, Dd, Hd, Dd, Dd, Dd^Edp, Dd, Dd, Ds, Ds, Rd, Rd, Dd, Dd, Ds, Ds, Ds, Ds, Ds, Ds, Dd, Dd^Edp, Dd, Dd, Dd, Hd, Hd, Mdd, Hd, Ds, Hd, Ds
Wwt, Gs, Gs, Gd, Gd, Ds, Dd^Vdt, Dd, Dd, Dd, Ds^Edpp, Ds, Dd, Rd, Dd, Dd, Rd, Rd, Rd, Dd, Dd^Vdt, Ds, Hd, Hd, Hd, Hd, Dd, Ds, Ds, Ds, Ds, Dd, Hd, Dd, Dd, Dd, Dd, Dd, Ds, Ds, Rd, Dd, Dd^Vdt, Ds, Ds, Ds, Dd, Ds, Ds, Ds, Ds^Es, Dd, Dd, Dd, Dd, Hd, Hd, Mdd, Dd, Dd, Ds, Ds
Wot, Wwt, Wwt, Gs, Dd, Dd, Dd, Ds, Ds, Ds, Ds, Dd, Dd, Dd, Ds, Dd, Dd, Dd, Dd, Dd, Dd, Ds, Ds, Hd, Hd, Hd, Dd, Dd, Dd, Dd, Dd, Hd, Mdd, Hd, Hd, Dd, Dd, Rd, Rd^Es, Ds, Ds, Dd, Ds, Ds, Ds, Ds, Dd, Dd, Ds, Ds, Ds, Ds, Dd, Dd, Dd, Dd, Dd, Hd, Dd, Dd^Edp, Ds, Ds
Wwt, Wot, Wot, Wwt^Es, Dd, Dd, Dd, Dd, Ds, Ds, Dd, Ds, Ds, Dd, Ds, Dd, Dd, Dd, Hd, Dd, Dd, Dd, Dd, Ds, Ds, Hd, Dd, Dd, Hd, Dd, Dd, Hd, Hd, Mdd, Hd, Dd, Dd, Rd, Rd, Ds^Es, Dd, Dd, Ds, Ds, Dd, Dd, Dd, Dd, Dd, Ds, Dd, Ds, Ds, Hd, Hd, Dd, Dd, Hd, Hd, Ds, Ds, Dd
Gs, Wwt, Wot, Wot, Wwt, Dd, Wwt, Dd, Wwt, Dd, Dd, Ds, Ds, Ds^Es, Ds, Ds, Ds, Hd, Hd, Hd, Ds, Ds, Dd, Ds, Ds, Dd, Dd, Hd, Hd, Dd, Dd, Dd, Dd, Mdd, Mdd, Hd, Dd, Dd, Dd, Dd, Dd, Dd, Ds, Hd, Hd, Dd, Dd, Dd, Hd, Hd, Dd, Dd, Dd, Hd, Hd, Dd, Dd, Dd, Dd, Ds, Dd^Es, Dd
Gs, Wwt, Wwt, Wot, Wot, Wot, Wot, Wwt, Wwt, Wwt, Dd, Ds, Ds, Ds, Ds, Dd, Ds, Ds, Ds, Hd, Hd, Ds, Dd, Dd, Dd, Dd, Dd, Hd, Hd, Hd, Hd, Dd, Dd, Hd, Dd, Hd, Dd, Dd^Es, Ds, Ds, Rd, Ds^Es, Ds, Hd, Hd, Dd, Dd, Dd, Dd, Hd, Hd, Dd, Dd, Dd, Hd, Hd, Hd, Dd, Dd, Dd, Dd, Dd
Gs, Ds, Ds, Wwt, Wwt, Wwt, Wwt, Wot, Wot, Wwt, Wwt, Dd, Ds, Dd, Ds, Dd, Dd, Ds, Dd, Hd, Hd, Hd, Ds, Dd, Dd, Dd, Dd, Ds, Hd, Hd, Hd, Dd, Dd, Dd, Dd, Hd, Dd, Dd, Ds, Dd, Ds, Ds^Es, Kdr, Hd, Dd^Es, Hd, Dd, Dd, Dd^Es, Hd, Hd, Hd, Ds, Ds, Dd, Hd, Hd, Dd, Dd, Dd, Rd, Rd
Dd, Gs, Ds, Ds, Ds, Ds, Wwt, Wwt, Wwt^Es, Wot, Wot, Wwt, Wwt, Dd, Dd, Dd, Dd, Dd, Dd, Dd, Dd, Hd, Ds, Dd, Dd, Dd, Dd, Ds, Ds, Hd, Hd, Hd, Dd, Dd, Dd, Dd, Dd^Vdt, Ds, Dd^Es, Rd^Es, Ds, Cd, Cdr, Dd^Dr, Dd^Vct, Hd, Hd, Dd, Dd, Dd, Dd, Hd, Ds, Dd, Dd, Dd, Dd, Hd, Dd, Dd, Rd, Dd
Dd, Dd, Dd, Dd^Es, Dd, Ds, Gd, Gd, Wwf, Wwt, Wwt, Wot, Wwt, Dd, Dd, Dd, Dd, Dd, Dd, Dd^Es, Dd, Ds, Ds, Dd, Hd, Hd, Hd, Ds, Dd, Ds, Ds, Hd, Dd, Ds, Ds, Dd, Dd, Dd, Dd, Rd, Ds, Dd^Es, Dd, Dd^Es, Dd, Dd, Dd, Dd, Dd, Dd^Edpp, Dd^Edp, Ds, Hd, Hd, Hd, Dd, Dd, Dd, Dd, Dd, Dd, Dd
Hd, Dd, Hd, Dd, Ds, Ds, Dd, Gd, Gs, Wwf^Es, Wwt, Wot, Wot, Wwt, Gs, Rd, Dd, Hd, Hd, Hd, Dd, Dd, Dd, Dd, Dd, Hd, Hd, Ds, Dd, Ds, Ds, Dd, Dd, Ds, Ds, Dd, Dd, Dd^Vct, Dd^Edp, Dd, Dd, Rd, Rd, Dd, Rd, Dd, Dd, Dd, Rd, Dd, Dd, Dd, Hd, Hd, Hd, Hd, Hd, Dd, Hd, Dd, Dd, Dd
Hd, Hd, Dd, Dd, Dd, Dd, Dd, Ds, Gs, Wwf^Es, Wwt, Wot, Wot, Wwt, Gd, Rd, Dd, Hd, Hhd, Hd, Hd, Dd, Dd, Dd, Dd, Hd, Ds, Dd, Dd, Dd, Dd, Dd, Dd, Dd, Dd, Ds, Ds, Dd, Dd, Dd^Edp, Dd, Rd, Rd, Dd, Hd, Dd, Dd, Rd, Rd, Dd, Ds, Dd, Dd, Hd, Hd, Mdd, Hd, Dd, Hd, Hd, Hd, Dd
Hd, Hd, Ds, Dd, Gs, Gs, Ds, Ds, Wwt, Wwt, Wot, Wot, Wwt, Gs, Gs, Dd, Hhd, Hhd, Hhd, Hd, Hd, Dd, Dd, Hd, Hd, Ds, Ds, Dd, Hd, Dd, Ds, Dd, Dd, Dd^Edp, Dd, Dd, Dd, Dd, Dd, Dd, Dd, Dd, Dd, Dd, Hd, Hd, Ds, Dd, Dd, Rd, Ds, Dd, Hd, Dd, Hd, Hd, Hd, Dd, Dd, Hd, Hd, Dd
Dd, Dd, Ds, Ds, Gs, Ds, Ds, Wwt, Wot, Wot, Wwt, Wwt, Gd, Gs, Gs, Gd, Hhd, Md, Hhd, Hhd, Hd, Hd, Dd, Hd, Hd, Ds, Dd, Dd, Hd, Ds, Ds, Dd, Dd, Dd, Hd, Dd, Dd, Dd, Dd, Hd, Dd, Hd, Dd, Hd, Dd, Hd, Ds, Dd^Edp, Dd, Rd, Ds, Hd, Hd, Dd, Dd, Dd, Ds, Ds, Rd, Dd, Hd, Hd
Dd, Dd, Ds, Ds, Gs, Ds, Wwt^Es, Wot, Wwt, Wwt, Wwf, Gs, Hhd, Hhd, Hhd, Hhd, Md, Md, Md, Hhd, Hd, Hd, Hd, Hd, Hd, Ds, Dd, Hd, Hd, Hd, Hd, Dd, Dd, Dd, Dd, Hd, Hd, Dd, Dd, Hd, Hd, Hd, Hd, Hd, Dd, Ds, Ds, Ds, Rd, Ds, Ds, Hd, Hd, Ds, Ds, Ds^Es, Rd, Ds, Dd, Dd, Dd, Hd
Dd, Ds, Dd, Gs, Gs, Gs, Gd, Wot, Wot, Wwf^Es, Wwf, Gd, Gd, Hhd, Hhd, Md, Hhd, Md, Md, Hhd, Hhd, Hd, Hd, Hd, Dd, Dd, Dd, Ds, Ds, Hd, Dd, Dd, Dd, Ds, Ds, Hd, Hd, Hd, Hd, Dd, Hd, Hhd, Hhd, Hd, Dd, Ds, Hd, Ds, Ds, Rd, Ds, Ds, Hd, Hd, Ds, Rd, Rd, Dd, Hd, Hd, Hd, Dd
Hd, Dd, Dd, Ds, Dd, Gd, Gd, Wwt, Wot, Wwt, Wwf^Es, Gs, Gs, Gs, Hhd, Md, Gd, Hhd, Hhd, Md, Hhd, Hd, Hd, Hd, Dd, Ds, Dd, Dd, Ds, Dd, Dd, Dd, Hd, Hd, Dd, Ds, Dd, Hd, Dd, Dd, Hhd, Hhd, Dd, Dd, Hd, Dd, Hd, Hd, Ds, Rd, Ds, Ds, Ds, Hd, Ds, Rd, Dd, Dd, Hd, Hd, Mdd, Dd
Hd, Dd, Dd, Ds, Dd, Gd, Gd, Wwt, Wot, Wot, Wot, Wwf^Es, Gg, Gs, Gs, Hhd, Gs, Gs, Gs, Hhd, Gd, Ds, Ds, Ds, Gd, Ds, Ds, Ds, Ds, Dd, Dd, Dd, Hd, Hd, Hd, Ds, Hd, Hhd, Hhd, Hhd, Md, Hhd, Dd, Dd, Hd, Hd, Dd, Hd, Dd, Ds^Es, Ds, Ds, Dd^Vdt, Dd, Dd, Dd, Dd, Hd, Hd, Mdd, Mdd, Hd
Hhd, Hd, Dd, Ds^Es, Ds, Gs, Gs, Gs, Wwt, Wot, Wot, Wwt, Wwt, Gs, Gs, Hhd, Gs, Gs, Hhd, Hhd, Hhd, Ds, Ds, Rd, Dd, Gd, Ds, Ds, Ds, Gd, Ds, Ds, Hd, Hd, Hd, Md, Hhd, Hhd, Hhd, Md, Md, Hhd, Hhd, Hhd, Hhd, Hhd, Dd, Hd, Ds, Ds^Es, Rd, Ds, Ds, Dd, Dd, Dd, Hd, Dd, Hd, Mdd, Mdd, Mdd
Hhd, Hd, Hd, Dd, Dd, Ds, Gs, Gs, Ds, Wwt, Wwt, Wot, Wot, Wwt, Wwt, Gs, Wwt^Es, Wwf, Gs, Gs, Gs, Gd, Ds, Dd, Gs, Gs, Gd, Dd, Dd, Ds, Ds, Ds, Hhd, Hd, Hhd, Md, Md, Md, Md, Md, Hhd, Hhd, Md, Md, Hhd, Hd, Hd, Dd, Ds, Dd, Rd, Ds^Es, Dd, Hd, Hd, Hd, Dd, Hd, Hd, Mdd, Mdd, Mdd
Hd, Hhd, Hd, Ds, Dd, Ds, Ds, Gs, Ds, Ds, Gs, Wot, Wot, Wot, Wot, Wwt, Wwt, Gs, Wwt, Gs, Gs, Gs, Gs, Gs, Gs, Gs, Gs, Dd, Gs, Gs, Gs, Gs, Hhd, Hhd, Hhd, Hhd, Hhd, Md, Md, Md, Md, Hhd, Md, Md, Hd, Hd, Hd, Dd, Dd, Rd, Rd, Ds, Dd, Hd, Hd, Dd, Dd, Dd, Dd, Hd, Hd, Hd
Hd, Hd, Hd, Hd, Hd, Dd, Ds, Dd, Dd, Gs, Gs, Wwt, Wwt, Wwt, Wwt, Wot, Wot, Wwt, Wot, Wwt, Wot, Wwt, Wwt, Wwt, Wwt, Wwt, Wwt, Gs, Wwt, Gs, Wwt, Gs, Gs, Hhd, Gd, Gd, Hhd, Hhd, Md, Md, Md, Md, Hhd, Hhd, Dd, Hd, Hd, Dd, Dd, Rd, Dd, Dd, Dd, Hd, Dd, Hd, Dd^Es, Dd, Dd, Hd, Dd, Hd
Hd, Hd, Hd, Hd, Hd, Hd, Dd, Dd, Dd, Dd, Dd, Gs, Ds, Gd, Ds, Wwt, Wwt, Wot, Wwt, Wot, Wwt, Wot, Wot, Wot, Wot, Wwt, Wot, Wwt, Wot, Wot, Wot, Wwt, Wwt, Gs, Gs, Gd, Hhd, Hhd, Md, Md, Md, Md, Hhd, Dd, Ds, Hd, Dd, Dd, Dd, Rd, Rd, Dd, Dd^Vo, Dd, Dd, Dd^Edpp, Dd, Dd^Edpp, Dd, Dd, Dd, Dd
Hd, Hd, Hd, Hd, Dd, Hd, Dd, Dd^Edp, Dd, Dd, Dd, Ds, Ds, Dd, Dd, Wwt, Gd, Wwt, Wwt, Wwt, Gd, Wwt, Wwt, Wwt, Wwt, Wot, Wwt, Wot, Wwt, Wwt, Wwt, Wot, Wwt, Gs, Dd, Gd, Gd, Hhd, Hhd, Md, Md, Hhd, Hhd, Dd, Ds, Dd, Dd, Dd, Dd, Dd, Dd^Edpp, Rr, Rr, Dd, Dd, Dd, Dd, Dd, Dd, Dd, Dd^Es, Dd
Hd, Hd, Hd, Hd, Hd, Dd, Dd, Dd, Hd, Dd, Dd, Dd^Es, Dd, Dd, Hd, Dd, Gd, Gs, Gs, Ds, Ds, Gd, Gs, Gs, Gd, Wwt^Es, Gs, Wwt, Gs, Wwt, Wwt, Wot, Wot, Gs, Dd, Dd, Gd, Gd, Hhd, Hhd, Hhd, Hhd, Hhd, Dd, Ds, Dd^Vo, Ds, Dd, Co, Dd, Dd^Vda, Dd, Rr, Rd, Dd^Vda, Dd, Dd, Co, Co, Dd, Dd, Dd
Hhd, Hhd, Hd, Hd, Hd, Hd, Dd, Dd, Dd^Es, Dd, Hd, Hd, Dd, Hd, Dd, Dd, Dd, Dd, Dd, Ds, Ds, Ds, Ds, Ds, Ds, Gs, Gs, Gs, Gd, Gs, Wwf, Wwt, Wot, Wwt, Dd, Dd, Dd, Hhd, Hhd, Hhd, Hhd, Hhd, Hhd, Ds, Ds, Ds, Ds, Ko, Co, Dd, Rr, Rr, Rr, Rd, Dd, Dd, Rr, Ko, Dd, Dd, Dd, Dd
Md, Hhd, Hhd, Hd, Hd, Hd, Hd, Dd, Dd^Es, Hd, Hd, Hd, Hd, Hd, Hd, Hd, Hd, Hd, Hd, Dd, Dd^Edp, Dd, Dd, Ds, Dd, Gs, Dd, Gs, Dd, Gs, Wwf, Wwt, Wot, Wwt, Dd, Gs, Hhd, Hhd, Hhd, Hhd, Ds, Hhd, Hhd, Dd, Dd, Dd^Vdt, Dd, Co, Rd, Rr, Rd, Rd, Rr, Rr, Rr, Rr, Dd^Vdt, Dd, Dd, Dd, Dd, Dd
Md^Xm, Md^Xm, Md, Hhd, Hhd, Hd, Dd, Dd^Edp, Dd, Hd, Hd, Hd, Hd, Hd, Mdd, Hd, Hd, Hd, Dd, Dd, Dd, Dd, Gd, Dd, Dd, Dd, Dd, Ds, Dd, Gs, Gs, Wwt, Wot, Wwt, Wwt, Gs, Gs, Hhd, Hhd, Ds, Gd, Ds, Gd, Gd, Dd, Ds, Gd, Gd, Rr, Rr, Gd, Re, Co, Co, Co, Rr, Rr, Dd, Dd, Hd, Hd, Dd
Md^Xm, Md^Xm, Md, Hhd, Hhd, Dd, Dd, Dd, Hd, Hd, Hd, Hd, Mdd^Xm, Mdd, Hd, Hd, Hd, Hd, Dd, Dd, Dd, Dd, Dd, Dd, Dd^Es, Dd, Dd, Ds, Dd, Dd, Wwf^Es, Wwf^Es, Wwt, Wot, Wwt, Wwf, Wwf, Gd, Gd, Ds, Gd, Ds, Gd, Gd, Gd, Gs, Wwf, Gd, Rr, Gs, Gd, Re, Co, Co, 3 Ko, Co, Rr, Dd, Dd, Hd, Hd, Hd
Md^Xm, Md^Xm, Md, Md, Hhd, Hd, Dd, Dd, Hd, Hd, Mdd, Mdd, Mdd, Mdd, Mdd, Hd, Hd, Hd, Hd, Hd, Hd, Dd, Dd, Dd, Ds, Dd, Hd, Dd, Dd^Edp, Dd, Wwf^Es, Wwf^Es, Wwt, Wot, Wot, Wwt, Wwf, Gs, Gs, Wwf^Es, Gd, Gs, Gd, Gd, Gd, Wwf, Wwf^Es, Wwt^Es, Wwt^Bw|r, Wwt, Wwt, Re, Wwt, Co, Co, Co, Re, Rr, Dd, Hd, Hd, Hd
Md, Md, Hhd, Hhd, Hd, Hd, Dd, Dd, Hd, Hd, Hd, Mdd, Mdd, Mdd, Mdd, Hd, Hd, Hd, Hd, Hd, Hd, Hd, Dd, Ds, Dd, Dd, Hd, Dd^Edp, Dd^Edp, Dd, Ds, Ds, Ds, Wwt, Wot, Wwt, Wwt, Gs, Wwt, Wwf, Wwf, Gd, Gd, Gd, Wwt, Wwt, Wwt, Wwt, Wwt^Bw|, Wwt, Wwt, Wwt, Wot, Wwt, Wwt, Re, Re, Rr, Gs, Dd, Dd, Dd
Md, Hhd, Hhd, Hhd, Hd, Hd, Hd, Dd, Hd, Hd, Hd, Hd, Hd, Mdd, Mdd^Xm, Hd, Hd, Hd, Mdd, Mdd, Hd, Hd, Hd, Hd, Dd, Dd, Hd, Dd, Dd, Ds, Hd, Ds, Ds, Wwt, Wwt, Wot, Wot, Wot, Wot, Wwt, Wwt, Wwt, Wwt, Wwt, Wot, Wwt, Wwt, Wwt, Gs, Wwt, Wwt, Wwt, Wwt, Wot, Wot, Wwt, Gs, Rr, Gs, Dd, Dd, Dd
Md, Hhd, Hhd, Hhd, Hhd, Hd, Hd, Dd, Dd, Hd, Hd, Hd, Mdd, Mdd, Mdd, Mdd, Hd, Hd, Mdd, Mdd, Hd, Hd, Dd, Dd, Dd, Hhd, Hhd, Hd, Hd, Ds, Hd, Ds, Dd, Gs, Gs, Wwt, Wwt, Wot, Wot, Wot, Wot, Wot, Wot, Wot, Wwt, Wwt, Wwt, Wwt, Gs, Gs, Re, Rb, Rb, Wwt, Wwt, Wwt, Wwt^Bw/r, Rr, Gd, Gd, Dd^Edpp, Dd
Md, Md, Md, Md^Xm, Md^Xm, Hhd, Md, Md, Hhd, Hd, Hd, Hd, Hd, Hd, Hd, Hd, Hd, Hd, Hd, Hd, Hd, Dd, Dd, Dd^Edp, Dd, Hhd, Hd, Hd, Hd, Hd, Hhd, Hhd, Gd, Gd, Hhd, Gs, Gs, Wwt, Gs, Wwt, Wwt, Wwt, Wwt, Wwt, Cdr, Gs, Gd, Re, Gd, Gd, Rd, Re, Rb, Wwt, Wwt^Bw/r, Wwt^Bw/r, Wwt, Wwt, Wwt^Es, Gd, Dd, Dd
Md, Md, Md, Md, Md, Md^Xm, Md^Xm, Md, Hhd, Hhd, Hd, Hd, Hd, Hd, Hd, Hd, Dd, Hd, Hd, Hd, Hd, Dd, Dd, Dd, Dd, Hd, Hd, Hd, Hd, Hd, Hhd, Gd, Gd, Hhd, Hhd, Gs, Gs, Gd, Gs, Gs, Gd, Gs, Dd, Dd, Cd, Dd, Gd, Gd, Co, Gs, Rr, Rr, Rr, Rr, Wwt, Wwt, Wot, Wot, Wwt, Gs, Gd, Dd
Md, Md^Xm, Md, Md, Mv, Md, Md, Hhd, Hhd, Hd, Md, Hhd, Hhd, Hd, Hd, Hd, Hd, Hd, Hhd, Hd, Hd, Hd, Dd, Dd^Edp, Dd, Hd, Hd, Hhd, Hd, Hd, Hhd, Hhd, Hhd, Hhd, Hhd, Hhd, Hhd, Hhd, Hhd, Gd, Gd, Gd, Cdr, Cd, Dd, Dd, Rd, Co, 2 Ko, Co, Rr, Dd^Vo, Dd, Gd, Re, Wwt, Wwt, Wot, Wwt, Gd, Gd, Dd
Hhd, Md, Md, Md, Md, Md, Md, Md^Xm, Md^Xm, Hhd, Md, Hhd, Hhd, Hd, Hd, Hd, Hhd, Md, Md, Hhd, Hd, Hd, Dd, Dd, Dd, Dd, Hd, Dd, Dd, Dd, Dd, Dd, Hhd, Hhd, Hhd, Hhd, Md, Hhd, Hhd, Hhd, Dd^Es, Dd, Dd, Dd, Dd, Dd^Vo, Dd, Co, Co, Co, Dd, Rr, Gd, Gd, Cdr, Re, Gd, Wwt, Wot, Wwt, Wwt, Gd
Hhd, Hhd, Hhd, Md, Hhd, Hhd, Hhd, Md^Xm, Md, Md, Md, Md, Md^Xm, Hhd, Hhd, Hhd, Md, Md, Md, Hhd, Hd, Dd, Hd, Dd, Dd, Hd, Dd, Dd, Hd, Hd, Dd^Edp, Dd, Hhd, Hhd, Md, Md, Md, Md, Hhd, Hhd, Dd, Dd, Dd^Es, Dd, Dd^Vda, Dd, Rr, Rr, Dd, Dd, Dd, Rr, Rr, Re, Re, Cdr, Gd, Wwt, Wwt, Wot, Wwt, Gd
Md, Hhd, Md, Md^Xm, Md^Xm, Md^Xm, Md, Md^Xm, Md, Md, Md, Md, Md, Md, Md, Md, Hhd, Md, Md, Hhd, Md, Hhd, Hd, Hd, Dd, Dd, Dd^Es, Dd, Hd, Hd, Dd, Dd, Hhd, Hhd, Md, Md, Md, Md, Md, Hhd, Hhd, Dd, Dd, Dd, Rd, Rd, Dd, Dd^Vdt, Dd, Dd, Dd, Dd^Vda, Dd^Edpp, Rd, Rd, Rd, Gd, Gd, Wwt, Wot, Wot, Wwt
Md, Md, Md, Md^Xm, Md^Xm, Md^Xm, Md, Md^Xm, Md, Md, Md, Md, Hhd, Hhd, Hhd, Md, Md, Hhd, Md, Md, Hhd, Hhd, Hd, Hd, Dd, Dd, Dd, Hd, Dd, Hd, Dd, Dd, Hhd, Hhd, Md, Md, Md, Md, Md, Hhd, Hhd, Dd, Dd, Dd, Dd, Dd^Vda, Dd, Dd, Dd, Dd, Dd, Dd, Rd, Rr, Rr, Rd, Gd, Gd, Gd, Wwt, Wwt, Wot
Md, Md, Md, Md, Md, Hhd, Hhd, Md, Md, Md, Md, Hhd, Hhd, Hhd, Hhd, Md, Hhd, Hhd, Hhd, Hhd, Dd, Hhd, Hd, Hd, Hd, Hd, Dd, Dd, Hd, Hd, Dd, Hhd, Hhd, Hhd, Md, Md, Md, Md, Md, Md, Md, Hhd, Hhd, Hhd, Dd, Dd, Dd, Dd, Dd, Dd^Es, Dd, Dd, Re, Rd, Rr, Rr, Re, Gd, Gd, Gd, Gd, Wwt
