Dd, Rd, Rd, Dd, Dd, Dd, Dd, Dd, Hd, Dd, Dd, Dd, Hd, Dd, Dd, Dd, Ds, Ds, Ds, Dd, Dd, Hd, Mdd, Mdd, Mdd, Mdd, Hd, Hd, Hd, Dd, Dd, Dd, Dd, Dd, Dd, Dd, Dd, Dd, Dd, Dd, Dd, Dd, Dd^Es, Dd, Dd, Dd, Rd, Rd, Dd, Dd, Dd, Dd, Dd, Dd, Ds, Ds, Ds, Dd, Dd, Dd, Dd, Dd
Dd, Dd, Dd^Es, Dd, Rd^Esd, Dd, Dd^Edpp, Dd, Hd, Dd, Mdd, Mdd, Hd, Hd, Dd, Ds, Hd, Hd, Hd, Hd, Ds, Hd, Hd, Mdd, Hd, Ds, Dd^Es, Hd, Hd, Dd, Dd, Dd^Edpp, Dd, Dd, Dd, Dd, Dd, Dd, Dd, Dd, Dd, Dd, Dd, Dd, Dd, Dd, Dd, Rd, Dd, Dd, Dd, Dd, Dd, Dd, Dd, Ds^Es, Ds, Ds^Edpp, Dd, Dd, Dd, Dd
Dd, Dd, Dd, Dd, Rd^Esd, Dd^Esd, Dd, Dd, Dd, Hd, Hd, Hd, Dd, Dd, Dd^Esd, Ds, Dd, Mdd, Hd, Dd, Ds, Ds, Ds^Edt, Hd, Dd, Ds^Es, Dd, Ds, Hd, Dd, Dd^Vdt, Dd, Dd, Dd^Edpp, Dd, Dd^Edpp, Dd, Dd, Dd, Dd, Dd, Dd, Dd, Dd, Dd, Dd^Edpp, Dd, Dd, Dd, Dd, Dd, Dd, Dd, Dd, Ds, Ds, Dd, Ds, Ds, Dd, Dd, Dd
Dd, Dd, Dd, Dd, Dd, Rd^Esd, Rd^Esd, Dd^Esd, Dd, Hd, Hd, Dd, Dd, Dd, Hd, Hd, Mdd, Mdd, Hd, Dd, Dd^Esd, Ds^Dr, Ds^Edt, Ds^Edt, Ds, Ds, Hd, Dd, Dd, Dd, Dd, Dd, Dd^Edpp, Dd, Dd, Dd, Rd^Esd, Rd, Rd, Dd, Dd, Dd, Dd, Dd, Dd, Dd, Dd, Dd, Dd, Dd, Dd, Dd, Dd, Dd, Ds^Esd, Dd, Dd, Dd, Dd, Dd, Ds, Dd
Dd^Esd, Dd, Dd^Vdt, Dd, Dd, Dd^Vdt, Rd, Dd, Dd, Dd, Dd, Dd, Dd, Dd, Hd, Mdd, Hd, Dd, Dd, Dd, Dd, Dd^Esd, Ds, Ds^Esd, Rd, Ds, Hd, Dd, Dd, Rd, Rd^Esd, Dd, Rd, Dd, Dd, Rd, Rd, Dd, Dd, Dd, Dd, Dd, Dd, Dd, Ds, Dd, Dd, Dd, Ds, Dd, Dd, Rd, Dd, Dd, Dd, Dd, Dd, Hd, Hd, Dd, Ds, Dd
Dd, Gs^Esd, Gs, Dd, Ce, Dd, Dd, Rd^Esd, Dd, Dd^Es, Dd, Dd, Dd, Dd, Dd, Hd, Dd, Hd, Dd, Dd, Dd, Rd, Rd, Rd, Rd, Rd, Ds, Hd, Hd, Dd, Dd, Rd^Esd, Rd, Dd, Dd, Dd, Dd, Dd, Dd, Dd, Dd, Dd, Rd^Esd, Dd, Ds, Dd, Ds^Es, Ds, Ds, Ds, Dd, Dd, Dd, Dd, Dd, Dd, Dd, Dd, Hd, Hd, Ds, Dd
Gs, Gs^Esd, Gs, Ce, 1 Ke, Ce, Dd, Dd^Vdt, Dd, Dd, Rd^Esd, Dd, Rd^Esd, Dd, Dd, Dd, Dd, Dd, Dd, Dd^Edpp, Dd, Dd^Esd, Ds, Ds, Ds, Ds, Ds, Hd, Hd, Hd, Dd, Dd, Dd, Dd, Dd, Dd, Dd, Dd, Ds, Dd, Rd, Dd, Rd, Dd, Dd, Ds, Ds, Ds, Ds, Ds, Dd, Dd, Dd, Dd, Dd, Dd^Edpp, Hd, Dd, Ds, Hd, Hd, Dd
Gs, Gs, Gs, Ce, Ce, Ce, Ds, Rd^Esd, Dd, Rd^Esd, Dd, Rd, Rd, Dd, Dd^Esd, Dd, Dd, Dd, Dd, Rd^Esd, Dd, Ds, Hd, Ds, Ds, Dd, Dd, Ds, Ds, Hd, Dd, Dd, Hd, Dd, Dd, Dd^Edp, Dd, Dd, Ds, Ds, Rd^Esd, Rd, Dd, Dd, Ds, Ds, Ds, Ds, Ds, Ds, Dd, Dd^Edp, Dd, Dd, Dd, Hd, Hd, Mdd, Hd, Ds, Hd, Ds
Wwt, Gs, Gs, Gd, Gd, Ds, Dd^Vdt, Dd, Dd^Esd, Dd, Ds^Edpp, Ds, Dd, Rd^Esd, Dd, Dd, Rd, Rd^Esd, Rd^Esd, Dd, Dd^Vdt, Ds, Hd, Hd, Hd, Hd, Dd, Ds, Ds, Ds, Ds, Dd, Hd, Dd, Dd, Dd, Dd, Dd, Ds, Ds, Rd, Dd, Dd^Vdt, Ds, Ds, Ds, Dd, Ds^Esd, Ds, Ds, Ds^Es, Dd, Dd, Dd, Dd, Hd, Hd, Mdd, Dd, Dd, Ds, Ds
Wot, Wwt, Wwt, Gs, Dd^Esd, Dd, Dd, Ds, Ds, Ds, Ds, Dd, Dd, Dd, Ds, Dd, Dd, Dd, Dd, Dd, Dd, Ds, Ds, Hd, Hd, Hd, Dd, Dd, Dd, Dd, Dd, Hd, Mdd, Hd, Hd, Dd, Dd, Rd^Esd, Rd^Es, Ds, Ds, Dd^Edt, Ds, Ds, Ds, Ds, Dd, Dd, Ds, Ds, Ds, Ds, Dd, Dd, Dd, Dd, Dd, Hd, Dd, Dd^Edp, Ds, Ds
Wwt, Wot, Wot, Wwt^Es, Dd, Dd, Dd, Dd, Ds, Ds, Dd, Ds, Ds, Dd^Esd, Ds, Dd, Dd^Esd, Dd, Hd, Dd, Dd, Dd, Dd, Ds, Ds, Hd, Dd, Dd, Hd, Dd, Dd, Hd, Hd, Mdd, Hd, Dd, Dd, Rd, Rd^Esd, Ds^Es, Dd, Dd, Ds, Ds, Dd, Dd, Dd, Dd, Dd, Ds, Dd, Ds, Ds, Hd, Hd, Dd, Dd, Hd, Hd, Ds, Ds, Dd
Gs, Wwt, Wot, Wot, Wwt, Dd, Wwt, Dd, Wwrt, Dd, Dd, Ds, Ds, Ds^Es, Ds, Ds, Ds, Hd, Hd, Hd, Ds, Ds, Dd, Ds, Ds, Dd, Dd, Hd, Hd, Dd, Dd, Dd, Dd, Mdd, Mdd, Hd, Dd, Dd, Dd, Dd, Dd, Dd, Ds, Hd, Hd, Dd, Dd, Dd, Hd, Hd, Dd, Dd, Dd, Hd, Hd, Dd, Dd, Dd, Dd, Ds, Dd^Es, Dd
Gs, Wwt, Wwt, Wot, Wot, Wot, Wot, Wwt, Wwt, Wwt, Dd, Ds, Ds, Ds, Ds, Dd, Ds, Ds, Ds, Hd, Hd, Ds, Dd, Dd, Dd, Dd, Dd, Hd, Hd, Hd, Hd, Dd, Dd, Hd, Dd, Hd, Dd, Dd^Es, Ds, Ds, Rd^Esd, Ds^Es, Ds, Hd, Hd, Dd, Dd, Dd, Dd, Hd, Hd, Dd, Dd, Dd, Hd, Hd, Hd, Dd, Dd, Dd, Dd, Dd
Gs, Ds, Ds, Wwt, Wwt, Wwt, Wwt, Wot, Wot, Wwt, Wwt, Dd, Ds, Dd, Ds, Dd, Dd, Ds, Dd, Hd, Hd, Hd, Ds, Dd, Dd, Dd, Dd, Ds, Hd, Hd, Hd, Dd, Dd, Dd, Dd, Hd, Dd^Edt, Dd, Ds, Dd^Edt, Ds^Edt, Ds^Es, Kdr, Hd, Dd^Es, Hd, Dd, Dd, Dd^Es, Hd, Hd, Hd, Ds, Ds, Dd, Hd, Hd, Dd, Dd, Dd, Rd, Rd
Dd, Gs, Ds, Ds, Ds, Ds, Wwt^Ewl, Wwt, Wwt^Es, Wot, Wot, Wwrt, Wwrt, Dd, Dd, Dd, Dd, Dd, Dd, Dd, Dd, Hd, Ds, Dd, Dd, Dd, Dd, Ds, Ds, Hd, Hd, Hd, Dd, Dd, Dd, Dd, Dd^Vdt, Ds, Dd^Es, Rd^Es, Ds^Edt, Cd, Cdr, Dd^Dr, Dd^Vct, Hd, Hd, Dd, Dd, Dd, Dd, Hd, Ds, Dd, Dd, Dd, Dd, Hd, Dd, Dd, Rd, Dd
Dd, Dd, Dd, Dd^Es, Dd, Ds, Gd, Gd, Wwf, Wwt, Wwt, Wot, Wwt, Dd, Dd, Dd, Dd, Dd, Dd, Dd^Es, Dd, Ds, Ds, Dd, Hd, Hd, Hd, Ds, Dd, Ds, Ds, Hd, Dd, Ds, Ds, Dd, Dd^Edt, Dd, Dd, Rd^Esd, Ds, Dd^Es, Dd, Dd^Es, Dd^Edt, Dd, Dd, Dd, Dd, Dd^Edpp, Dd^Edp, Ds, Hd, Hd, Hd, Dd, Dd, Dd, Dd, Dd, Dd, Dd
Hd, Dd, Hd, Dd, Ds, Ds, Dd, Gd, Gs, Wwf^Es, Wwt, Wot, Wot, Wwt, Gs, Rd, Dd, Hd, Hd, Hd, Dd, Dd, Dd, Dd, Dd, Hd, Hd, Ds, Dd, Ds^Esd, Ds, Dd, Dd, Ds, Ds^Esd, Dd, Dd^Edt, Dd^Vct, Dd^Edp, Dd, Dd, Rd^Esd, Rd, Dd^Edt, Rd^Esd, Dd^Edt, Dd, Dd, Rd^Esd, Dd, Dd, Dd, Hd, Hd, Hd, Hd, Hd, Dd, Hd, Dd, Dd, Dd
Hd, Hd, Dd, Dd, Dd, Dd, Dd, Ds, Gs, Wwf^Es, Wwt, Wot, Wot, Wwt, Gd, Rd, Dd, Hd, Hhd, Hd, Hd, Dd, Dd, Dd, Dd, Hd, Ds, Dd, Dd, Dd, Dd, Dd, Dd, Dd, Dd, Ds, Ds, Dd^Edt, Dd, Dd^Edp, Dd, Rd^Esd, Rd^Esd, Dd, Hd, Dd, Dd, Rd, Rd, Dd, Ds, Dd, Dd, Hd, Hd, Mdd, Hd, Dd, Hd, Hd, Hd, Dd
Hd, Hd, Ds, Dd, Gs, Gs^Esd, Ds, Ds, Wwt, Wwt, Wot, Wot, Wwt, Gs, Gs, Dd, Hhd, Hhd, Hhd, Hd, Hd, Dd, Dd, Hd, Hd, Ds, Ds, Dd, Hd, Dd, Ds, Dd, Dd, Dd^Edp, Dd, Dd, Dd, Dd, Dd, Dd, Dd, Dd, Dd, Dd, Hd, Hd, Ds, Dd, Dd, Rd^Esd, Ds, Dd, Hd, Dd, Hd, Hd, Hd, Dd, Dd, Hd, Hd, Dd
Dd, Dd, Ds, Ds, Gs^Esd, Ds, Ds, Wwt, Wot, Wot, Wwt, Wwt, Gd, Gs, Gs, Gd, Hhd, Md, Hhd, Hhd, Hd, Hd, Dd, Hd, Hd, Ds, Dd, Dd, Hd, Ds, Ds, Dd, Dd, Dd, Hd, Dd, Dd, Dd, Dd, Hd, Dd, Hd, Dd, Hd, Dd, Hd, Ds, Dd^Edp, Dd, Rd, Ds, Hd, Hd, Dd, Dd, Dd, Ds, Ds, Rd^Esd, Dd, Hd, Hd
Dd, Dd, Ds, Ds, Gs, Ds, Wwt^Es, Wot, Wwt, Wwt, Wwf, Gs, Hhd, Hhd, Hhd, Hhd, Md, Md, Md, Hhd, Hd, Hd, Hd, Hd, Hd, Ds, Dd, Hd, Hd, Hd, Hd, Dd, Dd, Dd, Dd, Hd, Hd, Dd, Dd, Hd, Hd, Hd, Hd, Hd, Dd, Ds, Ds, Ds, Rd^Esd, Ds, Ds, Hd, Hd, Ds, Ds, Ds^Es, Rd, Ds, Dd, Dd, Dd, Hd
Dd, Ds, Dd, Gs, Gs, Gs, Gd, Wot, Wot, Wwf^Es, Wwf, Gd, Gd, Hhd, Hhd, Md, Hhd, Md, Md, Hhd, Hhd, Hd, Hd, Hd, Dd, Dd, Dd, Ds, Ds, Hd, Dd, Dd, Dd, Ds, Ds, Hd, Hd, Hd, Hd, Dd, Hd, Hhd, Hhd, Hd, Dd, Ds, Hd, Ds, Ds, Rd^Esd, Ds, Ds, Hd, Hd, Ds, Rd, Rd^Esd, Dd, Hd, Hd, Hd, Dd
Hd, Dd, Dd, Ds, Dd, Gd, Gd, Wwt, Wot, Wwt, Wwf^Es, Gs, Gs, Gs, Hhd, Md, Gd, Hhd, Hhd, Md, Hhd, Hd, Hd, Hd, Dd, Ds, Dd, Dd, Ds, Dd, Dd, Dd, Hd, Hd, Dd, Ds, Dd, Hd, Dd, Dd, Hhd, Hhd, Dd, Dd, Hd, Dd, Hd, Hd, Ds, Rd, Ds, Ds, Ds, Hd, Ds, Rd^Esd, Dd, Dd, Hd, Hd, Mdd, Dd
Hd, Dd, Dd, Ds, Dd, Gd, Gd, Wwt, Wot, Wot, Wot, Wwf^Es, Gg, Gs, Gs, Hhd, Gs, Gs, Gs, Hhd, Gd, Ds, Ds, Ds, Gd, Ds, Ds, Ds, Ds, Dd, Dd, Dd, Hd, Hd, Hd, Ds, Hd, Hhd, Hhd, Hhd, Md, Hhd, Dd, Dd, Hd, Hd, Dd, Hd, Dd, Ds^Es, Ds, Ds^Edt, Dd^Vdt, Dd, Dd, Dd, Dd, Hd, Hd, Mdd, Mdd, Hd
Hhd, Hd, Dd, Ds^Es, Ds, Gs, Gs, Gs, Wwt, Wot, Wot, Wwrt, Wwrt, Gs, Gs, Hhd, Gs, Gs, Hhd, Hhd, Hhd, Ds, Ds, Rd, Dd, Gd, Ds, Ds, Ds, Gd^Esd, Ds, Ds, Hd, Hd, Hd, Md, Hhd, Hhd, Hhd, Md, Md, Hhd, Hhd, Hhd, Hhd, Hhd, Dd, Hd, Ds, Ds^Es, Rd^Esd, Ds, Ds^Edt, Dd, Dd, Dd, Hd, Dd, Hd, Mdd, Mdd, Mdd
Hhd, Hd, Hd, Dd, Dd, Ds, Gs, Gs, Ds, Wwrt, Wwt, Wot, Wot, Wwt, Wwt, Gs, Wwt^Es, Wwf, Gs, Gs, Gs, Gd, Ds^Esd, Dd, Gs, Gs, Gd, Dd^Esd, Dd, Ds, Ds^Esd, Ds, Hhd, Hd, Hhd, Md, Md, Md, Md, Md, Hhd, Hhd, Md, Md, Hhd, Hd, Hd, Dd, Ds, Dd, Rd, Ds^Es, Dd, Hd, Hd, Hd, Dd, Hd, Hd, Mdd, Mdd, Mdd
Hd, Hhd, Hd, Ds, Dd, Ds, Ds, Gs^Esd, Ds^Esd, Ds, Gs, Wot, Wot, Wot, Wot, Wwt, Wwt, Gs, Wwrt, Gs, Gs, Gs, Gs, Gs, Gs, Gs, Gs, Dd^Esd, Gs, Gs, Gs, Gs, Hhd, Hhd, Hhd, Hhd, Hhd, Md, Md, Md, Md, Hhd, Md, Md, Hd, Hd, Hd, Dd, Dd, Rd, Rd^Esd, Ds^Esd, Dd, Hd, Hd, Dd, Dd, Dd, Dd, Hd, Hd, Hd
Hd, Hd, Hd, Hd, Hd, Dd, Ds, Dd, Dd, Gs, Gs, Wwt, Wwrt, Wwt, Wwt, Wot, Wot, Wwt, Wot, Wwt, Wot, Wwt, Wwt, Wwt, Wwt, Wwrt, Wwt, Gs, Wwt, Gs, Wwrt, Gs, Gs, Hhd, Gd, Gd, Hhd, Hhd, Md, Md, Md, Md, Hhd, Hhd, Dd, Hd, Hd, Dd, Dd, Rd, Dd, Dd, Dd, Hd, Dd, Hd, Dd^Es, Dd, Dd, Hd, Dd, Hd
Hd, Hd, Hd, Hd, Hd, Hd, Dd, Dd, Dd, Dd, Dd, Gs, Ds, Gd^Esd, Ds, Wwt, Wwt, Wot, Wwt, Wot, Wwt, Wot, Wot, Wot, Wot, Wwt, Wot, Wwt, Wot, Wot, Wot, Wwrt, Wwt^Ewl, Gs, Gs, Gd, Hhd, Hhd, Md, Md, Md, Md, Hhd, Dd, Ds, Hd, Dd, Dd, Dd, Rd^Esd, Rd, Dd, Dd^Vo, Dd, Dd, Dd^Edpp, Dd, Dd^Edpp, Dd, Dd, Dd, Dd
Hd, Hd, Hd, Hd, Dd, Hd, Dd, Dd^Edp, Dd, Dd, Dd, Ds, Ds, Dd, Dd, Wwt^Ewl, Gd, Wwt, Wwrt, Wwt, Gd, Wwt, Wwt, Wwt, Wwt, Wot, Wwt, Wot, Wwt, Wwt, Wwt, Wot, Wwt, Gs, Dd^Esd, Gd, Gd, Hhd, Hhd, Md, Md, Hhd, Hhd, Dd, Ds, Dd, Dd^Edt, Dd, Dd, Dd, Dd^Edpp, Rr^Esd, Rr^Esd, Dd^Edt, Dd, Dd, Dd, Dd, Dd, Dd, Dd^Es, Dd
Hd, Hd, Hd, Hd, Hd, Dd, Dd, Dd, Hd, Dd, Dd, Dd^Es, Dd, Dd, Hd, Dd, Gd, Gs, Gs, Ds, Ds, Gd, Gs, Gs, Gd, Wwt^Es, Gs, Wwrt, Gs, Wwt, Wwt, Wot, Wot, Gs, Dd, Dd, Gd, Gd, Hhd, Hhd, Hhd, Hhd, Hhd, Dd, Ds, Dd^Vo, Ds^Edt, Dd, Co, Dd, Dd^Vda, Dd, Rr^Esd, Rd, Dd^Vda, Dd, Dd, Co, Co, Dd, Dd, Dd
Hhd, Hhd, Hd, Hd, Hd, Hd, Dd, Dd, Dd^Es, Dd, Hd, Hd, Dd, Hd, Dd, Dd, Dd, Dd, Dd, Ds, Ds, Ds^Esd, Ds, Ds, Ds, Gs, Gs, Gs, Gd, Gs, Wwrt, Wwt, Wot, Wwrt, Dd, Dd^Esd, Dd, Hhd, Hhd, Hhd, Hhd, Hhd, Hhd, Ds, Ds, Ds, Ds, Ko, Co, Dd, Rr^Esd, Rr^Esd, Rr, Rd^Esd, Dd, Dd^Edt, Rr^Esd, Ko, Dd, Dd, Dd, Dd
Md, Hhd, Hhd, Hd, Hd, Hd, Hd, Dd, Dd^Es, Hd, Hd, Hd, Hd, Hd, Hd, Hd, Hd, Hd, Hd, Dd, Dd^Edp, Dd, Dd, Ds, Dd, Gs, Dd, Gs, Dd^Esd, Gs, Wwf, Wwt, Wot, Wwrt, Dd^Esd, Gs, Hhd, Hhd, Hhd, Hhd, Ds, Hhd, Hhd, Dd, Dd, Dd^Vdt, Dd, Co, Rd, Rr, Rd, Rd, Rr, Rr, Rr, Rr^Edt, Dd^Vdt, Dd, Dd, Dd, Dd, Dd
Md^Xm, Md^Xm, Md, Hhd, Hhd, Hd, Dd, Dd^Edp, Dd, Hd, Hd, Hd, Hd, Hd, Mdd, Hd, Hd, Hd, Dd, Dd, Dd, Dd, Gd, Dd, Dd, Dd, Dd, Ds, Dd, Gs, Gs, Wwt, Wot, Wwt, Wwrt, Gs, Gs, Hhd, Hhd, Ds, Gd, Ds, Gd, Gd, Dd, Ds^Edt, Gd, Gd, Rr, Rr, Gd, Re, Co^Edt, Co^Edt, Co^Edt, Rr, Rr, Dd, Dd, Hd, Hd, Dd
Md^Xm, Md^Xm, Md, Hhd, Hhd, Dd, Dd, Dd, Hd, Hd, Hd, Hd, Mdd^Xm, Mdd, Hd, Hd, Hd, Hd, Dd, Dd, Dd, Dd, Dd, Dd, Dd^Es, Dd, Dd, Ds, Dd, Dd, Wwf^Es, Wwrt, Wwt, Wot, Wwt, Wwf, Wwf, Gd, Gd, Ds, Gd, Ds, Gd, Gd, Gd, Gs, Wwf^Ewl, Gd, Rr, Gs, Gd, Re, Co, Co, 3 Ko, Co, Rr, Dd, Dd, Hd, Hd, Hd
Md^Xm, Md^Xm, Md, Md, Hhd, Hd, Dd, Dd, Hd, Hd, Mdd, Mdd, Mdd, Mdd, Mdd, Hd, Hd, Hd, Hd, Hd, Hd, Dd, Dd, Dd, Ds, Dd, Hd, Dd, Dd^Edp, Dd, Wwf^Es, Wwf^Es, Wwt, Wot, Wot, Wwt, Wwf, Gs, Gs, Wwf^Es, Gd, Gs, Gd, Gd, Gd, Wwf, Wwf^Ewl, Wwt^Es, Wwt^Bw|r, Wwrt, Wwt, Re, Wwt, Co, Co^Edt, Co, Re, Rr^Esd, Dd, Hd, Hd, Hd
Md, Md, Hhd, Hhd, Hd, Hd, Dd, Dd, Hd, Hd, Hd, Mdd, Mdd, Mdd, Mdd, Hd, Hd, Hd, Hd, Hd, Hd, Hd, Dd, Ds, Dd, Dd, Hd, Dd^Edp, Dd^Edp, Dd, Ds, Ds, Ds, Wwt, Wot, Wwt, Wwt, Gs, Wwt, Wwf, Wwf, Gd, Gd, Gd, Wwt, Wwrt, Wwt, Wwt, Wwt^Bw|, Wwt, Wwt, Wwt, Wot, Wwt, Wwt, Re, Re, Rr, Gs, Dd, Dd, Dd
Md, Hhd, Hhd, Hhd, Hd, Hd, Hd, Dd, Hd, Hd, Hd, Hd, Hd, Mdd, Mdd^Xm, Hd, Hd, Hd, Mdd, Mdd, Hd, Hd, Hd, Hd, Dd, Dd, Hd, Dd, Dd, Ds, Hd, Ds, Ds, Wwrt, Wwt, Wot, Wot, Wot, Wot, Wwt, Wwt, Wwrt, Wwt, Wwt, Wot, Wwt, Wwt, Wwt, Gs, Wwt, Wwt, Wwt, Wwt, Wot, Wot, Wwt, Gs, Rr, Gs, Dd, Dd^Esd, Dd
Md, Hhd, Hhd, Hhd, Hhd, Hd, Hd, Dd, Dd, Hd, Hd, Hd, Mdd, Mdd, Mdd, Mdd, Hd, Hd, Mdd, Mdd, Hd, Hd, Dd, Dd, Dd, Hhd, Hhd, Hd, Hd, Ds, Hd, Ds, Dd, Gs, Gs, Wwt, Wwt, Wot, Wot, Wot, Wot, Wot, Wot, Wot, Wwt, Wwt, Wwrt, Wwrt, Gs, Gs, Re, Rb^Edt, Rb^Edt, Wwt, Wwt, Wwt, Wwt^Bw/r, Rr, Gd, Gd^Esd, Dd^Edpp, Dd
Md, Md, Md, Md^Xm, Md^Xm, Hhd, Md, Md, Hhd, Hd, Hd, Hd, Hd, Hd, Hd, Hd, Hd, Hd, Hd, Hd, Hd, Dd, Dd, Dd^Edp, Dd, Hhd, Hd, Hd, Hd, Hd, Hhd, Hhd, Gd, Gd, Hhd, Gs, Gs, Wwt, Gs, Wwt, Wwrt, Wwt, Wwrt, Wwt, Cdr, Gs, Gd^Edt, Re, Gd, Gd, Rd^Edt, Re^Edt, Rb, Wwt, Wwt^Bw/r, Wwt^Bw/r, Wwt, Wwt, Wwrt, Gd, Dd, Dd
Md, Md, Md, Md, Md, Md^Xm, Md^Xm, Md, Hhd, Hhd, Hd, Hd, Hd, Hd, Hd, Hd, Dd, Hd, Hd, Hd, Hd, Dd, Dd, Dd, Dd, Hd, Hd, Hd, Hd, Hd, Hhd, Gd, Gd, Hhd, Hhd, Gs, Gs, Gd, Gs, Gs, Gd, Gs, Dd, Dd, Cd, Dd, Gd, Gd, Co, Gs, Rr^Esd, Rr, Rr, Rr, Wwt^Ewl, Wwt, Wot, Wot, Wwt, Gs, Gd^Esd, Dd
Md, Md^Xm, Md, Md, Mv, Md, Md, Hhd, Hhd, Hd, Md, Hhd, Hhd, Hd, Hd, Hd, Hd, Hd, Hhd, Hd, Hd, Hd, Dd, Dd^Edp, Dd, Hd, Hd, Hhd, Hd, Hd, Hhd, Hhd, Hhd, Hhd, Hhd, Hhd, Hhd, Hhd, Hhd, Gd, Gd, Gd, Cdr, Cd, Dd, Dd, Rd, Co, 2 Ko, Co, Rr, Dd^Vo, Dd^Esd, Gd, Re, Wwt, Wwt, Wot, Wwt, Gd, Gd, Dd
Hhd, Md, Md, Md, Md, Md, Md, Md^Xm, Md^Xm, Hhd, Md, Hhd, Hhd, Hd, Hd, Hd, Hhd, Md, Md, Hhd, Hd, Hd, Dd, Dd, Dd, Dd, Hd, Dd, Dd, Dd, Dd, Dd, Hhd, Hhd, Hhd, Hhd, Md, Hhd, Hhd, Hhd, Dd^Es, Dd, Dd, Dd^Edt, Dd, Dd^Vo, Dd, Co, Co, Co, Dd, Rr^Esd, Gd, Gd, Cdr, Re, Gd, Wwt, Wot, Wwt, Wwt, Gd
Hhd, Hhd, Hhd, Md, Hhd, Hhd, Hhd, Md^Xm, Md, Md, Md, Md, Md^Xm, Hhd, Hhd, Hhd, Md, Md, Md, Hhd, Hd, Dd, Hd, Dd, Dd, Hd, Dd, Dd, Hd, Hd, Dd^Edp, Dd, Hhd, Hhd, Md, Md, Md, Md, Hhd, Hhd, Dd, Dd, Dd^Es, Dd, Dd^Vda, Dd^Edt, Rr, Rr, Dd, Dd, Dd, Rr, Rr, Re, Re, Cdr, Gd^Edt, Wwrt, Wwt, Wot, Wwt, Gd
Md, Hhd, Md, Md^Xm, Md^Xm, Md^Xm, Md, Md^Xm, Md, Md, Md, Md, Md, Md, Md, Md, Hhd, Md, Md, Hhd, Md, Hhd, Hd, Hd, Dd, Dd, Dd^Es, Dd, Hd, Hd, Dd, Dd, Hhd, Hhd, Md, Md, Md, Md, Md, Hhd, Hhd, Dd, Dd, Dd, Rd, Rd, Dd, Dd^Vdt, Dd, Dd, Dd, Dd^Vda, Dd^Edpp, Rd, Rd, Rd, Gd, Gd, Wwt, Wot, Wot, Wwt
Md, Md, Md, Md^Xm, Md^Xm, Md^Xm, Md, Md^Xm, Md, Md, Md, Md, Hhd, Hhd, Hhd, Md, Md, Hhd, Md, Md, Hhd, Hhd, Hd, Hd, Dd, Dd, Dd, Hd, Dd, Hd, Dd, Dd, Hhd, Hhd, Md, Md, Md, Md, Md, Hhd, Hhd, Dd, Dd, Dd, Dd, Dd^Vda, Dd, Dd, Dd, Dd, Dd, Dd^Edt, Rd^Edt, Rr, Rr, Rd, Gd, Gd, Gd, Wwt, Wwt, Wot
Md, Md, Md, Md, Md, Hhd, Hhd, Md, Md, Md, Md, Hhd, Hhd, Hhd, Hhd, Md, Hhd, Hhd, Hhd, Hhd, Dd, Hhd, Hd, Hd, Hd, Hd, Dd, Dd, Hd, Hd, Dd, Hhd, Hhd, Hhd, Md, Md, Md, Md, Md, Md, Md, Hhd, Hhd, Hhd, Dd, Dd, Dd, Dd, Dd, Dd^Es, Dd, Dd^Edt, Re, Rd, Rr, Rr, Re, Gd, Gd, Gd, Gd, Wwt
