border_size=1
usage=map

Dd          , Dd          , Dd          , Dd          , Ds          , Dd          , Gd          , Gd          , Gd          , Gd          , Dd          , Dd          , Dd          , Dd          , Dd          , Dd          , Dd          , Dd          , Ds          , Dd          , Dd          , Dd          , Rd          , Rd          , Rd          , Dd          , Dd          , Dd          , Dd          , Dd          , Ds          , Ds          , Rd          , Rd          , Ds          , Dd          , Dd          , Dd          , Dd^Edp      , Dd          , Dd          , Dd          , Dd          , Dd          , Dd          , Dd          , Hd          , Dd          
Dd          , Dd          , Dd          , Ds          , Gd          , Gs          , Gs^Efm      , Gs          , Wwt         , Gs          , Gs^Ft       , Dd          , Gs          , Dd          , Dd          , Dd          , Ds          , Ds          , Dd          , Dd          , Dd          , Rd          , Rd          , Rd          , Dd          , Dd          , Ds          , Ds          , Dd          , Dd          , Ds          , Rd          , Rd          , Ds          , Dd          , Dd          , Dd          , Dd          , Dd          , Dd          , Dd          , Dd          , Dd          , Dd^Es       , Dd          , Hd          , Hd          , Hd          
Dd          , Dd          , Gd          , Dd          , Gs          , Gs^Efm      , Wwt         , Wwt         , Wot         , Wwt         , Wwt         , Gs^Ft       , Gs^Ft       , Gd          , Gd          , Dd          , Ds          , Ds          , Ds          , Rd          , Rd          , Dd          , Dd          , Dd          , Dd          , Dd          , Ds          , Ds          , Ds          , Chr         , Ds          , Ds          , Rd          , Ds          , Ds          , Ds          , Dd          , Dd          , Dd          , Dd          , Dd          , Hd          , Dd          , Dd          , Hd          , Hd          , Hd          , Dd          
Ds          , Dd          , Gd          , Gd          , Gs^Ft       , Gs^Ft       , Wwt         , Wwt         , Wot         , Wwt         , Wwt         , Gs^Ft       , Gs^Efm      , Re          , Gd          , Dd          , Gd          , Ds          , Dd          , Rd          , Dd          , Dd          , Ds          , Ds          , Ds          , Ds          , Rd^Vct      , Rr          , Chr         , Khr         , Ds          , Rd          , Ds          , Ds          , Ds          , Ds          , Dd          , Dd          , Dd          , Dd          , Dd          , Hd          , Dd          , Dd          , Hd          , Hd          , Hd          , Dd          
Ds          , Gd          , Gs          , Gs          , Gs^Ft       , Wwt         , Wot         , Wot         , Wot         , Wot         , Wwt         , Wwt         , Wwt         , 1 Gd        , Gd          , Gd          , Gd          , Gd          , Gd          , Gd          , Dd          , Dd          , Ds          , Rd          , Ds          , Ds          , Rr          , Rr^Es       , Chr         , Ds^Dr       , Dd          , Ds          , Dd          , Ds          , Dd          , Ds          , Dd          , Dd          , Dd          , Hd          , Hd          , Hd          , Dd          , Dd^Edp      , Dd          , Hd          , Dd          , Dd          
Ds          , Ds          , Gd          , Gs^Ft       , Gs^Ft       , Wwt         , Wwt         , Wot         , Wwt         , Wot         , Wot         , Wwt         , Wwt         , Wwf         , Gs          , Re          , Gs          , Gs          , Gd          , Gd          , Ds          , Ds          , Rd          , Rr          , Rr^Es       , Ds          , Ds          , Rd^Es       , Dd^Es       , Ds^Es       , Dd          , Dd          , Dd          , Ds          , Dd^Es       , Dd          , Dd          , Dd          , Hd          , Hd          , Hd          , Hd          , Dd          , Rd          , Dd          , Dd          , Rd          , Dd          
Dd          , Dd          , Gs          , Gd          , Wwf         , Wwt         , Gs^Ft       , Wwt         , Gs          , Wwt         , Wwt         , Wwt         , Wwt         , Wwf         , Gs^Efm      , Gs^Ft       , Gd          , Re          , Gd^Vct      , Rd          , Dd          , Rd          , Khr         , Chr         , Rd^Es       , Rd^Vct      , Ds          , Ds          , Dd          , Rd          , Dd          , Dd          , Dd^Dr       , Dd          , Dd          , Dd          , Dd          , Dd          , Hd          , Hd          , Hd          , Dd          , Dd^Edp      , Dd          , Rd          , Rd          , Dd          , Rd          
Dd          , Dd          , Ds          , Gs          , Gs^Ft       , Gs^Ft       , Gs^Ft       , Gs^Efm      , Gs          , Wwf         , Wwt         , Wwt         , Wwt         , Wwt         , Wwf         , Gs          , Gd          , Gd          , Re          , Rd          , Rd          , Chr         , Chr         , Rr^Es       , Ds          , Rd^Es       , Ds          , Dd          , Rd          , Rd          , Dd          , Dd^Es       , Dd          , Dd^Es       , Dd          , Dd^Edp      , Dd          , Hd          , Hd          , Dd          , Dd          , Ds^Edp      , Rd          , Dd          , Dd          , Rd          , Dd          , Dd          
Dd^Edp      , Dd^Edp      , Ds          , Gs          , Gd          , Gs^Ft       , Gs          , Gs          , Gs^Ft       , Gs          , Gs          , Wwf         , Wwt         , Wwt         , Gs          , Re          , Re          , Gd          , Re          , Re          , Rd          , Ds^Es       , Rd          , Ds          , Dd          , Dd^Dr       , Dd^Es       , Dd          , Dd          , Dd          , Dd          , Dd          , Dd          , Dd^Es       , Dd          , Dd          , Dd          , Dd          , Dd          , Dd          , Ds          , Ds          , Rd          , Rd          , Dd          , Dd          , Dd          , Dd          
Dd          , Ds^Edp      , Dd          , Gd          , Gs          , Gd          , Gs          , Gs          , Gd          , Gs          , Wwf         , Wwt         , Wwt         , Wwt         , Gs          , Re          , Re          , Gs          , Rd          , Rd^Vct      , Rd          , Ds          , Dd^Es       , Chr         , Dd          , Dd^Es       , Dd          , Dd          , Dd          , Dd          , Hd          , Hd          , Dd          , Dd          , Hd          , Hd          , Hd          , Dd          , Dd          , Ds^Es       , Ds          , Rd          , Dd          , Dd          , Hd          , Hd          , Hd          , Dd          
Ds          , Ds^Edp      , Dd          , Gs          , Gd          , Gs          , Dd          , Gs          , Gd          , Gs          , Wwf         , Wwf         , Wwt         , Wwt         , Gs          , Gs^Efm      , Gd          , Gd          , Dd          , Dd          , Dd^Edp      , Ds          , Chr         , Chr         , Rr          , Chr         , Khr         , Dd^Dr       , Dd          , Dd          , Hd          , Hd          , Dd^Edp      , Dd          , Hd          , Hd          , Hd          , Hd          , Dd          , Dd          , Rd          , Ds          , Ds          , Dd          , Hd          , Hd          , Hd          , Hd          
Ds          , Dd^Es       , Hd          , Hd          , Dd          , Dd          , Dd          , Gd          , Gd          , Gs          , Gs          , Gs          , Gd          , Gd          , Gs^Ft       , Gs^Ft       , Gs          , Dd^Edp      , Dd^Edp      , Dd          , Rd          , Dd          , Dd^Dr       , Rr          , Rd^Vct      , Rr          , Chr         , Dd^Es       , Dd          , Hd          , Hd          , Dd          , Dd          , Dd          , Hd          , Hd          , Hd          , Dd          , Dd          , Rd          , Dd          , Ds          , Hd          , Hd          , Dd          , Hd          , Hd          , Dd          
Dd          , Dd          , Hd          , Hd          , Hd          , Dd          , Dd          , Dd          , Ds          , Dd          , Gs          , Gs          , Gd          , Gd          , Gs          , Gs          , Dd          , Dd^Edp      , Ds          , Rd          , Rd          , Dd          , Dd^Es       , Dd          , Dd^Es       , Rr          , Dd          , Dd          , Hd          , Hd          , Hd          , Dd          , Hd          , Dd          , Dd          , Hd          , Hd          , Dd          , Dd          , Rd          , Dd          , Dd          , Hd          , Hd          , Hd          , Dd          , Hd          , Dd          
Dd          , Dd          , Hd          , Hd          , Hd          , Hd          , Hd          , Ds          , Ds^Edp      , Dd          , Ds          , Gd          , Ds          , Dd          , Dd          , Dd          , Dd          , Ds^Edp      , Ds          , Rd          , Dd          , Dd          , Dd          , Dd^Es       , Dd          , Rd          , Dd^Es       , Dd          , Hd          , Dd          , Hd          , Hd          , Hd          , Hd          , Dd          , Dd          , Dd          , Dd          , Rd          , Ds          , Hd          , Dd          , Hd          , Hd          , Hd          , Dd          , Hd          , Dd          
Dd^Es       , Dd          , Hd          , Hd          , Hd          , Hd          , Hd          , Dd          , Ds          , Dd          , Hd          , Ds          , Ds^Es       , Dd          , Ds          , Dd          , Hd          , Ds          , Ds          , Rd          , Dd          , Hd          , Dd          , Dd^Es       , Dd          , Dd          , Dd^Dr       , Rd          , Rr          , Dd          , Hd          , Hd          , Hd          , Hd          , Hd          , Dd          , Rd          , Rd          , Ds^Edp      , Ds          , Hd          , Dd          , Hd          , Hd          , Ds          , Hd          , Ds          , Dd          
Hd          , Dd          , Dd          , Hd          , Hd          , Hd          , Hd          , Dd          , Hd          , Dd          , Hd          , Hd          , Dd          , Ds          , Ds          , Hd          , Hd          , Ds          , Dd          , Dd          , Hd          , Hd          , Dd          , Dd          , Hd          , Dd^Edp      , Dd          , Rd          , Dd          , Dd          , Hd          , Hd          , Hd          , Hd          , Ds          , Ds^Es       , Rd^Es       , Dd          , Ds          , Ds          , Dd          , Hd          , Ds          , Ds          , Ds          , Ds          , Dd          , Dd          
Hd          , Hd          , Hd          , Hd          , Hd          , Hd          , Hd          , Dd          , Hd          , Hd          , Hd          , Hd          , Hd          , Hd          , Ds^Es       , Ds          , Dd          , Dd          , Dd          , Dd          , Hd          , Hd          , Hd          , Dd          , Hd          , Dd          , Dd          , Rd^Es       , Dd          , Hd          , Hd          , Hd          , Dd          , Ds          , Dd          , Rd          , Dd^Es       , Dd          , Ds          , Dd          , Dd          , Dd          , Ds          , Ds          , Yhs^Xp      , Dd          , Dd          , Dd          
Dd          , Hd          , Hd          , Hd          , Hd          , Hd          , Dd          , Hd          , Hd          , Hd          , Dd          , Dd^Edp      , Dd          , Hd          , Hd          , Dd          , Dd          , Dd          , Hhd         , Hd          , Hd          , Hd          , Hd          , Hd          , Dd          , Dd          , Ds^Es       , Dd^Es       , Dd          , Rd          , Rr          , Dd          , Dd          , Ds          , Dd          , Dd          , Dd          , Dd          , Dd          , Dd          , Dd          , Ds          , Hd          , Yhs         , Hd          , Ds          , Ds          , Ds          
Dd          , Hd          , Hd          , Hd          , Hd          , Hd          , Hd          , Hd          , Dd          , Dd          , Hd          , Dd          , Dd          , Hd          , Hd          , Hd          , Hd          , Dd          , Hhd         , Hd          , Hd          , Hd          , Dd          , Dd          , Dd          , Ds^Es       , Ds          , Dd          , Hd          , Dd          , Rd          , Dd          , Dd^Edp      , Dd          , Rd          , Dd          , Hd          , Dd          , Hd          , Dd          , Hd          , Hd          , Hd          , Hd          , Ds          , Ds          , Yhs^Xp      , Ds          
Dd          , Dd          , Dd          , Hd          , Hd          , Hd          , Hd          , Dd          , Dd          , Hd          , Hd          , Dd          , Hd          , Hd          , Hd          , Hhd         , Hhd         , Hhd         , Hhd         , Hd          , Hhd         , Hd          , Hhd         , Dd          , Dd          , Ds          , Dd          , Dd          , Hd          , Dd          , Dd          , Dd          , Dd          , Dd          , Rd          , Dd          , Dd          , Dd          , Hd          , Dd          , Hd          , Hd          , Hd          , Hd          , Ds          , Yhs^Xp      , Ds          , Dd          
Dd          , Dd          , Ds          , Hd          , Dd          , Hd          , Hd          , Dd          , Dd          , Hd          , Hd          , Dd          , Dd          , Dd          , Hhd         , Hhd         , Md          , Hhd         , Hhd         , Hhd         , Hhd         , Hd          , Hhd         , Dd          , Dd          , Ds          , Dd^Es       , Dd          , Hd          , Hd          , Dd          , Rd          , Dd          , Rd          , Dd          , Dd          , Dd          , Dd^Edp      , Dd          , Hd          , Dd          , Hd          , Hd          , Ds          , Ds          , Ds          , Dd          , Dd          
Dd          , Ds          , Ds          , Dd          , Ds          , Dd          , Dd          , Dd          , Dd          , Hd          , Hd          , Hd          , Hd          , Dd          , Hhd         , Hhd         , Md          , Md          , Md^Xm       , Md          , Md          , Hhd         , Dd          , Dd          , Dd          , Dd          , Dd          , Dd          , Dd          , Dd          , Rd          , Rd          , Dd          , Hd          , Dd          , Dd          , Dd^Es       , Dd^Edp      , Dd          , Dd^Edp      , Hd          , Hd          , Dd          , Ds          , Dd          , Dd          , Hhd         , Hhd         
Hd          , Ds          , Ds^Es       , Dd^Es       , Ds          , Hd          , Hd          , Hd          , Hhd         , Hhd         , Hhd         , Hd          , Hd          , Hd          , Hd          , Hd          , Md          , Md^Xm       , Md^Xm       , Md^Xm       , Md          , Hhd         , Hhd         , Dd          , Dd          , Gd          , Gd          , Dd          , Dd          , Dd          , Dd          , Dd          , Dd          , Dd          , Dd          , Dd          , Dd          , Dd          , Dd          , Hd          , Dd          , Hd          , Hd          , Hd          , Dd          , Dd          , Hhd         , Hhd         
Hd          , Hd          , Ds          , Dd          , Dd          , Hd          , Hd          , Hhd         , Hhd         , Hhd         , Md          , Hhd         , Hhd         , Hd          , Hd          , Hd          , Hhd         , Md          , Md          , Md^Xm       , Md^Xm       , Hhd         , Hhd         , Dd          , Gd          , Gd          , Gd          , Dd          , Dd          , Dd          , Dd          , Dd          , Ce          , Dd          , 4 Ket       , Ce          , Gd          , Dd          , Hhd         , Dd          , Hhd         , Dd          , Dd          , Hd          , Dd          , Hhd         , Md          , Md          
Hd          , Hd          , Dd          , Dd          , Dd          , Hd          , Hhd         , Hhd         , Md          , Md          , Md^Xm       , Md          , Hd          , Hd          , Hhd         , Hhd         , Hhd         , Hhd         , Md          , Md^Xm       , Md^Xm       , Md          , Hhd         , Hhd         , Gd          , Gd          , Ce          , Dd          , 5 Ket       , Ce          , Dd          , Rd          , Gd          , Ce          , Gd          , Gd^Es       , Gd          , Hhd         , Hhd         , Md          , Hhd         , Dd          , Dd          , Dd          , Hhd         , Hhd         , Md          , Md          
Hd          , Hd          , Dd          , Hd          , Hd          , Hd          , Hd          , Hhd         , Md          , Md^Xm       , Md          , Md          , Hhd         , Hd          , Hhd         , Hd          , Hd          , Hhd         , Hhd         , Md          , Md^Xm       , Md          , Hhd         , Hhd         , Gd          , Gd          , Gd          , Ce          , Dd          , Dd          , Dd^Es       , Rd          , Gd^Vct      , Gd          , Gd^Vct      , Gd          , Chr         , Hhd         , Md          , Md^Xm       , Md          , Hhd         , Md          , Hhd         , Hhd         , Hhd         , Md^Xm       , Md^Xm       
Hd          , Dd          , Dd          , Dd          , Dd          , Hd          , Hd          , Hhd         , Hhd         , Md          , Md          , Hhd         , Hhd         , Hhd         , Hhd         , Hd          , Hd          , Hhd         , Hhd         , Hhd         , Md          , Md          , Hhd         , Hhd         , Hhd         , Gd          , Gd^Vct      , Gd          , Gs          , Gd^Vct      , Gd          , Rd          , Re          , Re          , Gd^Fdw      , Gd^Fdw      , Chr         , Hhd         , Md          , Md          , Md          , Md^Xm       , Md          , Hhd         , Hhd         , Md          , Md^Xm       , Md          
Dd^Edp      , Dd          , Dd          , Hd          , Dd          , Hd          , Hhd         , Md          , Md          , Hhd         , Md^Xm       , Md          , Md          , Hhd         , Hhd         , Hd          , Hd          , Hd          , Hhd         , Hhd         , Hd          , Md          , Hhd         , Hhd         , Chr         , Gd^Es       , Gs          , Gs          , Gs^Fdw      , Gd          , Rp          , Rr          , Re          , Gd          , Gs^Fdw      , Chr         , Md          , Md          , Md          , Md          , Md          , Md          , Md^Xm       , Md          , Md          , Md^Xm       , Md^Xm       , Md          
Dd          , Dd          , Dd          , Hd          , Hd          , Hhd         , Hhd         , Md          , Md          , Md^Xm       , Md^Xm       , Md          , Md          , Hhd         , Hhd         , Hhd         , Hhd         , Hhd         , Hhd         , Hhd         , Hd          , Hd          , Hd          , Hhd         , Gd^Fdw      , Chr         , Gs^Fdw      , Gs          , Gs^Fdw      , Gd          , Re          , Rp          , Gs          , Gd^Ve       , Gs^Fdw      , Hhd         , Hh          , Md          , Hhd         , Hhd         , Md          , Md          , Md          , Md^Xm       , Md^Xm       , Md^Xm       , Md^Xm       , Md          
Hd          , Dd          , Dd          , Dd^Edp      , Hd          , Hd          , Hd          , Hhd         , Md          , Md^Xm       , Md^Xm       , Md^Xm       , Md          , Md^Xm       , Md^Xm       , Hhd         , Hhd         , Hhd         , Hhd         , Hd          , Hhd         , Md          , Md          , Md          , Gd^Fdw      , Chr         , Gd^Fdw      , Gs          , Gd          , Gd^Fdw      , Re          , Rp          , Gd          , Gs^Fdw      , Gd          , Hh          , Hh          , Hhd         , Gd          , Hhd         , Hhd         , Hhd         , Md          , Md^Xm       , Md^Xm       , Md^Xm       , Md^Xm       , Md^Xm       
Dd          , Hd          , Hd          , Dd          , Dd          , Hd          , Hhd         , Hhd         , Md          , Md^Xm       , Md^Xm       , Md^Xm       , Md          , Md^Xm       , Md^Xm       , Hhd         , Hhd         , Md          , Md          , Hhd         , Hhd         , Md          , Md^Xm       , Md          , Md          , Gs^Fdw      , Gd^Fdw      , Hhd         , Hhd         , Gd^Ve       , Gd          , Re          , Re          , Cv          , Cv          , Hh          , Gd^Fdw      , Gd^Fdw      , Gd          , Hhd         , Hhd         , Hhd         , Md^Xm       , Md^Xm       , Md          , Md          , Md^Xm       , Md^Xm       
Hhd         , Hd          , Hd          , Hd          , Hd          , Hhd         , Hhd         , Hhd         , Md          , Md          , Md          , Md^Xm       , Md          , Md          , Md          , Md^Xm       , Md          , Md          , Md          , Hhd         , Md          , Md          , Md^Xm       , Md          , Md          , Gd^Fdw      , Hhd         , Hhd         , Hhd         , Gd          , Gd          , Cv          , Rp          , Re          , Cv          , 2 Kv        , Gd^Fdw      , Gs^Fdw      , Hhd         , Hhd         , Md          , Md^Xm       , Md          , Md          , Md          , Md^Xm       , Md^Xm       , Md^Xm       
Hhd         , Hhd         , Hhd         , Hd          , Hhd         , Hhd         , Hhd         , Md          , Md          , Md          , Hhd         , Md          , Md^Xm       , Md          , Md^Xm       , Md^Xm       , Md          , Md^Xm       , Md^Xm       , Md          , Md^Xm       , Md^Xm       , Md          , Md^Xm       , Md          , Md          , Md          , Hhd         , Hhd         , Hhd^Fdw     , Gd^Fdw      , Cv          , Cv          , Rp          , Re          , Gd^Fdw      , Gs          , Hhd         , Gd          , Md          , Md          , Md          , Hhd         , Md          , Hhd         , Hhd         , Md          , Md^Xm       
Hhd         , Hhd         , Md          , Hhd         , Md          , Md          , Md          , Md          , Md          , Md          , Hhd         , Hhd         , Hhd         , Md^Xm       , Md          , Md          , Hhd         , Md          , Md          , Md^Xm       , Md^Xm       , Md^Xm       , Md          , Md          , Md          , Md          , Md          , Md          , Md          , Hhd^Fdw     , Gs          , 3 Kv        , Gd          , Re          , Re          , Gs          , Gs^Ve       , Gs^Fdw      , Gd^Fdw      , Hhd         , Hh          , Hhd         , Hh          , Hhd         , Hhd         , Hhd         , Md          , Md^Xm       
Md          , Md          , Md          , Md          , Md          , Md          , Md          , Md          , Md          , Md          , Hhd         , Hhd         , Md^Xm       , Md^Xm       , Md          , Md          , Hhd         , Hhd         , Hhd         , Md^Xm       , Md^Xm       , Md          , Hhd         , Md          , Hhd         , Hhd         , Hh          , Md          , Hhd^Fdw     , Hhd^Fdw     , Gs^Ve       , Gd          , Hhd^Fdw     , Gd          , Gd^Ve       , Re          , Rp          , Gs^Fdw      , Gd^Fdw      , Gd          , Gd          , Hh          , Hh          , Hh          , Hhd         , Hhd         , Md          , Md          
Md          , Md          , Md          , Md          , Md          , Md          , Md          , Md          , Md          , Md          , Hhd         , Md          , Md          , Md          , Md^Xm       , Md          , Hhd         , Hhd         , Hh          , Md          , Md          , Md^Xm       , Md          , Hhd         , Hhd         , Hh          , Hh          , Hhd         , Hhd         , Gs^Fdw      , Md          , Gd          , Hhd         , Gd          , Gd^Fdw      , Gd^Fdw      , Rp          , Gs          , Gd^Ve       , Gd          , Gd^Fdw      , Gs^Fdw      , Hh          , Hh          , Md          , Md          , Md          , Md          
Md          , Md          , Md          , Md          , Md          , Md          , Md          , Md          , Md          , Hhd         , Hhd         , Hhd         , Hhd         , Md          , Md^Xm       , Md          , Hhd         , Hhd         , Hh          , Hhd         , Md          , Md^Xm       , Md          , Hhd         , Md          , Hh          , Gs^Fdw      , Gs^Fdw      , Hhd         , Gd          , Md          , Md          , Hhd^Fdw     , Hhd         , Gs          , Gs^Fdw      , Re          , Rp          , Gs^Fdw      , Gd          , Gs^Fdw      , Gs^Fdw      , Hh          , Hhd         , Md          , Md          , Md          , Md          
Md          , Md          , Md          , Md          , Md          , Md          , Md          , Md          , Hhd         , Hhd         , Hh          , Md          , Md          , Md          , Md          , Md          , Md          , Hh          , Hh          , Hhd         , Hhd         , Md          , Md          , Md          , Hhd         , Hh          , Gs^Fdw      , Gs^Fdw      , Gd          , Hhd^Fdw     , Gs^Fdw      , Hhd         , Gd          , Gd          , Gd          , Gd          , Gd^Fdw      , Re          , Re          , Gs          , Gs          , Hh          , Hh          , Hhd         , Hhd         , Md          , Md          , Md          
