Dd, Dd, Dd, Dd, Ds^Esd, Dd^Esd, Gd, Gd, Gd, Gd^Esd, Dd, Dd, Dd, Dd, Dd, Dd, Dd, Dd, Ds, Dd, Dd, Dd, Rd, Rd, Rd, Dd, Dd, Dd, Dd, Dd, Ds, Ds, Rd, Rd, Ds, Dd, Dd, Dd, Dd^Edp, Dd, Dd, Dd, Dd, Dd, Dd, Dd, Hd, Dd
Dd, Dd, Dd, Ds, Gd^Esd, Gs, Gs^Efm, Gs, Ww, Gs, Gs^Ftd, Dd, Gs, Dd^Esd, Dd, Dd, Ds, Ds, Dd, Dd, Dd, Rd^Esd, Rd, Rd, Dd, Dd, Ds, Ds, Dd^Edt, Dd, Ds, Rd^Esd, Rd^Esd, Ds, Dd, Dd, Dd, Dd, Dd, Dd, Dd, Dd, Dd, Dd^Es, Dd, Hd, Hd, Hd
Dd, Dd, Gd, Dd^Esd, Gs, Gs^Efm, Wwr, Wwr, Wo, Ww^Ewl, Ww^Ewl, Gs^Ftd, Gs^Ftd, Gd, Gd^Fts, Dd, Ds, Ds, Ds, Rd, Rd^Esd, Dd, Dd, Dd, Dd, Dd, Ds, Ds^Edt, Ds^Edt, Chr, Ds, Ds, Rd, Ds, Ds, Ds, Dd, Dd, Dd, Dd, Dd, Hd, Dd, Dd, Hd, Hd, Hd, Dd
Ds, Dd^Esd, Gd, Gd^Fts, Gs^Ftd, Gs^Ftd, Ww, Ww, Wo, Wwr^Ewl, Ww^Ewl, Gs^Ftd, Gs^Efm, Re, Gd, Dd^Esd, Gd^Fts, Ds^Esd, Dd, Rd^Esd, Dd, Dd, Ds, Ds, Ds, Ds, Rd^Vct, Rr, Chr, Khr, Ds, Rd^Esd, Ds, Ds, Ds, Ds, Dd, Dd, Dd, Dd, Dd, Hd, Dd, Dd, Hd, Hd, Hd, Dd
Ds, Gd, Gs^Fts, Gs^Ft, Gs^Ftd, Wwr, Wo^Ewl, Wo, Wo^Ewf, Wo, Ww, Wwr, Wwr, 1 Gd, Gd, Gd, Gd, Gd^Fts, Gd, Gd, Dd, Dd, Ds^Edt, Rd^Esd, Ds, Ds, Rr, Rr^Es, Chr, Ds^Dr, Dd, Ds, Dd, Ds, Dd^Vdt, Ds, Dd, Dd, Dd, Hd, Hd, Hd, Dd, Dd^Edp, Dd, Hd, Dd, Dd
Ds, Ds^Esd, Gd, Gs^Ftd, Gs^Ftd, Ww, Ww^Ewl, Wo, Ww, Wo, Wo, Ww^Ewf, Ww, Wwf, Gs, Re, Gs, Gs, Gd, Gd^Fts, Ds, Ds^Edt, Rd^Edt, Rr^Edt, Rr^Es, Ds^Es, Ds^Es, Khr, Dd^Es, Ds^Es, Dd, Dd, Dd, Ds, Dd^Es, Dd, Dd, Dd, Hd, Hd, Hd, Hd, Dd, Rd, Dd, Dd, Rd, Dd
Dd, Dd, Gs, Gd, Wwf, Ww, Gs^Ftd, Ww, Gs, Ww, Ww, Ww, Wwr^Ewl, Wwf^Ewl, Gs^Efm, Gs^Ftd, Gd, Re, Gd^Vct, Rd^Esd, Dd, Rd^Esd, Khr, Chr, Rd^Es, Rd^Vct, Ds, Chr, Dd, Rd^Esd, Dd, Dd, Dd^Dr, Dd, Dd, Dd, Dd, Dd, Hd, Hd, Hd, Dd, Dd^Edp, Dd, Rd^Esd, Rd, Dd, Rd
Dd, Dd, Ds, Gs^Fts, Gs^Ftd, Gs^Ftd, Gs^Ftd, Gs^Efm, Gs, Wwf^Ewl, Wwr, Ww, Wwr, Ww^Ewl, Wwf^Ewl, Gs, Gd, Gd, Re^Edt, Rd, Rd, Chr, Chr, Rr^Es, Ds, Rd^Es, Ds, Dd^Es, Rd^Esd, Rd, Dd, Dd^Es, Dd, Dd^Es, Dd, Dd^Edp, Dd, Hd, Hd, Dd, Dd, Ds^Edp, Rd^Esd, Dd^Esd, Dd^Vdr, Rd^Esd, Dd, Dd
Dd^Edp, Dd^Edp, Ds^Esd, Gs, Gd, Gs^Ft, Gs, Gs, Gs^Ftd, Gs, Gs, Wwf, Ww, Ww, Gs, Re, Re, Gd^Fts, Re, Re, Rd, Ds^Es, Rd^Esd, Ds, Dd, Dd^Dr, Dd^Es, Dd, Dd, Dd, Dd, Dd, Dd, Dd^Es, Dd, Dd, Dd, Dd, Dd, Dd, Ds, Ds, Rd, Rd^Esd, Dd, Dd, Dd, Dd
Dd, Ds^Edp, Dd, Gd, Gs^Fts, Gd, Gs^Fts, Gs, Gd, Gs, Wwf, Ww, Ww^Ewf, Wwr, Gs, Re, Re, Gs, Rd^Esd, Rd^Vct, Rd^Esd, Ds, Dd^Es, Chr, Chr, Dd^Es, Dd, Dd, Dd, Dd, Hd, Hd, Dd, Dd, Hd, Hd, Hd, Dd, Dd, Ds^Es, Ds, Rd, Dd^Esd, Dd, Hd, Hd, Hd, Dd
Ds, Ds^Edp, Dd, Gs, Gd, Gs, Dd, Gs, Gd^Fts, Gs, Wwf, Wwf^Ewf, Ww^Ewl, Wwr, Gs, Gs^Efm, Gd, Gd^Esd, Dd^Esd, Dd^Edt, Dd^Edp, Ds, Chr, Chr, Rr, Chr, Khr, Dd^Dr, Dd, Dd, Hd, Hd, Dd^Edp, Dd, Hd, Hd, Hd, Hd, Dd, Dd, Rd^Esd, Ds, Ds, Dd, Hd, Hd, Hd, Hd
Ds, Dd^Es, Hd, Hd, Dd, Dd, Dd, Gd, Gd, Gs, Gs, Gs, Gd, Gd, Gs^Ftd, Gs^Ftd, Gs, Dd^Edp, Dd^Edp, Dd, Rd, Dd, Dd^Dr, Rr, Rd^Vct, Rr, Chr, Dd^Es, Dd, Hd, Hd, Dd, Dd, Dd, Hd, Hd, Hd, Dd, Dd, Rd^Esd, Dd, Ds, Hd, Hd, Dd, Hd, Hd, Dd
Dd, Dd, Hd, Hd, Hd, Dd, Dd, Dd^Esd, Ds, Dd^Esd, Gs, Gs, Gd, Gd, Gs, Gs, Dd, Dd^Edp, Ds, Rd, Rd^Esd, Dd, Dd^Es, Dd, Dd^Es, Rr, Dd, Dd, Hd, Hd, Hd, Dd, Hd, Dd, Dd, Hd, Hd, Dd, Dd, Rd^Esd, Dd, Dd, Hd, Hd, Hd, Dd, Hd, Dd
Dd, Dd^Vdr, Hd, Hd, Hd, Hd, Hd, Ds, Ds^Edp, Dd, Ds, Gd, Ds, Dd, Dd, Dd, Dd, Ds^Edp, Ds, Rd^Esd, Dd, Dd, Dd, Dd^Es, Dd, Rd, Dd^Es, Dd, Hd, Dd, Hd, Hd, Hd, Hd, Dd, Dd, Dd^Vdr, Dd, Rd, Ds, Hd, Dd, Hd, Hd, Hd, Dd, Hd, Dd
Dd^Es, Dd, Hd, Hd, Hd, Hd, Hd, Dd, Ds, Dd, Hd, Ds, Ds^Es, Dd, Ds, Dd, Hd, Ds, Ds, Rd, Dd, Hd, Dd^Vdr, Dd^Es, Dd, Dd, Dd^Dr, Rd^Esd, Rr^Esd, Dd, Hd, Hd, Hd, Hd, Hd, Dd, Rd, Rd^Esd, Ds^Edp, Ds, Hd, Dd, Hd, Hd, Ds, Hd, Ds, Dd
Hd, Dd, Dd, Hd, Hd, Hd, Hd, Dd, Hd, Dd, Hd, Hd, Dd, Ds, Ds, Hd, Hd, Ds, Dd, Dd, Hd, Hd, Dd, Dd^Edt, Hd, Dd^Edp, Dd, Rd^Esd, Dd, Dd, Hd, Hd, Hd, Hd, Ds, Ds^Es, Rd^Es, Dd, Ds, Ds, Dd, Hd, Ds, Ds, Ds^Esd, Ds, Dd, Dd
Hd, Hd, Hd, Hd, Hd, Hd, Hd, Dd, Hd, Hd, Hd, Hd, Hd, Hd, Ds^Es, Ds, Dd, Dd, Dd, Dd, Hd, Hd, Hd, Dd, Hd, Dd, Dd, Rd^Es, Dd, Hd, Hd, Hd, Dd, Ds, Dd, Rd^Esd, Dd^Es, Dd, Ds, Dd, Dd, Dd, Ds, Ds, Yhs^Xp, Dd^Esd, Dd, Dd
Dd, Hd, Hd, Hd, Hd, Hd, Dd, Hd, Hd, Hd, Dd, Dd^Edp, Dd, Hd, Hd, Dd, Dd, Dd, Hhd, Hd, Hd, Hd, Hd, Hd, Dd, Dd, Ds^Es, Dd^Es, Dd, Rd^Esd, Rr, Dd, Dd, Ds, Dd, Dd, Dd, Dd, Dd, Dd, Dd, Ds, Hd, Yhs^Esd, Hd, Ds, Ds, Ds
Dd, Hd, Hd, Hd, Hd, Hd, Hd, Hd, Dd^Esd, Dd, Hd, Dd, Dd, Hd, Hd, Hd, Hd, Dd, Hhd, Hd, Hd, Hd, Dd, Dd, Dd, Ds^Es, Ds, Dd, Hd, Dd, Rd^Esd, Dd^Vdr, Dd^Edp, Dd, Rd, Dd, Hd, Dd, Hd, Dd, Hd, Hd, Hd, Hd, Ds, Ds^Esd, Yhs^Xp, Ds
Dd, Dd, Dd, Hd, Hd, Hd, Hd, Dd^Vdr, Dd, Hd, Hd, Dd, Hd, Hd, Hd, Hhd, Hhd, Hhd, Hhd, Hd, Hhd, Hd, Hhd, Dd, Dd, Ds, Dd^Vdr, Dd, Hd, Dd, Dd, Dd, Dd, Dd, Rd^Esd, Dd, Dd, Dd, Hd, Dd, Hd, Hd, Hd, Hd, Ds^Esd, Yhs^Xp, Ds^Esd, Dd
Dd, Dd, Ds, Hd, Dd, Hd, Hd, Dd, Dd, Hd, Hd, Dd, Dd, Dd, Hhd, Hhd, Md, Hhd, Hhd, Hhd, Hhd, Hd, Hhd, Dd, Dd, Ds, Dd^Es, Dd, Hd, Hd, Dd, Rd^Esd, Dd, Rd, Dd, Dd, Dd, Dd^Edp, Dd, Hd, Dd, Hd, Hd, Ds, Ds, Ds, Dd, Dd
Dd, Ds^Esd, Ds, Dd, Ds, Dd, Dd, Dd, Dd, Hd, Hd, Hd, Hd, Dd, Hhd, Hhd, Md, Md, Md^Xm, Md, Md, Hhd, Dd, Dd, Dd^Esd, Dd, Dd, Dd, Dd, Dd, Rd^Esd, Rd, Dd, Hd, Dd, Dd, Dd^Es, Dd^Edp, Dd, Dd^Edp, Hd, Hd, Dd, Ds, Dd, Dd, Hhd, Hhd
Hd, Ds, Ds^Es, Dd^Es, Ds, Hd, Hd, Hd, Hhd, Hhd, Hhd, Hd, Hd, Hd, Hd, Hd, Md, Md^Xm, Md^Xm, Md^Xm, Md, Hhd, Hhd, Dd, Dd^Esd, Gd, Gd^Esd, Dd, Dd, Dd, Dd, Dd, Dd, Dd, Dd, Dd, Dd, Dd, Dd, Hd, Dd, Hd, Hd, Hd, Dd, Dd, Hhd, Hhd
Hd, Hd, Ds, Dd, Dd, Hd, Hd, Hhd, Hhd, Hhd, Md, Hhd, Hhd, Hd, Hd, Hd, Hhd, Md, Md, Md^Xm, Md^Xm, Hhd, Hhd, Dd, Gd^Esd, Gd, Gd, Dd^Esd, Dd, Dd, Dd, Dd, Cer, Dd, 4 Ket, Cer, Gd, Dd, Hhd, Dd, Hhd, Dd, Dd, Hd, Dd, Hhd, Md, Md
Hd, Hd, Dd, Dd, Dd, Hd, Hhd, Hhd, Md, Md, Md^Xm, Md, Hd, Hd, Hhd, Hhd, Hhd, Hhd, Md, Md^Xm, Md^Xm, Md, Hhd, Hhd, Gd, Gd, Cte, Dd, 5 Ket, Cte, Dd, Rd, Gd, Cte, Gd, Gd^Es, Gd, Hhd, Hhd, Md, Hhd, Dd, Dd, Dd, Hhd, Hhd, Md, Md
Hd, Hd, Dd, Hd, Hd, Hd, Hd, Hhd, Md, Md^Xm, Md, Md, Hhd, Hd, Hhd, Hd, Hd, Hhd, Hhd, Md, Md^Xm, Md, Hhd, Hhd, Gd, Gd, Gd, Cer, Dd^Esd, Dd, Dd^Es, Rd^Esd, Gd^Vct, Gd, Gd^Vct, Gd, Chr, Hhd, Md, Md^Xm, Md, Hhd, Md, Hhd, Hhd, Hhd, Md^Xm, Md^Xm
Hd, Dd, Dd, Dd, Dd, Hd, Hd, Hhd, Hhd, Md, Md, Hhd, Hhd, Hhd, Hhd, Hd, Hd, Hhd, Hhd, Hhd, Md, Md, Hhd, Hhd, Hhd, Gd, Gd^Vct, Gd, Gs, Gd^Vct, Gd, Rd^Esd, Re, Re, Gd^Fdw, Gd^Fdw, Chr, Hhd, Md, Md, Md, Md^Xm, Md, Hhd, Hhd, Md, Md^Xm, Md
Dd^Edp, Dd, Dd, Dd^Vdr, Dd, Hd, Hhd, Md, Md, Hhd, Md^Xm, Md, Md, Hhd, Hhd, Hd, Hd, Hd, Hhd, Hhd, Hd, Md, Hhd, Hhd, Chr, Gd^Es, Gs, Gs, Gs^Fdw, Gd, Rp, Rr, Re, Gd, Gs^Fdw, Chr, Md, Md, Md, Md, Md, Md, Md^Xm, Md, Md, Md^Xm, Md^Xm, Md
Dd, Dd, Dd, Hd, Hd, Hhd, Hhd, Md, Md, Md^Xm, Md^Xm, Md, Md, Hhd, Hhd, Hhd, Hhd, Hhd, Hhd, Hhd, Hd, Hd, Hd, Hhd, Gd^Fdw, Cte, Gs^Fdw, Gs, Gs^Fdw, Gd, Re, Rp, Gs, Gd^Ve, Gs^Fdw, Hhd, Hh, Md, Hhd, Hhd, Md, Md, Md, Md^Xm, Md^Xm, Md^Xm, Md^Xm, Md
Hd, Dd, Dd, Dd^Edp, Hd, Hd, Hd, Hhd, Md, Md^Xm, Md^Xm, Md^Xm, Md, Md^Xm, Md^Xm, Hhd, Hhd, Hhd, Hhd, Hd, Hhd, Md, Md, Md, Gd^Fdw, Chr, Gd^Fdw, Gs, Gd, Gd^Fdw, Re, Rp, Gd, Gs^Fdw, Gd, Hh, Hh, Hhd, Gd, Hhd, Hhd, Hhd, Md, Md^Xm, Md^Xm, Md^Xm, Md^Xm, Md^Xm
Dd, Hd, Hd, Dd, Dd, Hd, Hhd, Hhd, Md, Md^Xm, Md^Xm, Md^Xm, Md, Md^Xm, Md^Xm, Hhd, Hhd, Md, Md, Hhd, Hhd, Md, Md^Xm, Md, Md, Gs^Fdw, Gd^Fdw, Hhd, Hhd, Gd^Ve, Gd, Re, Re, Cvrz, Cvz, Hh, Gd^Fdw, Gd^Fdw, Gd, Hhd, Hhd, Hhd, Md^Xm, Md^Xm, Md, Md, Md^Xm, Md^Xm
Hhd, Hd, Hd, Hd, Hd, Hhd, Hhd, Hhd, Md, Md, Md, Md^Xm, Md, Md, Md, Md^Xm, Md, Md, Md, Hhd, Md, Md, Md^Xm, Md, Md, Gd^Fdw, Hhd, Hhd, Hhd, Gd, Gd, Cvrz, Rp, Re, Cvrz, 2 Kvr, Gd^Fdw, Gs^Fdw, Hhd, Hhd, Md, Md^Xm, Md, Md, Md, Md^Xm, Md^Xm, Md^Xm
Hhd, Hhd, Hhd, Hd, Hhd, Hhd, Hhd, Md, Md, Md, Hhd, Md, Md^Xm, Md, Md^Xm, Md^Xm, Md, Md^Xm, Md^Xm, Md, Md^Xm, Md^Xm, Md, Md^Xm, Md, Md, Md, Hhd, Hhd, Hhd^Fdw, Gd^Fdw, Cvz, Cvrz, Rp, Re, Gd^Fdw, Gs, Hhd, Gd, Md, Md, Md, Hhd, Md, Hhd, Hhd, Md, Md^Xm
Hhd, Hhd, Md, Hhd, Md, Md, Md, Md, Md, Md, Hhd, Hhd, Hhd, Md^Xm, Md, Md, Hhd, Md, Md, Md^Xm, Md^Xm, Md^Xm, Md, Md, Md, Md, Md, Md, Md, Hhd^Fdw, Gs, 3 Kvr, Gd, Re, Re, Gs, Gs^Ve, Gs^Fdw, Gd^Fdw, Hhd, Hh, Hhd, Cvr, Hhd, Hhd, Hhd, Md, Md^Xm
Md, Md, Md, Md, Md, Md, Md, Md, Md, Md, Hhd, Hhd, Md^Xm, Md^Xm, Md, Md, Hhd, Hhd, Hhd, Md^Xm, Md^Xm, Md, Hhd, Md, Hhd, Hhd, Hh, Md, Hhd^Fdw, Hhd^Fdw, Gs^Ve, Gd, Hhd^Fdw, Gd, Gd^Ve, Re, Rp, Gs^Fdw, Gd^Fdw, Gd, Gd, Hh, Hh, Hh, Hhd, Hhd, Md, Md
Md, Md, Md, Md, Md, Md, Md, Md, Md, Md, Hhd, Md, Md, Md, Md^Xm, Md, Hhd, Hhd, Hh, Md, Md, Md^Xm, Md, Hhd, Hhd, Hh, Hh, Hhd, Hhd, Gs^Fdw, Md, Gd, Hhd, Gd, Gd^Fdw, Gd^Fdw, Rp, Gs, Gd^Ve, Gd, Gd^Fdw, Gs^Fdw, Hh, Hh, Md, Md, Md, Md
Md, Md, Md, Md, Md, Md, Md, Md, Md, Hhd, Hhd, Hhd, Hhd, Md, Md^Xm, Md, Hhd, Hhd, Hh, Hhd, Md, Md^Xm, Md, Hhd, Md, Hh, Gs^Fdw, Cvr, Hhd, Gd, Md, Md, Hhd^Fdw, Hhd, Gs, Gs^Fdw, Re, Rp, Gs^Fdw, Gd, Gs^Fdw, Gs^Fdw, Hh, Hhd, Md, Md, Md, Md
Md, Md, Md, Md, Md, Md, Md, Md, Hhd, Hhd, Hh, Md, Md, Md, Md, Md, Md, Hh, Hh, Hhd, Hhd, Md, Md, Md, Hhd, Hh, Gs^Fdw, Gs^Fdw, Gd, Hhd^Fdw, Gs^Fdw, Hhd, Gd, Gd, Gd, Gd, Gd^Fdw, Re, Re, Gs, Gs, Hh, Hh, Hhd, Hhd, Md, Md, Md
