Hh, Hh, Hh, Hh, Hh, Hh, Hh, Hh, Md^Xm, Md^Xm, Md, Md, Md, Hh, Hh, Hh, Gd^Fdw, Gd^Fdw, Gs, Re, Re, Gs, Gll^Fdw, Hhd, Hhd, Hhd, Hhd, Md, Md, Md, Md, Md, Md, Md^Xm, Md^Xm, Md, Mm, Mm, Mm, Mm, Mm, Mm
Hh, Hh, Hh, Hh, Hh, Hh, Md, Md, Md^Xm, Md^Xm, Md, Md, Md, Hh, Hh, Hhd^Fdw, Gd^Fdw, Gd^Fdw, Gd^Fdw, Re, Gs, Gs^Ve, Gll^Fdw, Hhd, Hhd, Md, Md, Md, Md, Md, Md, Md, Md, Mm, Md^Xm, Md^Xm, Md^Xm, Md^Xm, Md^Xm, Mm, Mm^Xm, Mm
Hh, Hh, Hh, Hh, Hh, Md, Md, Md^Xm, Md, Md, Md, Md, Md, Hh, Hhd, Hhd^Fdw, Hhd, Hhd, Gd, Re, Gd^Fdw, Gll^Fdw, Hhd, Hhd^Fdw, Hhd, Hhd, Md, Md, Hh, Mm, Hh, Md, Md, Md, Md, Md^Xm, Md^Xm, Md^Xm, Md^Xm, Mm, Mm, Mm
Hh, Hh, Hh, Hh, Md, Md, Md^Xm, Md^Xm, Md, Md, Md, Md, Md, Hh, Hhd, Hhd^Fdw, Hhd^Fdw, Gd^Fdw, Gd, Re, Re, Gd, Gd, Gll^Fdw, Gs^Fdw, Hhd, Hhd, Hhd, Hh, Hh, Hhd, Mm, Mm, Mm, Mm, Md, Md, Md^Xm, Md^Xm, Md^Xm, Md^Xm, Md
Mm, Hh, Hh, Md, Md, Md, Md, Md^Xm, Md^Xm, Md^Xm, Md, Md, Md, Hhd, Hhd, Hhd^Fdw, Gd^Fdw, Gd^Efm, Gd^Ve, Gll^Fdw, Re, Re^Es, Gd, Gd, Hhd, Hhd^Fdw, Hhd, Hhd, Hhd^Fdw, Hh, Hhd, Hh, Mm, Mm, Hh, Md, Md, Mm, Md, Md^Xm, Md, Md
Mm, Hh, Hh, Hh, Md, Md, Md, Md, Md^Xm, Md^Xm, Md, Md, Md, Hhd, Hhd^Fdw, Hhd^Fdw, Gll^Fdw, Gd, Gd^Fetd, Gll^Fdw, Re, Re, Ce^Edt, Gs, Gd, Hhd, Gs^Fdw, Hhd^Fdw, Hhd^Fdw, Hhd, Hhd, Hh, Hh, Hh, Hh, Hh, Hh, Mm, Md, Md^Xm, Md^Xm, Md^Xm
Md^Xm, Mm, Hh, Hh, Hh, Hh, Md^Xm, Mm, Md^Xm, Md^Xm, Md, Md, Hhd, Hhd, Hhd, Gll^Fdw, Gll^Fdw, Gll^Fdw, Gd, Gd^Fdw, Gd, Ce^Es, 1 Ke, Ce^Edt, Ce, Gd, Gll, Gd^Fdw, Hhd^Fdw, Hhd^Fdw, Hhd, Hhd, Hhd, Hh, Hhd, Hh, Hh, Mm, Md, Md^Xm, Md, Md
Md^Xm, Md, Md, Md, Mm, Hh, Md^Xm, Md^Xm, Md^Xm, Md^Xm, Md, Md, Hhd, Hhd, Hhd, Gd^Fdw, Gll^Fdw, Gll^Fdw, Gd, Re^Es, Gd, Ce, Ce, Ce^Es, Ce, Gd, Gs^Fdw, Gll^Fetd, Gd, Hhd^Fdw, Gd^Fdw, Hhd, Hhd^Fdw, Hh^Fdw, Hhd, Hhd^Fdw, Hhd, Hhd, Md, Md, Md, Md
Md^Xm, Md, Md, Md, Md^Xm, Md^Xm, Mm, Md, Hh, Md, Md, Hhd, Hh, Hhd, Hhd, Gd^Fdw, Gd^Fdw, Gll^Fdw, Gll^Fdw, Gd, Gd^Ve, Gd, Gd^Efm, Ce^Es, Rp, Gd, Gd^Ve, Gll^Fdw, Gd, Gd^Fdw, Hhd, Hhd, Hhd^Fdw, Hhd^Fdw, Hhd, Hhd, Hhd, Hhd, Md, Mm, Hhd, Md
Md^Xm, Md^Xm, Md^Xm, Md^Xm, Md^Xm, Md^Xm, Mm, Hh, Hh, Md, Hh, Hhd, Md, Md, Hhd, Hhd, Hhd, Hhd, Hhd^Fdw, Hhd^Fdw, Gd^Fdw, Re, Re^Es, Gd, Rp, Re, Gd, Gd, Hhd, Hhd^Fdw, Hhd, Hhd^Fdw, Hhd, Hhd, Hhd, Md, Md, Md, Md, Hhd, Gll^Fdw, Gll
Md^Xm, Md^Xm, Md^Xm, Md^Xm, Md^Xm, Md^Xm, Mm, Hh, Hh, Hh, Md, Md, Hhd, Md, Md, Hhd, Hhd, Hhd, Gs, Gs, Gs, Gd^Fdw, Gd, Re^Es, Re, Rp, Gs^Fdw, Hhd, Gs^Fdw, Hhd^Fdw, Gd, Gd, Hhd, Md, Hhd, Md, Hhd, Md, Gll^Fdw, Hhd, Gd^Fdw, Gd^Fdw
Md^Xm, Md^Xm, Md^Xm, Md^Xm, Md^Xm, Md^Xm, Mm, Mm, Mm, Hh, Hhd, Hhd, Hhd, Md, Md, Md, Md, Hhd, Hhd, Hhd, Hhd, Gs, Gd, Gll^Ve, Re^Fdw, Rp, Re^Ve, Gd^Fdw, Gs, Gd, Hhd, Hhd, Md, Hhd, Hhd, Hhd, Hhd^Fdw, Hhd, Gll^Fdw, Gll^Fdw, Rp, Rp
Md^Xm, Md^Xm, Md^Xm, Md^Xm, Md^Xm, Md^Xm, Mm, Mm, Hhd, Hhd, Hhd, Hhd, Hhd, Hhd, Md, Md, Md, Md, Md, Hhd, Hhd, Hhd, Gd, Gll^Es, Gll^Fdw, Rp, Re, Gs^Fdw, Gs, Hhd, Hhd^Fdw, Hhd, Hhd, Gd^Fdw, Gd, Gll^Fdw, Gd^Fdw, Gll^Fdw, Gd, Re, Gd, Gd
Md^Xm, Md^Xm, Md^Xm, Md^Xm, Md^Xm, Mm, Mm, Mm, Hhd^Fdw, Hhd^Fdw, Hhd, Hhd, Md, Md, Md, Md, Hhd, Md, Md, Hhd, Hhd, Md, Hhd, Gd, Gd, Gd, Re, Gs^Efm, Gs^Fdw, Hhd, Hhd, Hhd, Gd^Fdw, Gd^Fdw, Gd, Hhd^Fdw, Gd^Ve, Gll^Fdw, Rp, Re, Gd^Fetd, Gd^Fdw
Md^Xm, Md^Xm, Md^Xm, Mm, Md, Md, Hhd, Hhd, Hhd^Fdw, Rb^Fdw, Hhd, Hhd, Md, Hhd, Hhd, Hhd, Hhd, Hhd, Hhd, Hhd, Gs, Md, Hhd^Fdw, Gd, Re, Rp, Rp, Gs, Gs^Es, Gs, Rp^Edt, Gs^Edt, Rp, Rp, Rp, Rp, Rp, Re, Gd^Efm, Gd, Gll^Fdw, Gll^Fdw
Md^Xm, Md^Xm, Md^Xm, Md, Hhd, Hhd, Rb^Fdw, Rb^Fdw, Yhs, Yhs, Hhd, Md, Md, Hhd, Gd^Fdw, Hhd, Hhd, Hhd, Gs, Gd, Gd^Ve, Hhd, Hhd^Fdw, Gs^Fdw, Rp, Gs, Gd^Fdw, Rp, Re^Es, Re, Gll^Fdw, Rp^Edt, Gd, Re, Gs, Re^Es, Rp, Re, Gs, Gs^Fdw, Gll^Fdw, Gll^Fdw
Md^Xm, Md^Xm, Md, Md, Md, Hhd, Rb^Fdw, Rb^Fdw, Yhs^Xp, Yhs^Xp, Rb^Fdw, Rb^Fdw, Hhd, Gd^Fdw, Gll^Fdw, Gll, Gd^Fdw, Gd, Gs, Gd^Fdw, Gd, Gd^Fdw, Gs, Rp, Gd, Gd, Gll^Fdw, Re, Gs, Gd, Gll^Fetd, Gll^Fdw, Gd, Gd, Wwf, Wwf^Es, Wwf^Bsb|, Wwf, Wwf, Wwf, Wwf, Gd^Fdw
Md^Xm, Md^Xm, Md^Xm, Md^Xm, Md, Hhd, Re^Edb, Yhs^Xp, Yhs^Xp, Yhs, Rb^Fdw, Hhd, Hhd, Gd, Gd^Fdw, Gll^Fdw, Gd, Gd, Hhd, Hhd, Gs, Gd, Gd, Rp, Re^Es, Gd^Fdw, Gll^Fdw, Rp, Gd^Fdw, Gll^Fdw, Gll^Fdw, Gll^Fdw, Wwf^Edt, Wwf, Wwf, Wwf, Wwf^Bsb|, Wwf, Wwf, Wwf, Wwf, Wwf
Md^Xm, Md^Xm, Md, Md, Hhd, Hhd, Re^Edb, Re^Edb, Gd, Rb^Fdw, Re, Gll, Gd, Gd, Gd^Efm, Gd^Fdw, Gd, Gs, Hhd, Hhd, Hhd, Rp, Rp, Re, Gd, Gll^Fdw, Rp, Rp, Gd^Edt, Gs^Edt, Cer^Edt, Wwf, Wwf, Wwf, Wwf, Wwf, Rp, Wwf, Wwf, Wwf, Wwf, Wwf
Md^Xm, Md^Xm, Md, Hhd, Hhd, Gs, Gd^Fdw, Re^Fdw, Gd, Gd, Gd^Es, Re^Vov, Re, Gd, Gs, Gd, Hhd, Hhd, Hhd, Hhd, Re, Rp, Rp, Rp, Gd, Rp, Gs, Gd, Gd^Edt, Cer^Edt, Wwf^Es, Wwf^Edt, Wwf, Wwf, Wwf^Es, Gd^Fdw, Rp, Gd^Fdw, Gd^Fdw, Gs^Fdw, Gd^Fdw, Wwf
Md, Md^Xm, Md, Hhd, Gs, Gd, Gd^Fetd, Gd^Ve, Hhd^Fdw, Gd^Edt, Gd^Edt, Re, Cvz^Edt, Cvz^Es, Cvrz, Gs, Gs, Gs, Re^Es, Re, Re^Fetd, Gd^Ve, Rp, Rp, Gs^Fdw, Gs^Fdw, Gd^Fdw, Gd^Fdw, Cer, Cer^Edt, Wwf, Wwf^Es, Wwf, Wwf, Wwf^Edt, Hhd, Re, Rp, Gll^Fdw, Gd^Fetd, Hhd, Gd^Fdw
Md, Md, Md, Hhd, Hhd^Fdw, Gd^Fdw, Gll^Fdw, Gll^Fdw, Yhs^Xp, Gs^Edt, Gd^Edb, Cvz^Edt, 5 Kvr, Cvrz^Es, Cvrz^Es, Rp, Rp, Gs^Efm, Rp, Re^Ve, Rp, Rp, Gd, Gd^Fdw, Gs, Gd^Fetd, Cer^Edb, Gd^Fdw, Wwf, Wwf^Es, Wwf, Wwf, Wwf^Es, Wwf^Edt, Gd^Edt, Gs^Ve, Gd^Fetd, Rp^Edb, Yhs^Edb, Hhd, Hhd, Hhd
Md^Xm, Md, Hhd, Hhd, Hhd, Hhd^Fdw, Gll^Fdw, Gll^Fdw, Yhs^Edb, Yhs^Edb, Gd^Fdw, Cvrz^Es, Cvz^Edt, Cvrz^Edt, Re, Re, Re, Re, Re, Rp, Gs^Edt, Gs, Gd, Gd, Cer, Cer^Edb, Wwf^Edb, Wwf^Edb, Wwf, Wwf, Wwf, Wwf, Wwf^Es, Wwf^Edt, Cer^Es, Gd, Re, Re^Edb, Yhs^Xp, Yhs^Xp, Hhd, Hhd
Md^Xm, Md, Md, Hhd, Hhd, Hhd, Hhd, Hhd, Hhd, Yhs^Xp, Yhs^Xp, Gd^Edt, Gd, Gd^Edt, Gll^Fdw, Gd^Fdw, Gd^Fdw, Re^Es, Re, Rp^Edt, Gs^Edt, Gd^Fetd, Gd^Efm, Gd, Wwf, Wwf^Edb, Wwf, Wwf, Wwf^Es, Wwf^Es, Yhs^Xp, Wwf, Cer^Es, Cer, 4 Ket, Cer^Edb, Rp^Edb, Yhs, Hhd, Hhd, Hhd, Md
Md^Xm, Md^Xm, Md^Xm, Md, Md^Xm, Md, Md, Md^Xm, Md, Hhd, Hhd, Gd, Gs, Gd^Ve, Gd, Gll^Fdw, Gd, Re, Gs, Rp, Gd, Gd, Gd^Edb, Gs^Edb, Wwf^Edb, Wwf^Es, Wwf, Wwf^Es, Yhs, Yhs, Yhs^Xp, Yhs^Xp, Cer^Es, Cer, Rp, Re^Edb, Gd, Hhd, Hhd, Md, Md, Md
Md^Xm, Md^Xm, Md^Xm, Md^Xm, Md^Xm, Md^Xm, Md^Xm, Md, Md, Md, Md, Hhd, Hhd, Gs, Hhd, Gs, Gd^Fdw, Gd, Gd^Fdw, Rr, Gd^Fdw, Gd^Edt, Gd^Fdw, Wwf^Edb, Wwf^Es, Wwf, Wwf^Edb, Wwf^Es, Yhs, Yhs^Xp, Yhs, Cer, Re, Rp, Gll^Fdw, Gd^Ve, Hhd, Hhd, Md, Md, Md, Md
Md^Xm, Md^Xm, Md^Xm, Md^Xm, Md^Xm, Md^Xm, Md^Xm, Md^Xm, Md, Md, Md, Hhd, Hhd^Fdw, Hhd, Hhd, Hhd^Fdw, Gd^Fdw, Gd^Fdw, Rr, Rr, Gd^Fdw, Gd^Es, Wwf, Wwf^Edb, Wwf^Es, Wwf^Es, Wwf^Edb, Rb^Fdw, Rb^Fdw, Yhs^Xp, Rd^Es, Re, Gll^Fdw, Gd^Fdw, Gd, Hhd, Hhd, Md^Xm, Md, Md, Md^Xm, Md^Xm
Md^Xm, Md^Xm, Md^Xm, Md^Xm, Md^Xm, Md^Xm, Md, Md, Hhd^Fdw, Md, Hhd, Hhd, Gll^Fdw, Gs, Gd, Gd^Ve, Gd^Fdw, Gd^Fetd, Rr, Gd, Wwf, Wwf, Wwf^Es, Wwf, Wwf^Es, Wwf^Es, Re^Fdw, Re^Fdw, Re^Fdw, Re, Rp, Gd^Fdw, Gll^Fdw, Gll^Fdw, Gd^Fdw, Gd^Fdw, Hhd, Md, Md, Md^Xm, Md^Xm, Md
Md^Xm, Md, Md^Xm, Md^Xm, Md, Md^Xm, Md^Xm, Md, Hhd, Gg^Ve, Rd, Gs, Rd, Gd, Gd, Rb^Fdw, Rb^Fdw, Rd, Gd^Fdw, Wwf^Es, Wwf, Wwf, Wwf, Wwf, Re^Fdw, Wwf, Re^Fdw, Re^Fdw, Re^Es, Re, Rd, Gd^Fdw, Gd^Fdw, Gs, Gd^Es, Gll^Fdw, Hhd, Md, Md, Md, Md, Md
Md, Md^Xm, Md^Xm, Md^Xm, Md^Xm, Md, Md, Md, Hhd, Rb^Fdw, Rd^Edb, Re, Rb^Fetd, Rb^Fdw, Gll^Fdw, Rb^Fdw, Rd, Rd, Wwf^Es, Wwf^Es, Wwf, Wwf^Es, Rb^Edt, Re^Fetd, Re^Fdw, Re^Fdw, Re^Fdw, Rb, Re^Ve, Rd, Rp, Gs, Gd, Gs, Yhs^Xp, Rb, Rb, Hhd, Hhd, Md, Md, Mm^Xm
Md, Md^Xm, Md^Xm, Md^Xm, Md, Md, Hhd, Rb^Fdw, Yhs, Yhs^Xp, Yhs^Edb, Yhs^Edb, Rb, Rb^Fdw, Rd, Rd, Gd^Fdw, Wwf, Wwf^Es, Wwf, Wwg, Rb^Edt, Rb^Edt, Rb^Fdw, Rb^Fdw, Rb^Fdw, Rb^Fdw, Rb, Rb^Fdw, Re, Rp^Edt, Gd^Fetd, Gs^Es, Yhs^Xp, Rb^Fdw, Rb^Fdw, Rb^Fdw, Hhd, Rb^Fdw, Hhd, Md, Md
Md, Md, Md, Md^Xm, Md, Hhd, Rb^Fdw, Yhs, Rb, Yhs, Yhs, Rb, Rb^Fdw, Rb^Fdw, Rd, Gd^Fdw, Wwf, Wwf, Wwf^Es, Wwf, Wwg, Sm, Sm, Rb, Sm, Rb, Sm, Sm, Rb^Fdw, Re^Edt, Yhs^Edt, Yhs^Edb, Yhs^Edb, Yhs^Edb, Yhs^Xp, Yhs, Rb^Fdw, Rb^Fdw, Rb^Fdw, Hhd, Md, Md
Md, Md, Hhd, Md, Md, Hhd, Gs, Rb, Yhs, Yhs^Xp, Rd, Gs, Rd^Edt, Rd, Gd^Fdw, Wwf^Bsb\, Wwf^Bsb\, Wwf^Es, Wwf, Wwf, Wwf, Wwg, Sm, Rb, Sm, Cvz^Es, Cvz^Es, Cvrz, Cvrz, Yhs^Edt, Yhs^Xp, Yhs^Xp, Yhs^Edb, Yhs^Edb, Rb^Fdw, Rb^Fdw, Rb^Fdw, Yhs, Hhd, Hhd, Md, Md
Hhd, Hhd, Hhd, Md, Hhd, Hhd^Fdw, Gs, Hhd, Rd^Edb, Rd, Yhs, Gd, Gd^Edt, Gd^Edt, Wwf, Wwf^Es, Wwf, Rp, Gd^Ve, Gd^Fdw, Gd^Fdw, Sm, Sm, Sm, Sm, Sm, Cvrz^Es, 2 Kv, Cvrz, Yhs, Rd, Gd, Gd, Rb^Fdw, Yhs, Yhs, Yhs, Hhd, Md, Md, Md, Md^Xm
Gll^Fdw, Hhd, Hhd, Hhd, Hhd, Hhd^Fdw, Yhs, Gd^Fetd, Yhs^Edb, Yhs^Edb, Gs^Edb, Gd, Gs^Fdw, Wwf, Wwg, Wwg, Cvrz, Cvrz, Cvrz^Es, Gd^Fet, Gd^Fdw, Rb^Fdw, Rb^Fdw, Sm, Sm, Sm, Cvz, Cvz^Es, Re^Edt, Cvz, Gd, Gd^Ve, Yhs, Rb^Fdw, Rb^Fdw, Yhs^Xp, Yhs, Hhd, Hhd, Md, Md^Xm, Md^Xm
Gll^Fdw, Gll^Fdw, Gd^Fdw, Gll^Fdw, Yhs, Yhs, Rd, Rd^Edb, Yhs^Edb, Yhs^Xp, Gd, Gd^Fdw, Wwf^Es, Wwf, Wwg, Wwg, Cvz^Edt, 3 Kvr, Cvz, Rd, Rd^Edt, Rb^Fdw, Re, Rb, Rb, Rb, Re, Re^Edt, Rd^Edt, Rp, Gd^Fdw, Gll, Yhs, Yhs^Xp, Rb^Fdw, Yhs, Hhd^Fdw, Hhd, Md, Md, Md^Xm, Md^Xm
Gd, Gd^Fdw, Gd, Gd^Fdw, Yhs^Edb, Yhs^Xp, Rd, Gll^Fdw, Yhs^Xp, Yhs, Gd, Gs, Wwf, Wwf, Wwf^Es, Wwf^Es, Rd^Edt, Cvrz^Edt, Gs^Fdw, Cvrz^Es, Rd^Edt, Re, Gd^Fdw, Re, Re, Gd^Fdw, Gd^Fdw, Gd^Ve, Rb^Fdw, Rp, Rr^Edb, Rb^Fdw, Rb^Fdw, Rb, Rb^Fdw, Rb^Fdw, Hhd, Hhd, Md^Xm, Md, Md^Xm, Md^Xm
Gll, Gd, Gd^Ve, Gd, Rd^Edb, Rd^Edb, Hhd^Fdw, Gd^Fdw, Gd, Gs, Gd^Fdw, Wwf^Es, Wwf, Wwf, Wwf, Gs^Ve, Rd, Rd^Edt, Gd, Rd, Rd^Ve, Gd^Fdw, Gll^Fdw, Re, Re, Gll^Fdw, Gll^Fdw, Rb^Fdw, Yhs^Edb, Yhs^Edb, Rr^Edb, Rr^Edb, Yhs, Yhs, Rb^Fdw, Rb^Fdw, Hhd, Md, Md^Xm, Md, Md, Md
Rd, Rd, Rd, Rd, Hhd, Hhd, Yhs^Xp, Yhs^Xp, Gd, Gd, Wwf^Es, Wwf, Wwf^Es, Wwf, Gd^Fdw, Rd, Gs^Fdw, Gd^Fdw, Gd, Rp, Gd^Efm, Gll^Fdw, Gll^Fdw, Gd^Fdw, Rd, Gd^Efm, Gll, Rb^Fdw, Yhs, Yhs^Xp, Rb^Fdw, Rr^Edb, Gd^Fdw, Rb^Fdw, Gd^Fetd, Hhd, Md, Md, Hhd, Md, Md, Md
Gll^Fdw, Gd^Ve, Gll^Fdw, Hhd, Hhd, Hhd, Yhs, Yhs, Gd, Wwf, Wwf^Es, Wwf, Wwf, Gs^Fdw, Gd^Fdw, Rp, Gs^Fet, Gd^Efm, Rp, Rp, Gd^Fdw, Gll^Fdw, Gd, Gd^Fdw, Rp, Gd, Gd^Fdw, Gll, Gll^Fdw, Rb^Fdw, Gd^Fdw, Rr, Rp^Edt, Yhs^Dr, Yhs^Xp, Yhs^Xp, Md, Md, Md, Hhd, Md, Md
Gll^Fdw, Gll^Fdw, Hhd^Fdw, Hhd^Fdw, Hhd, Yhs, Hhd, Gd, Wwf, Wwf^Es, Wwf, Wwf^Es, Gd^Ve, Gd^Fdw, Gll^Fdw, Rp, Rp, Rd, Gd^Fdw, Gll, Gd^Fdw, Gll^Fdw, Gs, Gd, Gd^Fdw, Rp, Rd, Gd^Ve, Gd^Fetd, Gd, Gd^Fdw, Gd^Fdw, Rp^Edt, Rd^Edt, Hhd, Yhs^Edt, Gs, Md, Hhd, Hhd, Md, Md
Gll, Gll^Fdw, Gd, Hhd, Hhd, Hhd, Ww, Wwf^Es, Wwf, Wwf^Es, Gg^Fdw, Gd, Gs^Fdw, Gd^Fdw, Gs^Fdw, Rp, Rd, Gs^Fdw, Gs, Gd, Gll^Fdw, Gll^Fdw, Ww, Gd^Fdw, Gs^Fdw, Gd^Fdw, Rd, Gll^Fdw, Gll^Fdw, Gd^Fdw, Gs^Fdw, Rd, Gd^Fdw, Rd^Edt, Rd, Gd^Fdw, Hhd, Gd^Fdw, Hhd, Md, Mm^Xm, Mm^Xm
