Xos, Xos, Xos, Xos, Xos, Xos, Xos, Xos, Xos^Efs, Xos, Xos, Xos, Xos, Xos, Xos, Xos, Xos, Xos, Xos, Xos, Xos, Xuc, Xuc, Xuc, Xuc, Xuc, Xuc, Xos, Xos, Xos, Xom, Xos, Xos, Xos, Xos^Efs, Xos, Xos, Xos, Xos^Efs, Xos, Xos, Xos, Xos, Xos
Xos, Xos, Xos, Xos, Xos, Xos, Xos, Xos^Efs, Ur, Ur, Ur, Xos, Xos^Efs, Xos, Xos, Uu^Ii, Rrc, Xos, Ur, Xos, Xuc, Xuc, Xuc, Xuc, Xuc, Xuc, Xos^Efs, Xos^Efs, Ur, Xos, Ur, Xom, Xom, Xos^Efs, Ur, Ur, Ur, Ur, Ur, Xos^Efs, Xos, Xos, Xos, Xol
Xos, Xos, Xos, Xos, Xos^Efs, Xos^Efs, Ur^Es, Ur, Rrc, Rrc, Rrc, Ur, Ur^Es, Xos^Efs, Xos, Xos, Ur, Rrc, Rrc, Ur^Es, Ur, Xu, Xuc, Xuc, Xos^Efs, Xuc, Ur, Ur^Em, Rrc, Ur, Rrc, Ur, Ur, Ur, Rrc, Rrc, Rrc, Rrc, Rrc, Ur, Ur^Zz/, Xos^Efs, Qxu, Qxu
Ur^Ii, Xos^Efs, Ur, Xos, Ur, Ur, Rrc, Rrc^Es, Ur, Ur^Em, Ur, Rrc, Ur, Xos, Xos, Xos, Xos, Ur, Ur, Rrc, Kud, Cud, Xos, Xos^Efs, Uu^Em, Ur^Ii, Rrc, Rrc, Ur, Rrc, Ur, Rrc, Rrc, Rrc, Ur, Ur, Ur, Ur, Ur^Zz/, Rrc^Zz/, Rrc, Ur, Ur, Xos
Rrc^Ii, Ur^Ii, Rrc, Ur, Rrc, 1 Rrc, Ur, Ur, Xos, Xos, Ur^Es, Rrc, Ur, Xos, Cud, Yhr^Xp, Xos, Xos, Xos, Cud, Rrc, Ur, Ur, Uu^Pr\, Rrc^Pr\, Rrc, Ur, Ur^Em, Xos, Ur, Xos, Uu^Em, Rrc, Ur, Xos, Xos, Xos, Xos, Xos^Efs, Ur, Ur^Es, Rrc, Rrc, Ur
Ur^Ii, Rrc^Ii, Ur^Ii, Rrc, Ur, Ur, Xos, Xos, Xos, Xos, Ur, Rrc, Rrc, Ur, Ur, Xos, Cud, Yhr^Xp, Xos, Ur, Rrc, Ur, Rrc, Rrc, Uh, Uu^Pr\, Xos, Ur, Xos, Cud, Xos, Uu^Es, Rrc, Ur, Xos^Efs, Xos, Xos, Xos^Efs, Qxu, Qxu, Xos, Ur^Em, Ur, Rrc
Xos, Ur^Ii, Xos, Ur, Xos, Xos, Xos, Xos, Xos, Xos, Ur, Rrc, Rrc^Es, Rrc, Rrc, Ur, Ur, Xos, Ur, Ur, Rrc, Rrc, Ur, Uu^Es, Xos, Xos, Xos, Cud, Xos, Yhr^Xp, Xos, Ur, Rrc, Uu, Uh, Xos^Efs, Xos, Qxu, Qxu, Qxu, Qxu, Qxu, Xos, Ur
Ur, Xos^Efs, Xos^Efs, Xos, Xos, Xos, Xos, Xos, Xos^Efs, Xos, Ur^Zz\, Rrc, Ur, Ur, Ur^Es, Rrc, Rrc, Ur, Rrc, Rrc, Ur, Ur, Wwg, Xos, Xos, Xos, Xos, Yhr^Xp, Xos, Xos, Yhr^Xp, Cud, Uh, Rrc, Rrc, Uu^Es, Xos, Xos, Xos, Qxu, Qxu, Qxu, Qxu, Qxu
Rrc, Ur, Ur, Xos, Xos^Efs, Xos, Ur, Xos, Xos^Efs, Xos, Ur, Rrc^Zz\, Ur^Zz\, Xos, Xos, Ur, Ur, Rrc, Ur, Ur, Wwg, Xos, Wwg^Xo, Wwg^Xo, Wwg, Wwf^Es, Wwg, Xos^Xzm\, Xos^Xzm\, Xos, Xos, Xos, Cud, Rrc, Rrc, Rrc, Rrc^Zz/, Xos, Uh, Xol, Xom, Qxu, Qxu, Qxu
Ur, Rrc, Rrc^Pr/, Ur^Pr/, Ur, Ur^Es, Rrc, Ur, Ur, Ur, Rrc, Rrc, Ur, Xos, Xos, Xos, Xos, Ur, Wwg, Xos, Wwg^Xo, Wwg^Xo, Wwg, Wog, Wog, Wwg, Wwf, Wwf, Xos, Xos, Xos, Yhr^Xp, Xos, Rrc, Xos, Rrc^Zz/, Rrc, Rrc, Rrc, Uu^Em, Uu^Emf, Xom, Xos, Qxu
Xos, Ur^Pr/, Ur, Rrc, Rrc, Rrc, Wwg, Rrc, Rrc, Rrc, Ur, Ur, Xos, Xos, Xos, Xos, Xos, Xos, Xos, Wwg^Xo, Wwg, Wog, Wog, Wog, Wog, Wwg, Wwg, Wwf^Es, Wwg, Xos^Xzm\, Xos, Xos, Xos, Rrc^Pr/, Xos, Xos, Xos, Rrc, Rrc, Rrc, Uu^Em, Xom, Xos, Xos
Xos, Xos, Ur, Rrc, Wwg, Wwg, Gs^Efm, Wwg, Wwg^Bw/, Rrc, Ur, Xos, Xuc, Xuc, Xuc, Xos, Xos, Xos, Xos, Wwg, Wwg, Wwg, Wwg, Wog, Wog, Wog, Wwg, Wwg, Wwg^Xo, Xos, Xos^Efs, Xos, Uu, Rrc, Uu, Uu, Uu^Em, Uu^Es, Rrc, Rrc, Uh, Xos, Yhr^Pr\, Yhr
Xos, Xos, Ur, Rrc, Wwg, Gs^Efm, Gs^Fet, Gs, Wwg, Rrc, Rrc, Ur, Xu, Xuc, Xos, Xos, Xos, Xos, Xos, Wwf^Es, Wwg, Wwg, Wog, Wog, Wog, Wwg, Wwg, Wwg^Xo, Wwg, Wwg, Uh, Uh, Rrc, Rrc, Xos, Uu^Vud, Rrc, Rrc, Rrc, Rrc, Uu^Vu, Uh, Xos, Xos
Xos, Xos, Ur, Rrc, Wwg, Gs, Gs, Gs^Efm, Wwg^Bw\, Rrc, Rrc, Ur, Xuc, Xos, Yhr, Xos, Xos, Xos, Xos, Wwg, Wwg, Wog, Wog, Wog, Wog, Wog, Wwg^Xo, Wwg^Xo, Wwg, Uu^Es, Rrc, Rrc, Rrc, Yhr^Xp, Yhr^Xp, Yhr, Cud, Rrc, Rrc, Rrc, Rrc, Uh, Xos, Xos
Xos, Xos, Ur, Rrc, Rrc, Wwg, Wwg, Wwg, Rrc, Rrc, Rrc, Cud, Cud, Yhr^Xp, Xos, Xos, Yhr, Xos, Xos, Wwg, Wwf^Es, Wwg, Wog, Wog, Wog, Wog, Wwg^Xo, Wwg, Uu, Uu^Em, Rrc, Rrc, Rrc, Rrc, Rrc, Cud, 2 Urb^Kov, Cud, Yhr^Xp, Yhr, Uh, Uu^Em, Yhr^Pr/, Xos
Xos, Xos, Xos, Ur, Ur, Rrc, Rrc, Rrc, Ur, Ur, Cud, 3 Kud, Rrc, Ur, Ur, Yhr^Xp, Xos, Xos, Xos, Xos, Wwg, Wwg, Wwg, Wwg, Wwg, Wwg, Xos, Xos, Uu^Em, Uu^Vu, Rrc, Rrc, Yhr, Xos, Yhr^Xp, Cud, Cud, Cud, Yhr^Xp, Xos, Uu, Xos, Xos, Yhr
Xos, Xos, Xos, Xos, Xos, Ur, Ur, Ur, Xos, Xos, Xos, Cud, Ur, Rrc, Ur, Xos, Uu, Xos, Uu, Xos, Uu, Uu^Em, Uu^Vud, Wwf^Es, Xom, Xos, Xos, Xos, Yhr^Xp, Uu^Es, Uu, Rrc, Rrc, Yhr^Xp, Rrc, Rrc, Yhr^Xp, Rrc, Rrc, Uu, Xos, Yhr^Pr/, Yhr, Xos
Xos, Xos, Xos, Xos, Xos, Xos, Xos, Xos, Xos, Xos, Xos, Xos, Ur, Rrc, Rrc, Ur^Zz\, Rrc, Uu^Em, Rrc, Uu, Rrc, Rrc, Rrc, Uu, Cud, Xom, Xos^Efs, Yhr, Xos, Xos, Yhr^Xp, Uu^Em, Uu^Em, Rrc, Rrc, Rrc, Xos, Yhr, Rrc, Uu, Xos, Xos, Xos, Yhr
Xos, Xos, Rrc, Ur, Xos, Xos, Xos, Xos, Xos, Xos, Xos, Xos, Ur^Em, Rrc, Ur, Rrc^Zz/, Uu, Rrc, Uu, Rrc, Uu^Em, Uu^Em, Cud, 4 Kud, Rrc, Uu, Uu, Xos^Efs, Xom, Yhr, Xos, Xos, Yhr^Xp, Uu, Uu, Rrc, Rrc, Yhr^Xp, Rrc, Uu^Es, Xos, Xos, Xos, Xos
Xos, Ur, Rrc^Pr/, Ur^Pr/, Xos, Xos, Xuc, Xos, Xos, Xos, Xos, Xos, Ur^Es, Rrc, Ur, Ur^Zz\, Xos, Uu, Xos, Uu^Emf, Xos, Xos, Xos, Uu, Uu^Es, Rrc, Rrc, Uu, Uu, Xom, Xom, Yhr, Xos, Xos, Xos, Uu^Es, Uu^Es, Rrc, Rrc, Uu, Uu, Yhr^Xp, Yhr^Xp, Xos
Xos, Ur^Pr/, Rrc, Ur^Es, Xuc, Xuc, Xuc, Xuc, Xos, Xos, Xos, Xos, Ur, Rrc, Ur, Xos, Xos, Xos, Xos, Xos, Xos, Xos, Xos, Uu, Xos, Uu, Rrc, Rrc, Rrc, Uu, Uu, Xos, Xos, Xos, Xos, Xos, Xos, Uh, Uu, Rrc, Rrc, Uu, Xos, Xos
Xos, Ur^Em, Rrc, Ur, Ur^Ii, Xuc, Xuc, Xos, Xos, Xos, Xos, Xos, Ur, Rrc, Ur^Em, Xos, Xos, Xos, Xos, Xos, Xos, Xos, Yhr^Pr|, Yhr^Xp, Xos, Uu, Rrc, Uu, Uu, Rrc, Rrc^Pr/, Uu^Pr/, Uu, Yhr^Xp, Yhr^Xp, Xos^Xzm\, Xos^Xzm\, Xos, Xos, Uh, Rrc, Uu, Xos, Xos
Xom, Ur, Rrc, Uh, Xos, Xuc, Xos, Xos, Xos, Xos, Xos, Xos, Ur, Rrc, Ur^Em, Xos, Xos, Xos, Xos, Xos, Xos, Xos, Yhr, Xos, Xos^Efs, Uu, Rrc, Uu, Xos, Uu^Pr/, Rrc, Rrc, Rrc, Uu, Uu^Vud, Yhr, Xos, Xos, Xos, Uh, Rrc, Uu, Xos, Xos
Xom, Ur, Rrc, Uu^Em, Xos, Xos, Xos, Xos, Yhr, Xos, Xom, Xuc, Ur^Em, Rrc, Ur, Xos, Xos, Xos, Xos, Xos, Xos, Yhr, Xos, Xos^Efs, Uu, Uu, Rrc, Uu, Xos, Uu^Em, Rrc, Uu^Ii, Uu, Rrc, Rrc, Uu, Xom, Xos, Xos, Uu, Rrc, Uu, Xos^Efs, Xos
Xom, Ur, Rrc, Uu, Xos, Xos, Yhr, Xos, Xos, Yhr^Pr/, Yhr^Xp, Xuc, Ur^Es, Rrc, Ur, Xos, Xos, Xos, Xos, Xos, Xos^Efs, Yhr^Xp, Uu, Uu, Rrc, Rrc, Uu^Em, Uu, Xos, Uu, Rrc, Uu, Xos, Uu, Rrc, Uu^Efs, Uu, Xol^Xzm/, Uu, Uu, Rrc, Uu, Uu^Uf, Xos^Efs
Xos, Ur^Es, Rrc, Ur, Xos, Xos, Xos, Yhr^Pr/, Yhr^Xp, Xos, Ur, Ur, Rrc, Rrc, Ur, Xos, Yhr, Xos, Xos, Xos^Efs, Uu^Em, Uu^Es, Rrc, Rrc, Uu, Uu, Xom^Efs, Xom, Uu, Uu^Efs, Rrc, Uu, Xos, Uh, Uu, Rrc, Rrc, Uu, Rrc, Uu^Em, Rrc, Uu^Vud, Uh, Xu
Xos, Ur^Es, Rrc, Ur, Ur, Xos, Ur, Xos, Ur, Ur, Rrc, Rrc, Ur, Ur, Yhr^Xp, Xos, Xos, Yhr^Pr/, Yhr^Xp, Uh, Rrc, Rrc^Es, Uu, Uu, Xos, Xos^Efs, Uu, Uu, Rrc, Rrc, Uu^Em, Uu, Xos, Xos, Xos, Uh, Uu^Uf, Rrc, Uu, Rrc, Uu, Uu^Uf, Uh, Xu
Yhr^Pr\, Ur, Ur^Es, Rrc, Rrc, Ur, Rrc, Ur, Rrc, Rrc, Ur, Ur, Yhr^Xp, Xos, Xos, Yhr^Pr/, Yhr, Xos, Xos^Efs, Uu, Rrc, Uu^Em, Xos^Efs, Xos, Uu, Uh, Rrc, Rrc, Uu, Uu, Yhr^Xp, Yhr^Xp, Xos, Xos, Xos, Xos, Xos, Uu, Xos, Uu, Xos, Uh, Xos, Xuc
Xos, Xos, Yhr^Xp, Ur, Ur, Rrc, Ur, Rrc, Ur, Ur^Es, Yhr^Xp, Xos, Xos, Yhr^Pr/, Yhr, Xos, Xos, Yhr^Pr/, Yhr^Xp, Uu, Rrc, Uu^Em, Uu, Uh, Rrc, Rrc, Uu, Uu, Xos, Xos, Xos, Xos, Xos, Xos, Xos, Xos, Xos, Yhr^Xp, Xos, Yhr^Xp, Xos, Yhr^Xp, Xos, Xuc
Yhr, Yhr^Pr\, Xos, Xos, Yhr^Xp, Ur, Yhr^Xp, Ur, Yhr^Xp, Xos, Xos, Yhr^Pr/, Yhr, Xos, Xos, Xos, Xos, Xos, Xos, Uh, Uu^Vu, Rrc, Rrc, Rrc, Uu, Uu, Yhr^Xp, Yhr^Xp, Xos, Xos, Xos, Xos, Xos, Xos, Xuc, Xuc, Xuc, Yhr, Xos, Yhr, Xos, Yhr, Xuc, Xuc
Xos, Xos, Xos, Xos, Yhr^Pr\, Xos, Xos, Xos, Yhr^Pr/, Xos, Xos, Xos, Xos, Xos, Xos, Xos, Xos, Xos, Xos, Uh, Uh, Uu^Em, Uh, Uh, Xos, Xos, Xos, Xos, Xos, Xos, Xos, Xos, Xuc, Xuc, Xuc, Xuc, Xuc, Xuc, Xuc, Xuc, Xuc, Xuc, Xuc, Xuc
Xos, Xos, Xos, Yhr, Xos, Xos, Xos, Xos, Xos, Yhr, Xos, Xos, Xos, Xos, Xos, Xos, Xos, Xos, Xos, Xos, Xos, Xos, Xos, Xos, Xos, Xos, Xos, Xos, Xos, Xos, Xuc, Xuc, Xuc, Xuc, Xuc, Xuc, Xuc, Xuc, Xuc, Xuc, Xuc, Xuc, Xuc, Xuc
