Xos, Xos, Xos, Xos, Xos, Xos, Xos, Xos, Xos^Efs, Xos, Xos, Xos, Xos, Xos, Xos, Xos, Xos, Xos, Xos, Xos, Xos, Xuc, Xuc, Xuc, Xuc, Xuc, Xuc, Xos, Xos, Xos, Xom, Xos, Xos, Xos, Xos^Efs, Xos, Xos, Xos, Xos^Efs, Xos, Xos, Xos, Xos, Xos
Xos, Xos, Xos, Xos, Xos, Xos, Xos, Xos^Efs, Ur, Ur, Ur, Xos, Xos^Efs, Xos, Xos, Uu^Ii, Rr, Xos, Ur, Xos, Xuc, Xuc, Xuc, Xuc, Xuc, Xuc, Xos^Efs, Xos^Efs, Ur, Xos, Ur, Xom, Xom, Xos^Efs, Ur, Ur, Ur, Ur, Ur, Xos^Efs, Xos, Xos, Xos, Xos
Xos, Xos, Xos, Xos, Xos^Efs, Xos^Efs, Ur^Es, Ur, Rr, Rr, Rr, Ur, Ur^Es, Xos^Efs, Xos, Xos, Ur, Rr, Rr, Ur^Es, Ur, Xu, Xuc, Xuc, Xos^Efs, Xuc, Ur, Ur^Em, Rr, Ur, Rr, Ur, Ur, Ur, Rr, Rr, Rr, Rr, Rr, Ur, Ur^Zz/, Xos^Efs, Qxu, Qxu
Ur^Ii, Xos^Efs, Ur, Xos, Ur, Ur, Rr, Rr^Es, Ur, Ur^Em, Ur, Rr, Ur, Xos, Xos, Xos, Xos, Ur, Ur, Rr, Kud, Cud, Xos, Xos^Efs, Uu^Em, Ur^Ii, Rr, Rr, Ur, Rr, Ur, Rr, Rr, Rr, Ur, Ur, Ur, Ur, Ur^Zz/, Rr^Zz/, Rr, Ur, Ur, Xos
Rr^Ii, Ur^Ii, Rr, Ur, Rr, 1 Rr, Ur, Ur, Xos, Xos, Ur^Es, Rr, Ur, Xos, Cud, Yhr^Xp, Xos, Xos, Xos, Cud, Rr, Ur, Ur, Uu^Pr\, Rr^Pr\, Rr, Ur, Ur^Em, Xos, Ur, Xos, Uu^Em, Rr, Ur, Xos, Xos, Xos, Xos, Xos^Efs, Ur, Ur^Es, Rr, Rr, Ur
Ur^Ii, Rr^Ii, Ur^Ii, Rr, Ur, Ur, Xos, Xos, Xos, Xos, Ur, Rr, Rr, Ur, Ur, Xos, Cud, Yhr^Xp, Xos, Ur, Rr, Ur, Rr, Rr, Uh, Uu^Pr\, Xos, Ur, Xos, Cud, Xos, Uu^Es, Rr, Ur, Xos^Efs, Xos, Xos, Xos^Efs, Qxu, Qxu, Xos, Ur^Em, Ur, Rr
Xos, Ur^Ii, Xos, Ur, Xos, Xos, Xos, Xos, Xos, Xos, Ur, Rr, Rr^Es, Rr, Rr, Ur, Ur, Xos, Ur, Ur, Rr, Rr, Ur, Uu^Es, Xos, Xos, Xos, Cud, Xos, Yhr^Xp, Xos, Ur, Rr, Uu, Uh, Xos^Efs, Xos, Qxu, Qxu, Qxu, Qxu, Qxu, Xos, Ur
Ur, Xos^Efs, Xos^Efs, Xos, Xos, Xos, Xos, Xos, Xos^Efs, Xos, Ur^Zz\, Rr, Ur, Ur, Ur^Es, Rr, Rr, Ur, Rr, Rr, Ur, Ur, Wwg, Xos, Xos, Xos, Xos, Yhr^Xp, Xos, Xos, Yhr^Xp, Cud, Uh, Rr, Rr, Uu^Es, Xos, Xos, Xos, Qxu, Qxu, Qxu, Qxu, Qxu
Rr, Ur, Ur, Xos, Xos^Efs, Xos, Ur, Xos, Xos^Efs, Xos, Ur, Rr^Zz\, Ur^Zz\, Xos, Xos, Ur, Ur, Rr, Ur, Ur, Wwg, Xos, Wwg^Xo, Wwrg^Xo, Wwg, Wwf^Es, Wwrg, Xos^Xzm\, Xos^Xzm\, Xos, Xos, Xos, Cud, Rr, Rr, Rr, Rr^Zz/, Xos, Uh, Xos^Efs, Xom^Efs, Qxu, Qxu, Qxu
Ur, Rr, Rr^Pr/, Ur^Pr/, Ur, Ur^Es, Rr, Ur, Ur, Ur, Rr, Rr, Ur, Xos, Xos, Xos, Xos, Ur, Wwg, Xos, Wwg^Xo, Wwg^Xo, Wwg, Wog, Wog, Wwrg, Wwf, Wwf, Xos, Xos, Xos, Yhr^Xp, Xos, Rr, Xos, Rr^Zz/, Rr, Rr, Rr, Uu^Em, Uu^Emf, Xom, Xos, Qxu
Xos, Ur^Pr/, Ur, Rr, Rr, Rr, Wwg, Rr, Rr, Rr, Ur, Ur, Xos, Xos, Xos, Xos, Xos, Xos, Xos, Wwrg^Xo, Wwg, Wog, Wog, Wog, Wog, Wwg, Wwg, Wwf^Es, Wwg, Xos^Xzm\, Xos, Xos, Xos, Rr^Pr/, Xot, Xos, Xos, Rr, Rr, Rr, Uu^Em, Xom, Xos, Xos
Xos, Xos, Ur, Rr, Wwg, Wwg, Gs^Efm, Wwg, Wwg^Bw/, Rr, Ur, Xos, Xuc, Xuc, Xuc, Xos, Xos, Xos, Xos, Wwg, Wwg, Wwrg, Wwrg, Wog, Wog, Wog, Wwg, Wwg, Wwg^Xo, Xos, Xos^Efs, Xos, Uu, Rr, Uu, Uu, Uu^Em, Uu^Es, Rr, Rr, Uh, Xos, Yhr^Pr\, Yhr
Xos, Xos, Ur, Rr, Wwg, Gs^Efm, Gs^Fet, Gs, Wwg, Rr, Rr, Ur, Xu, Xuc, Xot, Xos, Xos, Xos, Xos, Wwf^Es, Wwg, Wwrg, Wog, Wog, Wog, Wwg, Wwrg, Wwrg^Xo, Wwg, Wwg, Uh, Uh, Rr, Rr, Xos, Uu^Dr, Rr, Rr, Rr, Rr, Uu^Vu, Uh, Xos, Xos
Xos, Xos, Ur, Rr, Wwg, Gs, Gs, Gs^Efm, Wwg^Bw\, Rr, Rr, Ur, Xuc, Xos, Yhr, Xos, Xos, Xos, Xos, Wwrg, Wwg, Wog, Wog, Wog, Wog, Wog, Wwrg^Xo, Wwrg^Xo, Wwg, Uu^Es, Rr, Rr, Rr, Yhr^Xp, Yhr^Xp, Yhr, Cud, Rr, Rr, Rr, Rr, Uh, Xos, Xos
Xos, Xos, Ur, Rr, Rr, Wwg, Wwg, Wwg, Rr, Rr, Rr, Cud, Cud, Yhr^Xp, Xos, Xos, Yhr, Xos, Xos, Wwg, Wwf^Es, Wwg, Wog, Wog, Wog, Wog, Wwg^Xo, Wwg, Uu, Uu^Em, Rr, Rr, Rr, Rr, Rr, Cud, 2 Urb^Kov, Cud, Yhr^Xp, Yhr^Yva, Uh, Uu^Em, Yhr^Pr/, Xos
Xos, Xos, Xos, Ur, Ur, Rr, Rr, Rr, Ur, Ur, Cud, 3 Kud, Rr, Ur, Ur, Yhr^Xp, Xos, Xos, Xos, Xos, Wwg, Wwg, Wwg, Wwg, Wwg, Wwg, Xos, Xos, Uu^Em, Uu^Vu, Rr, Rr, Yhr, Xos, Yhr^Xp, Cud, Cud, Cud, Yhr^Xp, Xos, Uu, Xos, Xos, Yhr
Xos, Xos, Xos, Xos, Xos, Ur, Ur, Ur, Xos, Xos, Xos, Cud, Ur, Rr, Ur, Xos, Uu, Xos, Uu, Xos, Uu, Uu^Em, Uu^Dr, Wwf^Es, Xom, Xos, Xos, Xos, Yhr^Xp, Uu^Es, Uu, Rr, Rr, Yhr^Xp, Rr, Rr, Yhr^Xp, Rr, Rr, Uu, Xos, Yhr^Pr/, Yhr, Xos
Xos, Xos, Xos, Xos, Xos, Xos, Xos, Xos, Xos, Xos, Xos, Xos, Ur, Rr, Rr, Ur^Zz\, Rr, Uu^Em, Rr, Uu, Rr, Rr, Rr, Uu, Cud, Xom, Xos^Efs, Yhr, Xot, Xos, Yhr^Xp, Uu^Em, Uu^Em, Rr, Rr, Rr, Xos, Yhr, Rr, Uu, Xos, Xos, Xos, Yhr
Xos, Xos, Rr, Ur, Xos, Xos, Xos, Xos, Xos, Xos, Xos, Xos, Ur^Em, Rr, Ur, Rr^Zz/, Uu, Rr, Uu, Rr, Uu^Em, Uu^Em, Cud, 4 Kud, Rr, Uu, Uu, Xos^Efs, Xom, Yhr^Yva, Xos, Xos, Yhr^Xp, Uu, Uu, Rr, Rr, Yhr^Xp, Rr, Uu^Es, Xos, Xos, Xot, Xos
Xos, Ur, Rr^Pr/, Ur^Pr/, Xos, Xos, Xuc, Xos, Xos, Xos, Xos, Xos, Ur^Es, Rr, Ur, Ur^Zz\, Xos, Uu, Xos, Uu^Emf, Xos, Xos, Xos, Uu, Uu^Es, Rr, Rr, Uu, Uu, Xom, Xom, Yhr, Xos, Xos, Xos, Uu^Es, Uu^Es, Rr, Rr, Uu, Uu, Yhr^Xp, Yhr^Xp, Xos
Xos, Ur^Pr/, Rr, Ur^Es, Xuc, Xuc, Xuc, Xuc, Xos, Xos, Xos, Xos, Ur, Rr, Ur, Xos, Xos, Xos, Xos, Xos, Xos, Xos, Xos, Uu, Xos, Uu, Rr, Rr, Rr, Uu, Uu, Xos, Xos, Xos, Xos, Xos, Xos, Uh, Uu, Rr, Rr, Uu, Xos, Xos
Xos, Ur^Em, Rr, Ur, Ur^Ii, Xuc, Xuc, Xos, Xos, Xos, Xos, Xos, Ur, Rr, Ur^Em, Xos, Xos, Xos, Xos, Xos, Xos, Xos, Yhr^Pr|, Yhr^Xp, Xos, Uu, Rr, Uu, Uu, Rr, Rr^Pr/, Uu^Pr/, Uu, Yhr^Xp, Yhr^Xp, Xos^Xzm\, Xos^Xzm\, Xos, Xos, Uh, Rr, Uu, Xos, Xos
Xom, Ur, Rr, Uh, Tb^Tf, Uu, Xos, Xos, Xos, Xos, Xos, Xos, Ur, Rr, Ur^Em, Xos, Xos, Xos, Xos, Xos, Xos, Xos, Yhr, Xos, Xos^Efs, Uu, Rr, Uu, Xos, Uu^Pr/, Rr, Rr, Rr, Uu, Uu^Dr, Yhr^Yva, Xos, Xos, Xos, Uh, Rr, Uu, Xos, Xos
Xom, Ur, Rr, Uu^Em, Uh, Uh, Xos, Xos, Yhr, Xos, Xom, Xuc, Ur^Em, Rr, Ur, Xos, Xos, Xos, Xos, Xos, Xos, Yhr^Yva, Xos, Xos^Efs, Uu, Uu, Rr, Uu, Xos, Uu^Em, Rr, Uu^Ii, Uu, Rr, Rr, Uu, Xom, Xos, Xos, Uu, Rr, Uu, Xos^Efs, Xos
Xom, Ur, Rr, Uu, Xos, Xos, Yhr, Xos, Xos, Yhr^Pr/, Yhr^Xp, Xuc, Ur^Es, Rr, Ur, Xos, Xos, Xos, Xos, Xos, Xos^Efs, Yhr^Xp, Uu, Uu, Rr, Rr, Uu^Em, Uu, Xos, Uu, Rr, Uu, Xos, Uu, Rr, Uu^Efs, Uu, Xos^Xzm/, Uu, Uu, Rr, Tb, Tb^Tf, Xos^Efs
Xos, Ur^Es, Rr, Ur, Xot, Xos, Xos, Yhr^Pr/, Yhr^Xp, Xos, Ur, Ur, Rr, Rr, Ur, Xos, Yhr, Xos, Xot, Xos^Efs, Uu^Em, Uu^Es, Rr, Rr, Uu, Uu, Xom^Efs, Xom, Uu, Uu^Efs, Rr, Uu, Xos, Uh, Uu, Rr, Rr, Uu, Rr, Uu^Em, Rr, Uu^Vud, Uh, Xu
Xos, Ur^Es, Rr, Ur, Ur, Xos, Ur, Xos, Ur, Ur, Rr, Rr, Ur, Ur, Yhr^Xp, Xos, Xos, Yhr^Pr/, Yhr^Xp, Uh, Rr, Rr^Es, Uu, Uu, Xos, Xos^Efs, Uu, Uu, Rr, Rr, Uu^Em, Uu, Xos, Xos, Xos, Uh, Tb^Tf, Rr, Uu, Rr, Uu, Tb^Tf, Uh, Xu
Yhr^Pr\, Ur, Ur^Es, Rr, Rr, Ur, Rr, Ur, Rr, Rr, Ur, Ur, Yhr^Xp, Xot, Xos, Yhr^Pr/, Yhr, Xos, Xos^Efs, Uu, Rr, Uu^Em, Xos^Efs, Xos, Uu, Uh, Rr, Rr, Uu, Uu, Yhr^Xp, Yhr^Xp, Xos, Xos, Xos, Xos, Xos, Uu, Xos, Uu, Xos, Uh, Xos, Xuc
Xos, Xos, Yhr^Xp, Ur, Ur, Rr, Ur, Rr, Ur, Ur^Es, Yhr^Xp, Xos, Xos, Yhr^Pr/, Yhr, Xos, Xos, Yhr^Pr/, Yhr^Xp, Uu, Rr, Uu^Em, Uu, Uh, Rr, Rr, Uu, Uu, Xos, Xos, Xos, Xos, Xos, Xos, Xos, Xos, Xos, Yhr^Xp, Xos, Yhr^Xp, Xos, Yhr^Xp, Xos, Xuc
Yhr, Yhr^Pr\, Xos, Xos, Yhr^Xp, Ur, Yhr^Xp, Ur, Yhr^Xp, Xos, Xos, Yhr^Pr/, Yhr, Xos, Xos, Xos, Xos, Xos, Xos, Uh, Uu^Vyf, Rr, Rr, Rr, Uu, Uu, Yhr^Xp, Yhr^Xp, Xos, Xos, Xos, Xos, Xos, Xos, Xuc, Xuc, Xos, Yhr^Yva, Xos, Yhr^Yva, Xos, Yhr, Xos, Xuc
Xos, Xos, Xos, Xos, Yhr^Pr\, Xos, Xos, Xos, Yhr^Pr/, Xos, Xos, Xos, Xos, Xos, Xos, Xos, Xos, Xos, Xos, Uh, Uh, Uu^Em, Uh, Uh, Xos, Xos, Xos, Xos, Xos, Xos, Xos, Xos, Xuc, Xuc, Xuc, Xuc, Xuc, Xos, Xuc, Xos, Xuc, Xos, Xuc, Xuc
Xos, Xos, Xos, Yhr, Xos, Xos, Xos, Xos, Xos, Yhr, Xos, Xos, Xos, Xos, Xos, Xos, Xos, Xos, Xos, Xos, Xos, Xos, Xos, Xos, Xos, Xos, Xos, Xos, Xos, Xos, Xuc, Xuc, Xuc, Xuc, Xuc, Xuc, Xuc, Xuc, Xuc, Xuc, Xuc, Xuc, Xuc, Xuc
