Xos, Xos, Xos, Xos, Xos, Xos, Xos, Xos, Xos, Xos, Xos, Xos, Xos, Xos, Xos, Xos, Xos, Xos, Xos, Xos, Xos, Xos, Xos, Xos, Xos^Zok, Uu^Zok, Uu^Zok, Uu^Zok, Uu^Zok, Uu^Zok, Xos^Zok, Xos, Xuc, Xos, Xu, Xom, Xom, Xom, Xu, Xu, Uh, Xuc, Uh, Xuc, Xuc, Xos, Xos, Xos, Xos, Xu, Xu, Xu, Xu, Xu, Xu, Xu, Xu, Xu, Xu, Xu, Xu, Xu, Xu, Xu, Xu, Xu, Xu, Xu, Xu, Xu, Xu, Xu
Xos, Xos, Xos, Xos, Xos, Xos, Xos, Xos, Xos, Xos, Xos, Xos, Xos, Xos, Xos, Xos, Xos, Xos, Xos, Xos, Xos, Xos, Xos, Xos, Xos^Zok, Uu^Zok, Uu^Zok, Uu^Zok, Uu^Zok, Uu^Zok, Xos^Zok, Xos, Xu, Xuc, Uh, Xu, Uh, Uh, Uu, Xu, Uh, Uh, Xuc, Xuc, Uh, Xos, Xos, Xos, Xos, Xu, Xu, Xu, Xu, Xu, Xu, Xu, Xu, Xu, Xu, Xu, Xu, Xu, Xu, Xu, Xu, Xu, Xu, Xu, Xu, Xu, Xu, Xu
Xos, Xos, Xos, Xos, Xos, Xos, Xos, Xos, Xos, Xos, Xos, Xos, Xos, Xos, Xos, Xos, Xos, Xos, Xos, Xos, Xos, Xos, Xos, Xos, Xos^Zok, Uu^Zok, Uu^Zok, Uu^Zok, Uu^Zok, Uu^Zok, Xos^Zok, Xos, Xuc, Xuc, Uh, Uu, Uu, Uh, Uu^Ii, Uu, Ur, Uu, Uu, Uu, Uh, Xos, Xos, Xos, Xos, Xu, Xu, Xu, Xu, Xu, Xu, Xu, Xu, Xu, Xu, Xu, Xu, Xu, Xu, Xu, Xu, Xu, Xu, Xu, Xu, Xu, Xu, Xu
Xos, Xos, Xos, Xos, Xos, Xos, Xos, Xos, Xos, Xos, Xos, Xos, Xos, Xos, Xos, Xos, Xos, Xos, Xos, Xos, Xos, Xos, Xos, Xos, Xos^Zok, Uu^Zok, Uu^Zok, Uu^Zok, Uu^Zok, Uu^Zok, Xos^Zok, Xuc, Uh, Uh, Uu, Uu, Uu, Ur, Uu, Uu, Uu^Efs, Uu, Uu, Uh, Uh, Xos, Xos, Xos, Xos, Xu, Xu, Xu, Xu, Xu, Xu, Xu, Xu, Xu, Xu, Xu, Xu, Xu, Xu, Xu, Xu, Xu, Xu, Xu, Xu, Xu, Xu, Xu
Xos, Xos, Xos, Xos, Xos, Xos, Xos, Xos, Xos, Xos, Xos, Xos, Xos, Xos, Xos, Xos, Xos, Xos, Xos, Xos, Xos, Xos, Xos, Xos, Xos^Zok, Uu^Zok, Uu^Zok, Uu^Zok, Uu^Zok, Uu^Zok, Xos^Zok, Xu, Xu, Xu, Uh, Uu^Ii, Ur, Uu, Uu, Ur, Uu, Uh, Uu, Uu, Uu, Xos, Xom, Xos, Xos, Xu, Xu, Xu, Xu, Xu, Xu, Xu, Xu, Xu, Xu, Xu, Xu, Xu, Xu, Xu, Xu, Xu, Xu, Xu, Xu, Xu, Xu, Xu
Xos, Xos, Xos, Xos, Xos, Xos, Xos, Xos, Xos, Xos, Xos, Xos, Xos, Xos, Xos, Xos, Xos, Xos, Xos, Xos, Xos, Xos, Xos, Xos, Xos^Zok, Uu^Zok, Uu^Zok, Uu^Zok, Uu^Zok, Uu^Zok, Xos^Zok, Xu, Xuc, Xuc, Uh, Uu, Ur, Uu, Uu^Ii, Uu, Uu, Uu, Uh, Uh, Uu, Uu, Uu, Xom, Xu, Xu, Xu, Xu, Xu, Xu, Xu, Xu, Xu, Xu, Xu, Xu, Xu, Xu, Xu, Xu, Xu, Xu, Xu, Xu, Xu, Xu, Xu, Xu
Xos, Xos, Xos, Xos, Xos, Xos, Xos, Xos, Xos, Xos, Xos, Xos, Xos, Xos, Xos, Xos, Xos, Xos, Xos, Xos, Xos, Xos, Xos, Xos, Xos^Zok, Uu^Zok, Uu^Zok, Uu^Zok, Uu^Zok, Uu^Zok, Xos^Zok, Xu, Xu, Uh, Uu, Uu^Efs, Uu, Uu, Ur, Uu, Ur^Efs, Uu, Uu, Ur, Uh, Uu, Urb, Uu, Xuc, Xu, Xu, Xu, Xu, Xu, Xu, Xu, Xu, Xu, Xu, Xu, Xu, Xu, Xu, Xu, Xu, Xu, Xu, Xu, Xu, Xu, Xu, Xu
Xos, Xos, Xos, Xos, Xos, Xos, Xos, Xos, Xos, Xos, Xos, Xos, Xos, Xos, Xos, Xos, Xos, Xos, Xos, Xos, Xos, Xos, Xos, Xos, Xos^Zok, Uu^Zok, Uu^Zok, Uu^Zok, Uu^Zok, Uu^Zok, Xos^Zok, Xu, Xu, Xu, Uh, Uu, Uu, Uu, Xom, Uu, Ur, Ur, Tb^Tf, Uu, Xom, Uh, Uu, Urb, Xu, Xu, Xu, Xu, Xu, Xu, Xuc, Xu, Wog, Xu, Wwrg, Xu, Uh, Xuc, Xuc, Xu, Tb^Tf, Uh, Uh, Xu, Xu, Xu, Xu, Xu
Xos, Xos, Xos, Xos, Xos, Xos, Xos, Xos, Xos, Xos, Xos, Xos, Xos, Xos, Xos, Xos, Xos, Xos, Xos, Xos, Xos, Xos, Xos, Xos, Xos^Zok, Uu^Zok, Uu^Zok, Uu^Zok, Uu^Zok, Uu^Zok, Xos^Zok, Xu, Xu, Uh, Xu, Uh, Uh, Xom, Xom, Uh, Uu, Tb^Tf, Tb^Tf, Xom, Xos, Xos, Xu, Xu, Xu, Xu, Xu, Xu, Xu, Xuc, Wog, Wog, Wog, Wog, Wog, Wwrg, Ur, Uu^Tf, Ur, Uh, Uu^Emf, Tb^Tfi, Uu^Tf, Xu, Xu, Xu, Xu, Xu
Xos, Xos, Xos, Xos, Xos, Xos, Xos, Xos, Xos, Xos, Xos, Xos, Xos, Xos, Xos, Xos, Xos, Xos, Xos, Xos, Xos, Xos, Xos, Xos, Xos^Zok, Uu^Zok, Uu^Zok, Uu^Zok, Ur, Uu^Zok, Xos^Zok, Xu, Xu, Uh, Xu, Xu, Xos, Xos, Uu, Uu, Uu, Uh, Tb^Tf, Xom, Xos, Xu, Xu, Xu, Xu, Xu, Xu, Xu, Xu, Xu, Wog, Wog, Wog, Wog, Wwg, Wwrg, Wwg, Ur, Ur, Ur^Em, Ur^Em, Tb^Tf, Uh, Uu, Xu, Xu, Xu, Xu
Xos, Xos, Xos, Xos, Xos, Xos, Xos, Xos, Xos, Xos, Xos, Xos, Xos, Xos, Xos, Xos, Xos, Xos, Xos, Xos, Xos, Xos, Xos, Xos, Xos^Zok, Uu^Zok, Uu, Uu, Uu, Uu, Xos^Efs, Xos, Xos, Xu, Xos, Xos, Uu, Uu, Ur, Ur, Uu^Tf, Uu^Tf, Xom, Xom, Uu^Tf, Xu, Xu, Xu, Xu, Xu, Xu, Xu, Xu, Xuc, Uu, Wog, Wog, Wog, Wwg, Wwg, Xu, Uu, Uh, Uu^Em, Ur^Em, Uu, Xu, Xu, Xu, Xu, Xu, Xu
Xos, Xos, Xos, Xos, Xos, Xos, Xos, Xos, Xos, Xos, Xos, Xos, Xos, Xos, Xos, Xos, Xos, Xos, Xos, Xos, Xos, Xos, Xos, Xos, Xos^Zok, Uu^Zok, Uu, Ur, Urb, Uu, Qxv, Xos^Efs, Xom, Xos, Xos, Xos, Uu, Ur^Efs, Uu, Uu, Xos, Xom, Uu, Uu, Uh, Xuc, Xuc, Xu, Xu, Xu, Xu, Xu, Xu, Xuc, Xu, Wwrg, Wwrg, Wwg, Uu, Xuc, Xu, Xu, Xuc, Uu^Tf, Tb^Tf, Uh, Xu, Xu, Xuc, Xu, Xu, Xu
Xos, Xos, Xos, Xos, Xos, Xos, Xos, Xos, Xos, Xos, Xos, Xos, Xos, Xos, Xos, Xos, Xos, Xos, Xos, Xos, Xos, Xos, Xos, Xos, Xos, Qxv, Qxv, Uu, Uu, Uu, Qxv, Qxv, Qxv, Xom, Xos, Uu, Urb, Uu, Uu, Uu, Uu, Uu^Tf, Urb, Urb, Uu, Uu, Xu, Xu, Xu, Xu, Xu, Xu, Xu, Xu, Xu, Uu, Xu, Uu, Uh, Xu, Xuc, Xuc, Ur^Pw\, Uu^Tf, Uu, Uu^Ii, Uu^Em, Uu^Emf, Uu, Xuc, Xu, Xu
Xos, Xos, Xos, Xos, Xos, Xos, Xos, Xos, Xos, Xos, Xos, Xos, Xos, Xos, Xos, Xos, Xos, Xos, Xos, Xos, Xu, Xos, Xos, Xos, Xos, Xos, Qxv, Uu, Uu, Ur, Uu, Qxv, Qxv, Xos, Xos, Uu, Urb, Uu, Uu, Uu, Uu, Uu, Uu, Uu, Xos, Xos, Xu, Xu, Xu, Xu, Xu, Xu, Xu, Xu, Xu, Xu, Xu, Xu, Xuc, Xu, Xuc, Ur^Tf, Xu, Xu, Xu, Uu, Xu, Tb^Tf, Uh, Xu, Xu, Xu
Xos, Xos, Xos, Xos, Xos, Xos, Xos, Xos, Xos, Xos, Xos, Xos, Xos, Xos, Xos, Xos, Xos, Xos, Xos, Xos, Xu, Xu, Uu, Xos, Xos, Xos, Qxv, Qxv, Uu, Urb, Urb, Qxv, Qxv, Xos, Xos^Efs, Uu, Urb, Uu, Uu, Urb^Efs, Urb, Uu, Uu, Xos, Xu, Xu, Xu, Xu, Xu, Xu, Xu, Xu, Xu, Xu, Xu, Xu, Xu, Xuc, Uh, Xu, Uh, Uu, Ur, Xuc, Xuc, Xu, Xu, Xu, Xu, Xu, Xu, Xu
Xos, Xos, Xos, Xos, Xos, Xos, Xos, Xos, Xos, Xos, Xos, Xos, Xos, Xos, Xos, Xos, Xos, Xos, Xos, Xos, Xu, Xu, Xu, Uu, Xuc, Xos, Qxv, Qxv, Uh, Urb, Urb, Uh, Uu^Tf, Uu, Urb, Urb^Pr\, Xos^Efs, Xos, Xos, Uu, Uu, Urb, Tb^Tf, Uu, Xu, Xu, Xu, Xu, Xu, Xu, Xu, Xu, Xu, Xu, Xu, Xu, Xu, Xu, Uu, Uu^Em, Uu^Emf, Ur^Ii, Ur, Uu, Xuc, Xu, Xu, Xu, Xu, Xu, Xu, Xu
Xos, Xos, Xos, Xos, Xos, Xos, Xos, Xos, Xos, Xos, Xos, Xos, Xos, Xos, Xos, Xos, Xos, Xos, Xos, Xos, Xos, Xu, Xu, Ur^Br\, Ur^Br\, Xos, Xos, Uh, Uu, Uu^Tf, Tb^Tf, Urb, Uu, Urb, Uu^Tf, Uu, Uu^Em, Xos^Efs, Xos, Xos, Uu^Tf, Urb, Urb, Uu, Uh, Xuc, Xu, Xu, Xu, Xu, Xu, Xu, Xu, Xu, Xu, Xu, Xu, Xu, Xu, Xu, Xu, Uu, Uh, Uh, Xu, Xu, Xu, Xu, Xu, Xu, Xu, Xu
Qxu, Xos, Xos, Xos, Xos, Xos, Xos, Xos, Xos, Xos, Xos, Xos, Xos, Xos, Xos, Xos, Xos, Xos, Xos, Xos, Xos, Xos, Xos, Uu, Xuc, Ur^Br\, Ur^Br\, Uu^Pr\, Uu^Pr\, Tb^Tf, Uu, Uh, Uh, Uu, Urb, Uu, Uu, Uu^Em, Xu, Xu, Xu, Tb^Tf, Uh, Uu, Uh, Xuc, Xu, Xu, Xu, Xu, Xu, Xu, Xu, Xu, Xos, Xos, Xos, Xu, Xu, Xu, Xu, Uh, Uh, Xu, Xu, Xu, Xu, Xu, Xu, Xu, Xu, Xu
Qxu, Qxu, Qxu, Xos, Xos, Xos, Xos, Xos, Xos, Xos, Xos, Xos, Xos, Xos, Xos, Xos, Xos, Xos, Xos, Xos, Xos, Xos, Xos, Xos, Xos, Uu, Xos, Ur^Br\, Ur^Br\, Xos, Xos, Uh, Xuc, Uu, Uu, Urb, Uu, Xuc, Xu, Xu, Xu, Xu, Xu, Uh, Xu, Xu, Xu, Xu, Xu, Xu, Xu, Xu, Xos, Xos, Xos, Xos, Xos, Xos, Xos, Xu, Xos, Xu, Xu, Xu, Xu, Xu, Xu, Xu, Xu, Xu, Xu, Xu
Qxu, Qxu, Qxu, Qxu, Qxu, Xos, Xos, Xos, Xos, Xos, Xos, Xos, Xos, Xos, Xos, Xos, Xos, Xos, Xos, Xos, Xos, Xos, Xos, Xos, Xos, Xos, Xos, Xos, Xos, Ur^Br\, Xu, Xuc, Xuc, Uu^Em, Uu, Urb, Urb^Zz/, Uu^Zz/, Uu, Xuc, Xuc, Xu, Xu, Xu, Xu, Xu, Xu, Xu, Xos, Xu, Xos, Xos, Xos, Xos, Xos, Yhl, Yhl, Xos, Xos, Xos, Xos, Xos, Xos, Xu, Xu, Xu, Xu, Xu, Xu, Xu, Xu, Xu
Ur, Xos, Qxu, Qxu, Qxu, Qxu, Qxu, Xos, Xos, Xos, Xos, Xos, Xos, Xos, Xos, Xos, Xos, Xos, Xos, Xos, Xos, Xos, Xos, Xos, Xos, Xos, Xos, Xos, Xos, Xos, Xos, Xu, Xu, Xuc, Xu, Uu^Zz/, Urb, Uu, Uu^Efs, Uu, Xu, Xu, Xuc, Xu, Xu, Xu, Xos, Xos, Xos, Xos, Xos, Xos, Xos, Yhl, Yhl, Xos, Xos, Yhl^Pr/, Yhl^Xp, Xot, Uu, Xom, Xom, Xuc, Xuc, Xu, Xu, Xu, Xu, Xu, Xu, Xu
Rr, Ur, Ur, Xos, Qxu, Qxu, Qxu, Qxu, Qxu, Xos, Xos, Xos, Xos, Xos, Xos, Xos, Xos, Xos, Xos, Xos, Xos, Xos, Xos, Xos, Xos, Xos, Xos, Xos, Xos, Xos, Xos, Xu, Xu, Xu, Xu, Uu, Uu^Efs, Urb, Ur, Uu, Uu, Xuc, Xuc, Xu, Xuc, Xu, Xu, Xos, Xu, Xu, Xu, Xos, Xos, Xos, Xos, Yhl^Pr/, Yhl^Xp, Xos, Uu, Uu, Uu^Tf, Tb^Tf, Uu, Xuc, Uh, Xuc, Uh, Xu, Xu, Xu, Xu, Xu
Ur, 1 Rr, Rr, Ur, Ur, Xos, Qxu, Qxu, Qxu, Qxu, Qxu, Xos, Xos, Xos, Xos, Xos, Xos, Xos, Xos, Xos, Xos, Xos, Xos, Xos, Xos, Xos, Xos, Xos, Xos, Xos, Xos, Xos, Xu, Xu, Xu, Xu, Uu, Uh, Uu, Urb, Urb, Uh, Uu, Xu, Ur, Xuc, Qxu, Qxu, Qxu, Xu, Xuc, Xu, Xu, Xos, Xos^Efs, Xos^Efs, Uu, Uu, Uu^Ii, Uu, Uu, Tb^Tf, Uu^Em, Uu^Vu, Uu, Uu, Uh, Xuc, Xu, Xu, Xu, Xu
Qxu, Ur, Ur, Rr, Rr, Ur, Ur, Xos, Qxu, Qxu, Qxu, Qxu, Qxu, Xos, Xos, Xos, Xos, Xos, Xos, Xos, Xos, Xos, Xos, Xos, Xos, Xos, Xos, Xos, Xos, Xos, Xos, Xos, Xu, Xu, Xuc, Xuc, Uu, Uh, Uu^Emf, Uu^Tf, Ur, Ur, Urb, Uu, Uu^Tf, Uu, Qxu, Qxu, Qxu, Uu, Uh, Xuc, Xu, Xos, Xos, Uu, Uh, Uu, Rb^Edt, Rb, Uu^Tf, Uh, Urb, Uu, Uu, Uu, Uh, Uh, Xu, Xu, Xu, Xu
Qxu, Xos, Qxu, Ur, Ur, Rr, Rr, Ur, Ur, Xos, Qxu, Qxu, Qxu, Qxu, Qxu, Xos, Xos, Xos, Xos, Xos, Xos, Xos, Xos, Xos, Xos, Xos, Xos, Xos, Xos, Xos, Xos, Xos, Xos, Xu, Xuc, Uh, Uu, Tb^Tf, Uu, Ur, Uu^Tf, Uu^Tf, Uu, Urb, Urb, Uu^Tf, Qxu, Qxu, Qxu, Uu, Uh, Xu, Xu, Xos, Xos, Uu^Tf, Uh, Uu^Vud, Uu, Uu, Urb, Urb, Uu, Uu, Wwf, Uh, Uu, Xuc, Xuc, Xu, Xu, Xu
Qxu, Qxu, Qxu, Xos, Qxu, Ur, Ur, Rr, Rr, Ur, Ur, Xos, Qxu, Qxu, Qxu, Qxu, Xos, Xos, Xos, Xos, Xos, Xos, Xos, Xos, Yhr, Xos, Xos, Xos, Xos, Xos, Xos, Xos, Xos, Xu, Xu, Xuc, Uu^Tf, Uu, Ur, Ur, Tb^Tf, Ur, Ur, Ur, Uu^Efs, Urb, Qxu^Bcx\, Qxu, Qxu, Qxu, Qxu, Xu, Xos, Xos, Xos^Efs, Uh, Tb^Tf, Uu, Cud, Cud, Cud, Urb, Uu^Ii, Uu, Wwf^Es, Uu, Uh, Xuc, Xu, Xu, Xu, Xu
Xos, Qxu, Qxu, Qxu, Qxu, Xos, Qxu, Ur, Ur, Rr, Rr, Ur, Ur, Xos, Qxu, Xos, Xos, Xos, Xoi, Xos, Xos^Efs, Xos, Yhr^Pr\, Yhr, Xos, Xos, Yhr, Xos, Xos, Xos, Xos, Xos, Xos, Xos, Xu, Xu, Uu^Tf, Tb^Tf, Uu, Ur, Uu, Uu, Qxu, Urb, Qxu, Qxu, Qxu, Qxu^Bcx\, Qxu^Bcx\, Qxu, Uu, Xos, Xos, Xos^Efs, Uu^Tf, Uu, Uu^Edt, Rb, Cud, 6 Kud, Cud, Urb, Uu, Wwf, Uu, Uu, Xu, Xu, Xu, Xu, Xu, Xu
Xu, Xos, Xos, Qxu, Qxu, Qxu, Qxu, Xos, Qxu, Ur, Ur, Rr, Rr, Ur, Ur, Xos, Xos^Efs, Xoi, Ur, Cud, Cud, Yhr^Xp, Xos^Efs, Xos, Yhr^Pr\, Yhr, Xos, Xos, Yhr, Xos, Xos, Xos, Xos, Xos, Xu, Xu, Xu, Uu, Uu^Tf, Uu, Uh, Qxu, Qxu, Qxu^Bcx|, Qxu, Uh, Uu, Qxu, Qxu, Urb, Uu, Xos, Xos^Efs, Xos, Uu, Uu, Rb^Em, Rb^Em, Uu, Cud, Uu, Wwf, Wwf, Uu, Uu, Uu, Xu, Xu, Xu, Xu, Xu, Xu
Xu, Xu, Xu, Xos, Xos, Qxu, Qxu, Qxu, Qxu, Xos, Qxu, Ur, Ur, Rr, Rr^Pr/, Ur^Pr/, Ur, Cud, Ur, Ur, Ur, Cud, Cud, Yhr^Xp, Xos^Efs, Xos, Yhr^Pr\, Yhr, Xos, Xos, Yhr, Xos, Xos, Xos, Xu, Xu, Xu, Xu, Xu, Uu, Qxu, Qxu, Qxu, Qxu^Bp|, Qxu, Uh, Qxu, Qxu, Uu, Urb, Uu^Tf, Uh, Uu, Uu, Urb, Uu, Uu, Uu, Urb, Urb, Uu, Wwf, Cud, Uu, Wwf, Uh, Xu, Xu, Xu, Xu, Wog, Wog
Xu, Xu, Xu, Xu, Xu, Xos, Xos, Qxu, Qxu, Qxu, Xos, Xos, Xos^Efs, Ur^Pr/, Ur^Vud, Rr, Kud, Cud, Ur, Ur^Efs, Ur, Ur, Ur, Cud, Cud, Yhr^Xp, Xos^Efs, Xos, Yhr^Pr\, Yhr, Xos, Xos, Xos, Xos, Xu, Xu, Xu, Xu, Xu, Xu, Xu, Qxu, Qxu, Qxu^Bcx|, Qxu, Qxu, Qxu, Qxu, Qxu, Uu, Ur^Em, Uh, Ur, Urb, Uu, Uu, Xu, Uu, Urb, Uu^Ii, Uu, Uu, Uu, Uu, Uu, Xuc, Xuc, Xuc, Xu, Xu, Wog, Wog
Xu, Xu, Xu, Xu, Xu, Xu, Xu, Xos, Xos, Xos, Xoi, Xoi^Efs, Ur, Cud, Cud, Cud, Ur, Rr, Rr, Ur^Vu, Ur, Ur, Ur^Efs, Ur, Ur, Cud, Cud, Yhr^Xp, Xos, Xos, Xos, Xos, Xos, Xos, Xu, Xu, Xu, Xu, Xu, Xu, Xu, Xu, Uu^Tf, Rr, Uu^Efs, Uu, Uu, Qxu, Qxu, Uu^Tf, Ur^Em, Uu^Tf, Ur, Uu^Vu, Uu^Tf, Xu, Xuc, Uu, Uu, Urb, Xuc, Uu, Uu, Wwf, Wwg, Wwg^Es, Wog, Wog, Wog, Wog, Wog, Wog
Xu, Xu, Xu, Xu, Uh, Xos, Xu, Xu, Xu, Xos, Xos^Efs, Cud, Cud, Ur, Ur, Ur, Ur, Ur, Ur, Rr, Rr, Ur, Ur, Ur, Cud, Ur, Ur, Xos, Xos, Xos, Xos, Xos, Xos, Xos, Xu, Xu, Xu, Xu, Xu, Xu, Uu^Tf, Uu^Edb, Uu^Edb, Rr^Edb, Rr, Rr, Rr, Qxu, Uu^Efs, Tb^Tf, Ur, Ur, Uu, Uu, Uu^Em, Xuc, Uh, Uu, Urb, Rb^Em, Uu^Em, Uu, Wwf^Es, Wwf^Es, Wwg^Es, Wwrg, Wog, Wog, Wog, Wog, Wog, Wog
Xu, Xu, Xos, Uh, Uu^Tf, Xuc, Uh, Xu, Xos, Xos^Efs, Yhr^Pr\, Yhr^Xp, Xos^Efs, Cud, Cud, Ur^Efs, Ur, Ur, Ur, Ur^Vu, Ur, Rr, 2 Kud, Cud, Ur^Vud, Cud, Xos, Xos, Xu, Xu, Xos, Xos, Xos, Xos, Xu, Xu, Xu, Xu, Xu, Xu, Uu^Tf, Uu^Edb, Rr^Edb, Rr^Edb, Uu, Uu, Uu, Qxu^Bcx\, Urb, Uu, Ur, Uu, Uu^Ii, Uu, Uu^Tf, Uu, Ur, Urb, Wwf, Uu, Uu, Cud, Wwrg, Wwg, Wwrg, Wog, Wog, Wog, Xu, Wog, Wog, Xu
Xu, Xos, Xos, Uh, Rb, Uh, Tb^Tf, Yhr, Yhr^Xp, Yhr, Xos, Xos^Efs, Yhr^Pr\, Yhr^Xp, Xos^Efs, Cud, Cud, Ur, Ur^Efs, Ur, Ur, Cud, Ur, Rr, Rr^Pr/, Ur^Pr/, Ur, Xu, Xu, Xos, Xos, Xos, Xos, Xu, Xu, Xu, Xu, Xu, Xos^Efs, Xos^Efs, Uu^Zz\, Uu, Rr, Uu, Uh, Uu^Tf, Uh, Qxu, Uu, Urb, Ur, Ur, Ur, Ur, Ur, Ur, Ur, Ur, Uu, Uu, Wwf, Wwf^Es, Wwg, Wwg, Wwrg, Wog, Xu, Xu, Xu, Xu, Xu, Xu
Xu, Xu, Uh, Yhr, Yhr^Xp, Rb^Emf, Cud, Yhr, Yhr^Edb, Yhr^Edb, Yhr^Xp, Yhr, Xos, Xos^Efs, Yhr^Pr\, Yhr^Xp, Xos^Efs, Cud, Cud, Ur, Ur, Cud, Xos, Ur^Pr/, Ur, Rr, Rr, Ur, Uh, Xos, Xos^Efs, Xos^Efs, Uu, Xos, Xos, Xu, Xos^Efs, Xos, Uu^Zz\, Uu, Rr, Rr^Zz\, Uu^Zz\, Uu, Xuc, Xuc, Xuc, Qxu, Qxu, Uu, Uu, Uu^Tf, Uh, Uu, Tb^Tf, Uu, Uu, Ur, Uu, Uu, Wwrg, Wwrg, Wwg, Wwf, Wwg, Xu, Xos, Xu, Xu, Xu, Xu, Xu
Xu, Xu, Uh, Uh, Rb^Edb, Cud, 4 Urb^Kov, Cud, Uu^Edb, Yhr^Edb, Rb, Yhr, Yhr^Xp, Yhr, Xos, Xos^Efs, Yhr^Pr\, Yhr^Xp, Xos, Cud, Xos, Xos, Xos, Xos, Xos, Ur, Ur, Rr, Uu^Tf, Xos, Xos^Efs, Uu, Ur^Br/, Ur^Br/, Uu, Xos^Efs, Uu^Zz\, Uu, Rr, Rr^Zz\, Uu^Zz\, Uu, Xos, Xos, Xuc, Xuc, Xuc, Xuc, Qxu, Uh, Uh, Uu, Uu, Uu^Emf, Tb^Tf, Uu^Tf, Uh, Ur, Uh, Cud, Wwg, Xu, Wwg, Wwg, Yhl^Xp, Xot, Xos, Xos, Xos, Xu, Xu, Xu
Xu, Xu, Xos, Rb^Edb, Rb^Edb, Cud, Cud, Cud, Uu^Edb, Yhr^Xp, Rb, Uu, Uh, Yhr, Yhr^Xp, Yhr, Xos, Xos, Xos, Xos, Xos, Xos, Xos, Xos, Xos, Xos, Uh, Rr, Rr^Em, Uu^Emf, Ur^Br/, Ur^Pr\, Xos, Uu, Xos, Xos, Uu, Rr^Zz\, Uu^Zz\, Uu, Xos, Xos, Xuc, Xuc, Xu, Xuc, Qxu, Qxu^Xo, Xu, Xu, Xu, Xu, Xu, Uu^Tf, Uh, Uu, Uu, Ur, Uu, Wwg, Wog, Wog, Yhl^Xp, Xos, Xot, Yhl^Pr/, Yhl, Xom, Xom, Xos, Xos, Xu
Xos, Xu, Xu, Xu, Yhr^Edb, Yhr^Edb, Rb, Yhr^Edb, Yhr^Xp, Rb, Uu^Vud, Uu, Rb^Edb, Rb, Yhr^Xp, Xos^Efs, Xos^Efs, Xos, Xos, Xos, Xos, Xos, Xos, Xos, Xos, Xos, Uu^Em, Uu^Em, Ur^Br/, Ur^Br/, Re^Em, Re^Tf, Xos, Xos, Xos^Efs, Xos, Cud, Rr, Uu, Xos, Xuc, Xuc, Xu, Xu, Xu, Xu, Xuc, Xuc, Xu, Xu, Xu, Xu, Xu, Xu, Xu, Xu, Xu, Uu, Xos, Xu, Wog, Xos, Xos, Yhl^Pr/, Yhl, Xos, Yhl, Uu, Xom, Xos, Xos, Xos
Xos, Xos, Xos, Xu, Xos, Yhr^Xp, Rb, Rb^Vyf, Yhr, Yhr^Xp, Yhr, Yhr, Rb^Edb, Rb^Edb, Cud, Cud, Yhr, Xos^Xzm\, Xos, Xos, Xu, Xos, Xu, Xos, Uu, Xos^Efs, Ur^Pr\, Ur^Br/, Uu, Rr, Rr, Uu^Tf, Xos, Xos^Efs, Uh, Uu, Uu, Cud, Cud, Xos, Xu, Xu, Uu^Br|, Uh, Xos, Xuc, Xuc, Xuc, Xuc, Xu, Xos, Xos, Xos, Xu, Xu, Xu, Xu, Xos, Xos, Wog^Xo, Xos, Xos, Xom, Xot, Yhl, Yhl, Yhl^Em, Uu^Emf, Uh, Xom, Xos, Xos
Xos, Xos, Xos, Xos, Xos, Cud, Cud, Rb, Yhr, Uh, Uh, Uu, Xos, Cud, Yhr, Yhr, Yhr, Xos, Xos, Xos, Xu, Xu, Xu, Uu, Ur^Br/, Ur^Br/, Uu, Xos, Uu^Emf, Uu, Rr, Uh, Uu^Tf, Uu^Tfi, Uu^Em, Uu^Emf, Rr^Edt, Rr^Em, Uu, Xos, Xu, Uh, Uu^Br|, Uh, Xos, Xos, Xu, Xuc, Xuc, Xos, Xos, Xos, Xos, Xos, Xos, Xu, Xos, Xos, Wog, Wog, Xos, Xom, Uh, Uu, Yhl^Tf, Yhl, Yhl^Em, Uu^Tf, Uu, Xos, Xot, Xos
Xos, Xos, Xos, Xos, Xos^Efs, Yhr^Edb, Yhr^Xp, Cud, Xos^Efs, Uh, Xos, Xos, Yhr^Xp, Yhr, Yhr^Xp, Yhr^Xp, Xos, Xos, Xot, Xos, Uu^Emf, Xu, Xu, Xu, Xu, Uu, Xos^Efs, Xos, Uu^Tf, Uu^Em, Rr^Edt, Rr, Rr^Edt, Uh, Uu^Emf, Uu^Edt, Rr^Edt, Uu, Uh, Xos, Xu, Uh, Uu^Pr/, Uu^Pr/, Qxu, Xu, Xu, Xu, Xu, Xos, Xos, Xos, Wog, Xos, Xos, Xos, Xos, Xos, Xos, Xos, Xos, Xos, Uh, Uh, Uu^Tf, Yhl^Em, Yhl^Em, Yhl, Yhl, Yhl, Yhl^Pr/, Xos
Xos, Xos, Xos, Xos^Efs, Qxu, Yhr^Edb, Yhr^Edb, Yhr^Edb, Yhr, Xos^Efs, Xot, Xos, Yhr^Xp, Yhr, Xos^Xzm/, Xos, Uh, Xos^Efs, Cud, Rr, Rr, Uu^Tf, Uh, Xu, Xu, Xos^Efs, Uu, Uh, Rr, Rr^Edt, Uu^Edt, Uu^Efs, Uu^Edt, Rr^Edt, Cud, Cud, Cud, Uh, Uu, Xos, Xos, Uu^Pr/, Uu^Br|, Qxu, Xu, Xu, Xu, Xu, Xos, Xos, Xos, Wog, Wog, Xos, Xos, Xos, Xos, Xos, Xos, Xos, Xos, Xos, Xos, Uu, Uu, Yhl, Yhl, Yhl, Yhl^Pr/, Xos, Xos, Yhl
Xos, Xos, Xos, Xos, Qxu, Uh, Uu, Yhr^Edb, Yhr^Edb, Yhr^Edb, Yhr^Xp, Xos^Efs, Yhr, Yhr, Uh, Tb^Tf, Uu^Dr, Uu^Edb, Yhr^Edb, Cud, Xu, Rr, Rr, Uu, Rr, Uu, Rr, Rr, Uu^Emf, Uu, Xos, Uh, Uu, Ur, Cud, 3 Kud, Qxu, Uu^Tf, Uu^Edt, Xos^Efs, Uu, Uu, Uu^Br|, Qxu, Xos, Xu, Xos, Xos, Xos^Efs, Xos^Efs, Wog, Wog^Xo, Wog^Xo, Xos, Xos^Efs, Xos, Xos, Xos, Xos^Efs, Xos^Efs, Uh, Xos^Efs, Xom^Efs, Xos, Xos, Uh, Xos, Xos, Xos, Yhl, Yhl, Xos
Xos, Xos, Xos, Xos, Qxu, Uh, Uh, Yhr, Yhr^Edb, Yhr^Edb, Yhr, Yhr, Yhr, Yhr^Xp, Yhr^Edb, Tb^Tf, Yhr, Yhr^Edb, Uu, Xu, Uh, Uu, Uu, Rr, Uh, Rr, Xos, Uh, Xos, Xos, Xos^Efs, Uu, Ur^Edt, Ur^Edt, Uh, Cud, Uu, Uu^Edt, Uu, Uh, Uu, Uu, Uu^Pr/, Uu^Pr/, Xos, Xos, Xos, Xos, Cud, Wwg, Wog, Wog, Xos, Xos^Efs, Uh, Uh, Uu, Xos, Uu^Emf, Uh, Wwf, Uh, Uh, Xom, Xos, Xos, Xos, Xos, Xos, Xos, Xos, Yhl
Xos, Xos, Xos, Xos, Xos, Qxu, Yhr, Yhr, Yhr, Xos, Xos, Yhr^Vyv, Yhr, Yhr^Edb, Yhr^Edb, Yhr^Edb, Uh, Tb^Tf, Xos, Xu, Xu, Uh, Xu, Xu, Xu, Xos, Xos, Xos, Xos, Xos^Efs, Cud, Ur, Uu, Uu^Edt, Uu, Rr^Em, Uu, Uu^Tf, Uh, Uh, Xos, Uu^Pr/, Uu^Br|, Uu, Xos, Xos, Xos, Cud, Wwg, Wwg, Wog, Wwg, Cud, Xos^Efs, Uu^Tfi, Uu^Tf, Uh, Wwf, Wwf, Uu^Tf, Wwf, Uh, Wwf, Xos, Xos, Xos, Xos, Xos, Xos, Xos, Xos, Xos
Xos, Xos, Xos, Xos, Xos, Xos, Yhr^Edb, Yhr^Edb, Yhr^Edb, Xos, Xuc, Yhr, Yhr, Yhr, Yhr, Uu, Xos, Xos, Xos, Xos, Xos, Xu, Xu, Xu, Xos, Xos, Xos, Xu, Uu, Ur, Uh, Cud, Xos, Uu, Uu^Vu, Rr, Uu, Xom, Xos^Efs, Xos, Xuc, Uh, Uu^Br|, Uu^Br\, Xos, Xos, Xos, Wwrg, Wwg, Wog, Wwrg, Wwg, Cud, Uu^Vud, Wwf, Uu^Emf, Cud, Wwf, Cud, Uu^Edt, Uu^Edt, Wwf, Wwf, Xos, Xos, Xos, Xos^Efs, Xos, Xos, Xos, Xos, Xos
Xos, Xos, Xos, Xos, Xom, Xom, Yhr^Xp, Yhr^Edb, Yhr^Edb, Yhr^Xp, Yhr^Xp, Yhr, Yhr, Yhr, Yhr^Xp, Yhr^Xp, Xos, Xos, Xos, Xos, Xos, Xos, Xos, Xos, Xos^Efs, Xos^Xzm/, Uh, Yhr, Uu, Uh, Xos, Xos, Xos, Xos, Uu, Rr, Rr, Uu, Uu, Xom^Efs, Xuc, Xuc, Xu, Xu, Xos, Xos, Xos, Wwg, Uu^Ii, Wwg, Wwg, Wwg, Cud, Urb, Urb, Cud, 5 Kud, Cud, Uu^Vu, Urb^Edt, Wwg, Xos, Xos, Wwf^Pr/, Wwf, Cud, Cud, Xos^Efs, Xos, Xos, Xos, Xos
Xos, Xos, Xos, Xos, Yhr, Yhr^Pr\, Xom, Xos, Yhr^Xp, Yhr, Yhr, Yhr, Yhr^Pr/, Xos^Efs, Xom^Efs, Xos, Xos, Xos, Yhr, Xos, Xos, Xos, Xom, Xom^Efs, Yhr^Xp, Uu^Tf, Yhr, Yhr, Xos, Xos, Xos^Efs, Xos^Efs, Yhr, Xos, Uu^Pr\, Uu^Efs, Uu, Rr, Uu, Uu, Uu, Xuc, Xu, Xu, Xos, Xos, Wog, Wwg, Wwg, Wwg, Xos, Xos, Xos, Wwf, Wwg, Cud, Cud, Cud, Uh, Wwf^Es, Wwf, Uu^Tfi, Uh^Ii, Xos, Cud, Uu^Ii, Cud, Xos, Xos, Xos, Xos, Xos
Xos, Xos, Yhr, Yhr, Xos, Xom, Yhr, Yhr^Pr\, Xos, Xos, Xos, Yhr^Pr/, Yhr, Yhr, Yhr, Xom, Xos, Xos, Xos, Yhr, Yhr^Pr|, Xos, Xos, Yhr^Xp, Yhr^Edb, Yhr^Edb, Yhr, Xos, Xos, Xos, Xos, Wwf, Yhr^Xp, Yhr, Xos, Xos, Xos, Uu, Uu, Rr, Uu, Xuc, Xos, Xos, Xos, Wwrg, Wog, Wog, Wwrg, Wog, Xos, Xos, Xos, Xos, Uh, Uu, Urb^Edt, Cud, Cud, Wwf, Uu^Vud, Uu^Tf, Uh, Xos, Xos, Cud, Xos, Xos, Xu, Xos, Xos, Xos
Xos, Xos, Xos, Xos, Yhr, Yhr, Xos, Xos, Xos, Xos, Xos, Uh, Tb^Tf, Yhr, Yhr, Tb^Tf, Yhr, Xot^Xzm\, Xos, Xos, Yhr^Xp, Xot, Yhr^Xp, Yhr, Yhr, Yhr^Edb, Xos, Xos, Xos, Xot, Uu^Tf, Wwf, Wwg, Yhr^Xp, Xu, Xu, Xos, Xos, Wwrg, Uu, Rr, Uu, Xom, Xom, Cud, Wwg, Wwg, Wwrg, Xos, Xos, Xos, Xos, Xos, Xos, Uu, Uu^Ii, Urb^Edt, Uu^Edt, Uu, Urb, Urb, Uu, Xos, Xos, Xu, Xos, Wog, Xu, Xu, Xu, Xu, Xos
Xos, Xos, Xos, Xos, Xos, Xos, Qxu, Xos, Xos, Xos, Xos, Xos, Yhr^Emf, Yhr, Yhr, Uh, Uu^Emf, Yhr, Tb^Tf, Xos^Xzm\, Yhr, Yhr, Yhr, Yhr, Yhr, Xos, Xos, Xos, Xos, Uh, Uh, Wwg, Wwf, Uu^Tf, Xu, Xu, Xu, Xos, Wwg, Uu, Rr, Uu, Wwf, Wwf, Uu, Cud, Cud, Wwg, Xos, Xos, Xos, Xos, Xom^Efs, Xos^Efs, Cud, Urb^Emf, Uu^Tf, Xos, Xos, Uu, Cud, Cud, Xos, Xos, Wog, Wog^Xo, Wog^Xo, Wog, Xu, Xu, Xu, Xu
Xos, Xos, Xos, Xos, Xos, Xos, Xos, Qxu, Qxu, Xos, Xos, Xos, Tb^Tf, Tb^Emf, Yhr^Xp, Yhr, Yhr, Yhr^Xp, Yhr^Tf, Uh, Yhr, Yhr, Xuc, Yhr^Xp, Yhr^Xp, Tb^Tf, Uu^Edt, Xos^Efs, Uh, Uh, Wwf, Uu^Tf, Xos, Xu, Xu, Xu, Wwg, Wwg, Xu, Uu, Uu, Rr, Wwf, Wwg, Uu^Dr, Tb^Tf, Wwf, Cud, Xos, Xos, Xom, Xom, Uu^Edt, Wwf, Urb, Cud, Xos^Efs, Xos, Xos, Xos, Urb, Uu, Wwrg, Wwg, Wog, Wog, Xu, Xu, Xu, Xu, Xu, Xu
Xos, Xos, Xos, Xos, Xos, Xos, Xos, Xos, Xos, Qxu, Qxu^Xo, Xos, Uh, Xot, Xos, Yhr, Yhr, Yhr, Yhr^Edb, Yhr^Edb, Uh, Yhr, Yhr, Yhr, Yhr, Uh, Uh, Wwf^Edt, Wwg, Tb^Tf, Yhr^Xp, Xos, Xos, Xu, Xu, Xu, Xos, Wwg, Xu, Xu, Wwf, Uu, Wwg, Uu, Uu^Edt, Wwf, Wwf, Urb, Cud, Xos^Efs, Uu, Uu^Edt, Wwf, Uu^Edt, Uu^Dr, Uu^Emf, Uu, Xos^Efs, Xos, Wwg, Urb, Uu^Dr, Wwg, Wwg, Wog, Xuc, Xu, Xu, Xu, Xu, Xu, Xu
Xos, Xos, Xos, Xos, Xos, Xos, Xos, Xos, Xos, Xos, Xos, Qxu, Qxu, Uh, Uh, Yhr^Vyv, Yhr^Xp, Yhr^Xp, Yhr, Uu^Edb, Xos, Xos, Xuc, Xuc, Xuc, Uh, Wwg, Wwf, Wwrg, Yhr, Tb^Tf, Xos, Xos, Xos, Xu, Xos, Xos, Xos, Xu, Xu, Xu, Wwf, Xu, Wwf, Uu^Edt, Uu^Edt, Uu^Edt, Cud, Wwf, Wwf, Uu, Urb, Wwf, Wwg, Uu, Uu, Wwf, Wwg, Urb, Wwg, Uu, Uu^Emf, Wwg, Wog, Wog, Xuc, Xuc, Xu, Xu, Xu, Xu, Xu
Xos, Xos, Xos, Xos, Xos, Xos, Xos, Xos, Xos, Xos, Xos, Xos, Xos, Qxu, Qxu, Yhr, Yhr, Yhr, Yhr^Pr/, Xos, Xos, Xuc, Xuc, Xuc, Xuc, Xuc, Xuc, Wwg, Wwf, Uu^Tf, Uh, Wwf, Xos, Xu, Xu, Xos, Xuc, Xuc, Xuc, Xu, Xuc, Xu, Uu^Tf, Wwf, Uu^Edt, Tb^Tf, Uu^Edt, Wwrg, Wwg, Wwf, Wwrg, Wwrg, Xos, Xos, Xos, Xos, Xos, Wwg, Uu, Uu, Wwf, Uu, Xu, Wwrg, Wog, Wog, Xos, Xu, Xu, Xu, Xu, Xu
Xos, Xos, Xos, Xos, Xos, Xos, Xos, Xos, Xos, Xos, Xos, Xos, Xos, Xos, Xos, Qxu, Qxu, Xos, Xos, Yhr, Xuc, Xuc, Xuc, Xuc, Xuc, Xuc, Xuc, Xuc, Xuc, Xuc, Xu, Xu, Xu, Xu, Xuc, Xuc, Xuc, Xuc, Xuc, Xuc, Xuc, Xuc, Xuc, Uu, Uu, Uh, Uu, Uu, Uu, Wwg, Wwg, Xos, Xu, Xos, Xos, Xos, Xos, Xos, Xu, Wwg, Xu, Xu, Xu, Wog, Wog^Xo, Wog^Xo, Wog, Xu, Xu, Xu, Xu, Xu
Xos, Xos, Xos, Xos, Xos, Xos, Xos, Xos, Xos, Xos, Xos, Xos, Xos, Xos, Xos, Xos, Xos, Qxu^Xo, Qxu, Xos, Xos, Xuc, Xuc, Xuc, Xuc, Xuc, Xuc, Xuc, Xuc, Xuc, Xuc, Xuc, Xuc, Xu, Xuc, Xuc, Xuc, Xuc, Xuc, Xuc, Xuc, Xuc, Xuc, Uu, Uh, Uh, Xuc, Uh, Xu, Xu, Xu, Xu, Xu, Xu, Xuc, Xos, Xos, Xos, Xu, Xu, Xu, Xu, Xu, Xu, Wog, Wog, Wog, Wog, Xu, Xu, Xu, Xu
Xos, Xos, Xos, Xos, Xos, Xos, Xos, Xos, Xos, Xos, Xos, Xos, Xos, Xos, Xos, Xos, Xos, Xos, Xos, Xos, Xos, Xos, Xuc, Xuc, Xuc, Xuc, Xuc, Xuc, Xuc, Xuc, Xuc, Xuc, Xuc, Xuc, Xuc, Xuc, Xuc, Xuc, Xuc, Xuc, Xuc, Xuc, Xuc, Xuc, Xuc, Xuc, Xuc, Xuc, Xuc, Xuc, Xuc, Xuc, Xuc, Xuc, Xuc, Xuc, Xuc, Xuc, Xuc, Xuc, Xuc, Xuc, Xos, Xos, Xos, Xos, Xos, Xos, Xos, Xu, Xu, Xu
Xos, Xos, Xos, Xos, Xos, Xos, Xos, Xos, Xos, Xos, Xos, Xos, Xos, Xos, Xos, Xos, Xos, Xos, Xos, Xos, Xuc, Xuc, Xuc, Xuc, Xuc, Xuc, Xuc, Xuc, Xuc, Xuc, Xuc, Xuc, Xuc, Xuc, Xuc, Xuc, Xuc, Xuc, Xuc, Xuc, Xuc, Xuc, Xuc, Xuc, Xuc, Xuc, Xuc, Xuc, Xuc, Xuc, Xuc, Xuc, Xuc, Xuc, Xuc, Xuc, Xuc, Xuc, Xuc, Xuc, Xuc, Xuc, Xuc, Xos, Xos, Xos, Xos, Xos, Xu, Xu, Xu, Xu
Xos, Xos, Xos, Xos, Xos, Xos, Xos, Xos, Xos, Xos, Xos, Xos, Xos, Xos, Xos, Xos, Xos, Xos, Xuc, Xuc, Xuc, Xuc, Xuc, Xuc, Xuc, Xuc, Xuc, Xuc, Xuc, Xuc, Xuc, Xuc, Xuc, Xuc, Xuc, Xuc, Xuc, Xuc, Xuc, Xuc, Xuc, Xuc, Xuc, Xuc, Xuc, Xuc, Xuc, Xuc, Xuc, Xuc, Xuc, Xuc, Xuc, Xuc, Xuc, Xuc, Xuc, Xuc, Xuc, Xuc, Xuc, Xuc, Xuc, Xuc, Xuc, Xu, Xu, Xu, Xu, Xu, Xu, Xu
