Xos, Xos, Xos, Xos, Xos, Xos, Xos, Xos, Xos, Xos, Xos, Xos, Xos, Xos, Xos, Xos, Xos, Xos, Xos, Xos, Xos, Xos, Xos, Xos, Xos^Zok, Uu^Zok, Uu^Zok, Uu^Zok, Uu^Zok, Uu^Zok, Xos^Zok, Xos, Xuc, Xos, Xu, Xom, Xom, Xom, Xu, Xu, Uh, Xuc, Uh, Xuc, Xuc, Xos, Xos, Xos, Xos, Xu, Xu, Xu, Xu, Xu, Xu, Xu, Xu, Xu, Xu, Xu, Xu, Xu, Xu, Xu, Xu, Xu, Xu, Xu, Xu, Xu, Xu, Xu
Xos, Xos, Xos, Xos, Xos, Xos, Xos, Xos, Xos, Xos, Xos, Xos, Xos, Xos, Xos, Xos, Xos, Xos, Xos, Xos, Xos, Xos, Xos, Xos, Xos^Zok, Uu^Zok, Uu^Zok, Uu^Zok, Uu^Zok, Uu^Zok, Xos^Zok, Xos, Xu, Xuc, Uh, Xu, Uh, Uh, Uu, Xu, Uh, Uh, Xuc, Xuc, Uh, Xos, Xos, Xos, Xos, Xu, Xu, Xu, Xu, Xu, Xu, Xu, Xu, Xu, Xu, Xu, Xu, Xu, Xu, Xu, Xu, Xu, Xu, Xu, Xu, Xu, Xu, Xu
Xos, Xos, Xos, Xos, Xos, Xos, Xos, Xos, Xos, Xos, Xos, Xos, Xos, Xos, Xos, Xos, Xos, Xos, Xos, Xos, Xos, Xos, Xos, Xos, Xos^Zok, Uu^Zok, Uu^Zok, Uu^Zok, Uu^Zok, Uu^Zok, Xos^Zok, Xos, Xuc, Xuc, Uh, Uu, Uu, Uh, Uu^Ii, Uu, Ur, Uu, Uu, Uu, Uh, Xos, Xos, Xos, Xos, Xu, Xu, Xu, Xu, Xu, Xu, Xu, Xu, Xu, Xu, Xu, Xu, Xu, Xu, Xu, Xu, Xu, Xu, Xu, Xu, Xu, Xu, Xu
Xos, Xos, Xos, Xos, Xos, Xos, Xos, Xos, Xos, Xos, Xos, Xos, Xos, Xos, Xos, Xos, Xos, Xos, Xos, Xos, Xos, Xos, Xos, Xos, Xos^Zok, Uu^Zok, Uu^Zok, Uu^Zok, Uu^Zok, Uu^Zok, Xos^Zok, Xuc, Uh, Uh, Uu, Uu, Uu, Ur, Uu, Uu, Uu^Efs, Uu, Uu, Uh, Uh, Xos, Xos, Xos, Xos, Xu, Xu, Xu, Xu, Xu, Xu, Xu, Xu, Xu, Xu, Xu, Xu, Xu, Xu, Xu, Xu, Xu, Xu, Xu, Xu, Xu, Xu, Xu
Xos, Xos, Xos, Xos, Xos, Xos, Xos, Xos, Xos, Xos, Xos, Xos, Xos, Xos, Xos, Xos, Xos, Xos, Xos, Xos, Xos, Xos, Xos, Xos, Xos^Zok, Uu^Zok, Uu^Zok, Uu^Zok, Uu^Zok, Uu^Zok, Xos^Zok, Xu, Xu, Xu, Uh, Uu^Ii, Ur, Uu, Uu, Ur, Uu, Uh, Uu, Uu, Uu, Xos, Xos, Xos, Xos, Xu, Xu, Xu, Xu, Xu, Xu, Xu, Xu, Xu, Xu, Xu, Xu, Xu, Xu, Xu, Xu, Xu, Xu, Xu, Xu, Xu, Xu, Xu
Xos, Xos, Xos, Xos, Xos, Xos, Xos, Xos, Xos, Xos, Xos, Xos, Xos, Xos, Xos, Xos, Xos, Xos, Xos, Xos, Xos, Xos, Xos, Xos, Xos^Zok, Uu^Zok, Uu^Zok, Uu^Zok, Uu^Zok, Uu^Zok, Xos^Zok, Xu, Xuc, Xuc, Uh, Uu, Ur, Uu, Uu^Ii, Uu, Uu, Uu, Uh, Uh, Uu, Uu, Uu, Xos, Xu, Xu, Xu, Xu, Xu, Xu, Xu, Xu, Xu, Xu, Xu, Xu, Xu, Xu, Xu, Xu, Xu, Xu, Xu, Xu, Xu, Xu, Xu, Xu
Xos, Xos, Xos, Xos, Xos, Xos, Xos, Xos, Xos, Xos, Xos, Xos, Xos, Xos, Xos, Xos, Xos, Xos, Xos, Xos, Xos, Xos, Xos, Xos, Xos^Zok, Uu^Zok, Uu^Zok, Uu^Zok, Uu^Zok, Uu^Zok, Xos^Zok, Xu, Xu, Uh, Uu, Uu^Efs, Uu, Uu, Ur, Uu, Ur^Efs, Uu, Uu, Ur, Uh, Uu, Urb, Uu, Xuc, Xu, Xu, Xu, Xu, Xu, Xu, Xu, Xu, Xu, Xu, Xu, Xu, Xu, Xu, Xu, Xu, Xu, Xu, Xu, Xu, Xu, Xu, Xu
Xos, Xos, Xos, Xos, Xos, Xos, Xos, Xos, Xos, Xos, Xos, Xos, Xos, Xos, Xos, Xos, Xos, Xos, Xos, Xos, Xos, Xos, Xos, Xos, Xos^Zok, Uu^Zok, Uu^Zok, Uu^Zok, Uu^Zok, Uu^Zok, Xos^Zok, Xu, Xu, Xu, Uh, Uu, Uu, Uu, Xos, Uu, Ur, Ur, Uu^Uf, Uu, Xos, Uh, Uu, Urb, Xu, Xu, Xu, Xu, Xu, Xu, Xu, Xu, Xu, Xu, Xu, Xu, Xu, Xu, Xu, Xu, Xu, Xu, Xu, Xu, Xu, Xu, Xu, Xu
Xos, Xos, Xos, Xos, Xos, Xos, Xos, Xos, Xos, Xos, Xos, Xos, Xos, Xos, Xos, Xos, Xos, Xos, Xos, Xos, Xos, Xos, Xos, Xos, Xos^Zok, Uu^Zok, Uu^Zok, Uu^Zok, Uu^Zok, Uu^Zok, Xos^Zok, Xu, Xu, Uh, Xu, Uh, Uh, Xos, Xos, Uh, Uu, Uu^Uf, Uu^Uf, Xos, Xos, Xos, Xu, Xu, Xu, Xu, Xu, Xu, Xu, Xu, Xu, Xu, Xu, Xu, Xu, Xu, Xu, Xu, Xu, Xu, Xu, Xu, Xu, Xu, Xu, Xu, Xu, Xu
Xos, Xos, Xos, Xos, Xos, Xos, Xos, Xos, Xos, Xos, Xos, Xos, Xos, Xos, Xos, Xos, Xos, Xos, Xos, Xos, Xos, Xos, Xos, Xos, Xos^Zok, Uu^Zok, Uu^Zok, Uu^Zok, Ur, Uu^Zok, Xos^Zok, Xu, Xu, Uh, Xu, Xu, Xos, Xos, Uu, Uu, Uu, Uh, Uu^Uf, Xos, Xol, Xu, Xu, Xu, Xu, Xu, Xu, Xu, Xu, Xu, Xu, Xu, Xu, Xu, Xu, Xu, Xu, Xu, Xu, Xu, Xu, Xu, Xu, Xu, Xu, Xu, Xu, Xu
Xos, Xos, Xos, Xos, Xos, Xos, Xos, Xos, Xos, Xos, Xos, Xos, Xos, Xos, Xos, Xos, Xos, Xos, Xos, Xos, Xos, Xos, Xos, Xos, Xos^Zok, Uu^Zok, Uu, Uu, Uu, Uu, Xos^Efs, Xos, Xos, Xu, Xos, Xos, Uu, Uu, Ur, Ur, Uu^Uf, Uu^Uf, Xos, Xos, Uu^Uf, Xu, Xu, Xu, Xu, Xu, Xu, Xu, Xu, Xu, Xu, Xu, Xu, Xu, Xu, Xu, Xu, Xu, Xu, Xu, Xu, Xu, Xu, Xu, Xu, Xu, Xu, Xu
Xos, Xos, Xos, Xos, Xos, Xos, Xos, Xos, Xos, Xos, Xos, Xos, Xos, Xos, Xos, Xos, Xos, Xos, Xos, Xos, Xos, Xos, Xos, Xos, Xos^Zok, Uu^Zok, Uu, Ur, Urb, Uu, Qxv, Xos^Efs, Xos, Xos, Xos, Xos, Uu, Ur^Efs, Uu, Uu, Xos, Xos, Uu, Uu, Uh, Xuc, Xuc, Xu, Xu, Xu, Xu, Xu, Xu, Xu, Xu, Xu, Xu, Xu, Xu, Xu, Xu, Xu, Xu, Xu, Xu, Xu, Xu, Xu, Xu, Xu, Xu, Xu
Xos, Xos, Xos, Xos, Xos, Xos, Xos, Xos, Xos, Xos, Xos, Xos, Xos, Xos, Xos, Xos, Xos, Xos, Xos, Xos, Xos, Xos, Xos, Xos, Xos, Qxv, Qxv, Uu, Uu, Uu, Qxv, Qxv, Qxv, Xos, Xos, Uu, Urb, Uu, Uu, Uu, Uu, Uu^Uf, Urb, Urb, Uu, Uu, Xu, Xu, Xu, Xu, Xu, Xu, Xu, Xu, Xu, Xu, Xu, Xu, Xu, Xu, Xu, Xu, Xu, Xu, Xu, Xu, Xu, Xu, Xu, Xu, Xu, Xu
Xos, Xos, Xos, Xos, Xos, Xos, Xos, Xos, Xos, Xos, Xos, Xos, Xos, Xos, Xos, Xos, Xos, Xos, Xos, Xos, Xu, Xos, Xos, Xos, Xos, Xos, Qxv, Uu, Uu, Ur, Uu, Qxv, Qxv, Xos, Xos, Uu, Urb, Uu, Uu, Uu, Uu, Uu, Uu, Uu, Xos, Xos, Xu, Xu, Xu, Xu, Xu, Xu, Xu, Xu, Xu, Xu, Xu, Xu, Xu, Xu, Xu, Xu, Xu, Xu, Xu, Xu, Xu, Xu, Xu, Xu, Xu, Xu
Xos, Xos, Xos, Xos, Xos, Xos, Xos, Xos, Xos, Xos, Xos, Xos, Xos, Xos, Xos, Xos, Xos, Xos, Xos, Xos, Xu, Xu, Uu, Xos, Xos, Xos, Qxv, Qxv, Uu, Urb, Urb, Qxv, Qxv, Xos, Xos^Efs, Uu, Urb, Uu, Uu, Urb^Efs, Urb, Uu, Uu, Xos, Xu, Xu, Xu, Xu, Xu, Xu, Xu, Xu, Xu, Xu, Xu, Xu, Xu, Xu, Xu, Xu, Xu, Xu, Xu, Xu, Xu, Xu, Xu, Xu, Xu, Xu, Xu, Xu
Xos, Xos, Xos, Xos, Xos, Xos, Xos, Xos, Xos, Xos, Xos, Xos, Xos, Xos, Xos, Xos, Xos, Xos, Xos, Xos, Xu, Xu, Xu, Uu, Xuc, Xos, Qxv, Qxv, Uh, Urb, Urb, Uh, Uu^Uf, Uu, Urb, Urb^Pr\, Xos^Efs, Xos, Xos, Uu, Uu, Urb, Uu^Uf, Uu, Xu, Xu, Xu, Xu, Xu, Xu, Xu, Xu, Xu, Xu, Xu, Xu, Xu, Xu, Xu, Xu, Xu, Xu, Xu, Xu, Xu, Xu, Xu, Xu, Xu, Xu, Xu, Xu
Xos, Xos, Xos, Xos, Xos, Xos, Xos, Xos, Xos, Xos, Xos, Xos, Xos, Xos, Xos, Xos, Xos, Xos, Xos, Xos, Xos, Xu, Xu, Ur^Br\, Ur^Br\, Xos, Xos, Uh, Uu, Uu^Uf, Uu^Uf, Urb, Uu, Urb, Uu^Uf, Uu, Uu^Em, Xos^Efs, Xos, Xos, Uu^Uf, Urb, Urb, Uu, Uh, Xuc, Xu, Xu, Xu, Xu, Xu, Xu, Xu, Xu, Xu, Xu, Xu, Xu, Xu, Xu, Xu, Xu, Xu, Xu, Xu, Xu, Xu, Xu, Xu, Xu, Xu, Xu
Qxu, Xos, Xos, Xos, Xos, Xos, Xos, Xos, Xos, Xos, Xos, Xos, Xos, Xos, Xos, Xos, Xos, Xos, Xos, Xos, Xos, Xos, Xos, Uu, Xuc, Ur^Br\, Ur^Br\, Uu^Pr\, Uu^Pr\, Uu^Uf, Uu, Uh, Uh, Uu, Urb, Uu, Uu, Uu^Em, Xu, Xu, Xu, Uu^Uf, Uh, Uu, Uh, Xuc, Xu, Xu, Xu, Xu, Xu, Xu, Xu, Xu, Xos, Xos, Xos, Xu, Xu, Xu, Xu, Xu, Xu, Xu, Xu, Xu, Xu, Xu, Xu, Xu, Xu, Xu
Qxu, Qxu, Qxu, Xos, Xos, Xos, Xos, Xos, Xos, Xos, Xos, Xos, Xos, Xos, Xos, Xos, Xos, Xos, Xos, Xos, Xos, Xos, Xos, Xos, Xos, Uu, Xos, Ur^Br\, Ur^Br\, Xos, Xos, Uh, Xuc, Uu, Uu, Urb, Uu, Xuc, Xu, Xu, Xu, Xu, Xu, Uh, Xu, Xu, Xu, Xu, Xu, Xu, Xu, Xu, Xos, Xos, Xos, Xos, Xos, Xos, Xos, Xu, Xos, Xu, Xu, Xu, Xu, Xu, Xu, Xu, Xu, Xu, Xu, Xu
Qxu, Qxu, Qxu, Qxu, Qxu, Xos, Xos, Xos, Xos, Xos, Xos, Xos, Xos, Xos, Xos, Xos, Xos, Xos, Xos, Xos, Xos, Xos, Xos, Xos, Xos, Xos, Xos, Xos, Xos, Ur^Br\, Xu, Xuc, Xuc, Uu^Em, Uu, Urb, Urb^Zz/, Uu^Zz/, Uu, Xuc, Xuc, Xu, Xu, Xu, Xu, Xu, Xu, Xu, Xos, Xu, Xos, Xos, Xos, Xos, Xos, Yhl, Yhl, Xos, Xos, Xos, Xos, Xos, Xos, Xu, Xu, Xu, Xu, Xu, Xu, Xu, Xu, Xu
Ur, Xos, Qxu, Qxu, Qxu, Qxu, Qxu, Xos, Xos, Xos, Xos, Xos, Xos, Xos, Xos, Xos, Xos, Xos, Xos, Xos, Xos, Xos, Xos, Xos, Xos, Xos, Xos, Xos, Xos, Xos, Xos, Xu, Xu, Xuc, Xu, Uu^Zz/, Urb, Uu, Uu^Efs, Uu, Xu, Xu, Xuc, Xu, Xu, Xu, Xos, Xos, Xos, Xos, Xos, Xos, Xos, Yhl, Yhl, Xos, Xos, Yhl^Pr/, Yhl^Xp, Xos, Uu, Xom, Xom, Xuc, Xuc, Xu, Xu, Xu, Xu, Xu, Xu, Xu
Rrc, Ur, Ur, Xos, Qxu, Qxu, Qxu, Qxu, Qxu, Xos, Xos, Xos, Xos, Xos, Xos, Xos, Xos, Xos, Xos, Xos, Xos, Xos, Xos, Xos, Xos, Xos, Xos, Xos, Xos, Xos, Xos, Xu, Xu, Xu, Xu, Uu, Uu^Efs, Urb, Ur, Uu, Uu, Xuc, Xuc, Xu, Xuc, Xu, Xu, Xos, Xu, Xu, Xu, Xos, Xos, Xos, Xos, Yhl^Pr/, Yhl^Xp, Xos, Uu, Uu, Uu^Uf, Uu^Uf, Uu, Xuc, Uh, Xuc, Uh, Xu, Xu, Xu, Xu, Xu
Ur, 1 Rrc, Rrc, Ur, Ur, Xos, Qxu, Qxu, Qxu, Qxu, Qxu, Xos, Xos, Xos, Xos, Xos, Xos, Xos, Xos, Xos, Xos, Xos, Xos, Xos, Xos, Xos, Xos, Xos, Xos, Xos, Xos, Xos, Xu, Xu, Xu, Xu, Uu, Uh, Uu, Urb, Urb, Uh, Uu, Xu, Ur, Xuc, Qxu, Qxu, Qxu, Xu, Xuc, Xu, Xu, Xos, Xos^Efs, Xos^Efs, Uu, Uu, Uu^Ii, Uu, Uu, Uu^Uf, Uu^Em, Uu^Vu, Uu, Uu, Uh, Xuc, Xu, Xu, Xu, Xu
Qxu, Ur, Ur, Rrc, Rrc, Ur, Ur, Xos, Qxu, Qxu, Qxu, Qxu, Qxu, Xos, Xos, Xos, Xos, Xos, Xos, Xos, Xos, Xos, Xos, Xos, Xos, Xos, Xos, Xos, Xos, Xos, Xos, Xos, Xu, Xu, Xuc, Xuc, Uu, Uh, Uu^Emf, Uu^Uf, Ur, Ur, Urb, Uu, Uu^Uf, Uu, Qxu, Qxu, Qxu, Uu, Uh, Xuc, Xu, Xos, Xos, Uu, Uh, Uu, Rb^Edt, Rb, Uu^Uf, Uh, Urb, Uu, Uu, Uu, Uh, Uh, Xu, Xu, Xu, Xu
Qxu, Xos, Qxu, Ur, Ur, Rrc, Rrc, Ur, Ur, Xos, Qxu, Qxu, Qxu, Qxu, Qxu, Xos, Xos, Xos, Xos, Xos, Xos, Xos, Xos, Xos, Xos, Xos, Xos, Xos, Xos, Xos, Xos, Xos, Xos, Xu, Xuc, Uh, Uu, Uu^Uf, Uu, Ur, Uu^Uf, Uu^Uf, Uu, Urb, Urb, Uu^Uf, Qxu, Qxu, Qxu, Uu, Uh, Xu, Xu, Xos, Xos, Uu^Uf, Uh, Uu^Vud, Uu, Uu, Urb, Urb, Uu, Uu, Wwf, Uh, Uu, Xuc, Xuc, Xu, Xu, Xu
Qxu, Qxu, Qxu, Xos, Qxu, Ur, Ur, Rrc, Rrc, Ur, Ur, Xos, Qxu, Qxu, Qxu, Qxu, Xos, Xos, Xos, Xos, Xos, Xos, Xos, Xos, Yhr, Xos, Xos, Xos, Xos, Xos, Xos, Xos, Xos, Xu, Xu, Xuc, Uu^Uf, Uu, Ur, Ur, Uu^Uf, Ur, Ur, Ur, Uu^Efs, Urb, Qxu^Bcx\, Qxu, Qxu, Qxu, Qxu, Xu, Xos, Xos, Xos^Efs, Uh, Uu^Uf, Uu, Cud, Cud, Cud, Urb, Uu^Ii, Uu, Wwf^Es, Uu, Uh, Xuc, Xu, Xu, Xu, Xu
Xos, Qxu, Qxu, Qxu, Qxu, Xos, Qxu, Ur, Ur, Rrc, Rrc, Ur, Ur, Xos, Qxu, Xos, Xos, Xos, Xos^Efs, Xos, Xos^Efs, Xos, Yhr^Pr\, Yhr, Xos, Xos, Yhr, Xos, Xos, Xos, Xos, Xos, Xos, Xos, Xu, Xu, Uu^Uf, Uu^Uf, Uu, Ur, Uu, Uu, Qxu, Urb, Qxu, Qxu, Qxu, Qxu^Bcx\, Qxu^Bcx\, Qxu, Uu, Xos, Xos, Xos^Efs, Uu^Uf, Uu, Uu^Edt, Rb, Cud, 6 Kud, Cud, Urb, Uu, Wwf, Uu, Uu, Xu, Xu, Xu, Xu, Xu, Xu
Xu, Xos, Xos, Qxu, Qxu, Qxu, Qxu, Xos, Qxu, Ur, Ur, Rrc, Rrc, Ur, Ur, Xos, Xos^Efs, Xos^Efs, Ur, Cud, Cud, Yhr^Xp, Xos^Efs, Xos, Yhr^Pr\, Yhr, Xos, Xos, Yhr, Xos, Xos, Xos, Xos, Xos, Xu, Xu, Xu, Uu, Uu^Uf, Uu, Uh, Qxu, Qxu, Qxu^Bcx|, Qxu, Uh, Uu, Qxu, Qxu, Urb, Uu, Xos, Xos^Efs, Xos, Uu, Uu, Rb^Em, Rb^Em, Uu, Cud, Uu, Wwf, Wwf, Uu, Uu, Uu, Xu, Xu, Xu, Xu, Xu, Xu
Xu, Xu, Xu, Xos, Xos, Qxu, Qxu, Qxu, Qxu, Xos, Qxu, Ur, Ur, Rrc, Rrc^Pr/, Ur^Pr/, Ur, Cud, Ur, Ur, Ur, Cud, Cud, Yhr^Xp, Xos^Efs, Xos, Yhr^Pr\, Yhr, Xos, Xos, Yhr, Xos, Xos, Xos, Xu, Xu, Xu, Xu, Xu, Uu, Qxu, Qxu, Qxu, Qxu^Bp|, Qxu, Uh, Qxu, Qxu, Uu, Urb, Uu^Uf, Uh, Uu, Uu, Urb, Uu, Uu, Uu, Urb, Urb, Uu, Wwf, Cud, Uu, Wwf, Uh, Xu, Xu, Xu, Xu, Wog, Wog
Xu, Xu, Xu, Xu, Xu, Xos, Xos, Qxu, Qxu, Qxu, Xos, Xos, Xos^Efs, Ur^Pr/, Ur^Vud, Rrc, Kud, Cud, Ur, Ur^Efs, Ur, Ur, Ur, Cud, Cud, Yhr^Xp, Xos^Efs, Xos, Yhr^Pr\, Yhr, Xos, Xos, Xos, Xos, Xu, Xu, Xu, Xu, Xu, Xu, Xu, Qxu, Qxu, Qxu^Bcx|, Qxu, Qxu, Qxu, Qxu, Qxu, Uu, Ur^Em, Uh, Ur, Urb, Uu, Uu, Xu, Uu, Urb, Uu^Ii, Uu, Uu, Uu, Uu, Uu, Xuc, Xuc, Xuc, Xu, Xu, Wog, Wog
Xu, Xu, Xu, Xu, Xu, Xu, Xu, Xos, Xos, Xos, Xos^Efs, Xos^Efs, Ur, Cud, Cud, Cud, Ur, Rrc, Rrc, Ur^Vu, Ur, Ur, Ur^Efs, Ur, Ur, Cud, Cud, Yhr^Xp, Xos, Xos, Xos, Xos, Xos, Xos, Xu, Xu, Xu, Xu, Xu, Xu, Xu, Xu, Uu^Uf, Rrc, Uu^Efs, Uu, Uu, Qxu, Qxu, Uu^Uf, Ur^Em, Uu^Uf, Ur, Uu^Vu, Uu^Uf, Xu, Xuc, Uu, Uu, Urb, Xu, Uu, Uu, Wwf, Wwg, Wwg^Es, Wog, Wog, Wog, Wog, Wog, Wog
Xu, Xu, Xu, Xu, Uh, Xos, Xu, Xu, Xu, Xos, Xos^Efs, Cud, Cud, Ur, Ur, Ur, Ur, Ur, Ur, Rrc, Rrc, Ur, Ur, Ur, Cud, Ur, Ur, Xos, Xos, Xos, Xos, Xos, Xos, Xos, Xu, Xu, Xu, Xu, Xu, Xu, Uu^Uf, Uu, Uu^Vud, Rrc, Rrc, Rrc, Rrc, Qxu, Uu^Efs, Uu^Uf, Ur, Ur, Uu, Uu, Uu^Em, Xuc, Uh, Uu, Urb, Rb^Em, Uu^Em, Uu, Wwf^Es, Wwf^Es, Wwg^Es, Wwrg, Wog, Wog, Wog, Wog, Wog, Wog
Xu, Xu, Xos, Uh, Uu^Uf, Xuc, Uh, Xu, Xos, Xos^Efs, Yhr^Pr\, Yhr^Xp, Xos^Efs, Cud, Cud, Ur^Efs, Ur, Ur, Ur, Ur^Vu, Ur, Rrc, 2 Kud, Cud, Ur^Vud, Cud, Xos, Xos, Xu, Xu, Xos, Xos, Xos, Xos, Xu, Xu, Xu, Xu, Xu, Xu, Uu^Uf, Uu, Rrc, Rrc, Uu, Uu, Uu, Qxu^Bcx\, Urb, Uu, Ur, Uu, Uu^Ii, Uu, Uu^Uf, Uu, Ur, Urb, Wwf, Uu, Uu, Cud, Wwrg, Wwg, Wwrg, Wog, Wog, Wog, Xu, Wog, Wog, Xu
Xu, Xos, Xos, Uh, Rb, Uh, Uu^Uf, Yhr, Yhr^Xp, Yhr^Pr\, Xos, Xos^Efs, Yhr^Pr\, Yhr^Xp, Xos^Efs, Cud, Cud, Ur, Ur^Efs, Ur, Ur, Cud, Ur, Rrc, Rrc^Pr/, Ur^Pr/, Ur, Xu, Xu, Xos, Xos, Xos, Xos, Xu, Xu, Xu, Xu, Xu, Xos^Efs, Xos^Efs, Uu^Zz\, Uu, Rrc, Uu, Uh, Uu^Uf, Uh, Qxu, Uu, Urb, Ur, Ur, Ur, Ur, Ur, Ur, Ur, Ur, Uu, Uu, Wwf, Wwf^Es, Wwg, Wwg, Wwrg, Wog, Xu, Xu, Xu, Xu, Xu, Xu
Xu, Xu, Uh, Yhr, Yhr^Xp, Rb^Emf, Cud, Yhr, Yhr, Yhr, Yhr^Xp, Yhr^Pr\, Xos, Xos^Efs, Yhr^Pr\, Yhr^Xp, Xos^Efs, Cud, Cud, Ur, Ur, Cud, Xos, Ur^Pr/, Ur, Rrc, Rrc, Ur, Uu^Vu, Xos, Xos^Efs, Xos^Efs, Uu, Xos, Xos, Xu, Xos^Efs, Xos, Uu^Zz\, Uu, Rrc, Rrc^Zz\, Uu^Zz\, Uu, Xuc, Xuc, Xuc, Qxu, Qxu, Uu, Uu, Uu^Uf, Uh, Uu, Uu^Uf, Uu, Uu, Ur, Uu, Uu, Wwrg, Wwrg, Wwg, Wwf, Wwg, Xu, Xos, Xu, Xu, Xu, Xu, Xu
Xu, Xu, Uh, Uh, Rb, Cud, 4 Urb^Kov, Cud, Uu, Yhr, Rb, Yhr, Yhr^Xp, Yhr^Pr\, Xos, Xos^Efs, Yhr^Pr\, Yhr^Xp, Xos, Cud, Xos, Xos, Xos, Xos, Xos, Ur, Ur, Rrc, Ur, Xos, Xos^Efs, Uu, Ur^Br/, Ur^Br/, Uu, Xos^Efs, Uu^Zz\, Uu, Rrc, Rrc^Zz\, Uu^Zz\, Uu, Xos, Xos, Xuc, Xuc, Xuc, Xuc, Qxu, Uh, Uh, Uu, Uu, Uu^Emf, Uu^Uf, Uu^Uf, Uh, Ur, Uh, Cud, Wwg, Xu, Wwg, Wwg, Yhl^Xp, Xos, Xos, Xos, Xos, Xu, Xu, Xu
Xu, Xu, Xos, Rb, Rb, Cud, Cud, Cud, Uu, Yhr^Xp, Rb, Uu, Uh, Yhr, Yhr^Xp, Yhr^Pr\, Xos, Xos, Xos, Xos, Xos, Xos, Xos, Xos, Xos, Xos, Ur, Rrc, Rrc, Uu, Ur^Br/, Ur^Pr\, Xos, Uu, Xos, Xos, Uu, Rrc^Zz\, Uu^Zz\, Uu, Xos, Xos, Xuc, Xuc, Xu, Xuc, Qxu, Qxu^Xo, Xu, Xu, Xu, Xu, Xu, Uu^Uf, Uh, Uu, Uu, Ur, Uu, Wwg, Wog, Wog, Yhl^Xp, Xos, Xos, Yhl^Pr/, Yhl, Xos, Xos, Xos, Xos, Xu
Xos, Xu, Xu, Xu, Yhr, Yhr, Rb, Yhr, Yhr^Xp, Rb, Uu^Vud, Uu, Rb, Rb, Yhr^Xp, Xol, Xol, Xos, Xos, Xos, Xos, Xos, Xos, Xos, Xos, Xos, Uu, Uu, Ur^Br/, Ur^Br/, Re, Re^Uf, Xos, Xos, Xos^Efs, Xos, Cud, Rrc, Uu, Xos, Xuc, Xuc, Xu, Xu, Xu, Xu, Xuc, Xuc, Xu, Xu, Xu, Xu, Xu, Xu, Xu, Xu, Xu, Uu, Xos, Xu, Wog, Xos, Xos, Yhl^Pr/, Yhl, Xos, Yhl, Uu, Xos, Xos, Xos, Xos
Xos, Xos, Xos, Xu, Xos, Yhr^Xp, Rb, Rb^Vu, Yhr, Yhr^Xp, Yhr, Yhr, Rb, Rb, Cud, Cud, Yhr, Xos^Xzm\, Xos, Xos, Xu, Xos, Xu, Xos, Uu, Xos^Efs, Ur^Pr\, Ur^Br/, Uu, Rrc, Rrc, Uu^Uf, Xos, Xos^Efs, Uh, Uu, Uu, Cud, Cud, Xos, Xu, Xu, Uu^Br|, Uh, Xos, Xuc, Xuc, Xuc, Xuc, Xu, Xos, Xos, Xos, Xu, Xu, Xu, Xu, Xos, Xos, Wog, Xos, Xos, Xos, Xos, Yhl, Yhl, Yhl^Em, Uu^Emf, Uh, Xos, Xos, Xos
Xos, Xos, Xos, Xos, Xos, Cud, Cud, Rb, Yhr, Uh, Uh, Uu, Xos, Cud, Yhr, Yhr, Yhr, Xos, Xos, Xos, Xu, Xu, Xu, Uu, Ur^Br/, Ur^Br/, Uu, Xos, Uu^Vu, Uu, Rrc, Uh, Uu^Uf, Uu^Ufi, Uu, Uu^Vud, Rrc, Rrc, Uu, Xos, Xu, Uh, Uu^Br|, Uh, Xos, Xos, Xu, Xuc, Xuc, Xos, Xos, Xos, Xos, Xos, Xos, Xu, Xos, Xos, Xos, Xos, Xos, Xos, Uh, Uu, Yhl^Uf, Yhl, Yhl^Em, Uu^Uf, Uu, Xos, Xos, Xos
Xos, Xos, Xos, Xos, Xos^Efs, Yhr, Yhr^Xp, Cud, Xos^Efs, Uh, Xos, Xos, Yhr^Xp, Yhr, Yhr^Xp, Yhr^Xp, Xos, Xos, Xos, Xos, Uu^Emf, Xu, Xu, Xu, Xu, Uu, Xos^Efs, Xos, Uu^Uf, Uu, Rrc, Rrc, Rrc, Uh, Cud, Uu, Rrc, Uu, Uh, Xos, Xu, Uh, Uu^Pr/, Uu^Pr/, Qxu, Xu, Xu, Xu, Xu, Xos, Xos, Xos, Wog, Xos, Xos, Xos, Xos, Xos, Xos, Xos, Xos, Xos, Uh, Uh, Uu^Uf, Yhl^Em, Yhl^Em, Yhl, Yhl, Yhl, Yhl^Pr/, Xos
Xos, Xos, Xos, Xos^Efs, Qxu, Yhr, Yhr, Yhr, Yhr, Xos^Efs, Xos, Xos, Yhr^Xp, Yhr, Xos^Xzm/, Xos, Uh, Xos^Efs, Cud, Rrc, Rrc, Uu^Uf, Uh, Xu, Xu, Xos^Efs, Uu, Uh, Rrc, Rrc, Uu, Uu^Efs, Uu, Rrc, Cud, Cud, Cud, Uh, Uu, Xos, Xos, Uu^Pr/, Uu^Br|, Qxu, Xu, Xu, Xu, Xu, Xos, Xos, Xos, Wog, Wog, Xos, Xos, Xos, Xos, Xos, Xos, Xos, Xos, Xos, Xos, Uu, Uu, Yhl, Yhl, Yhl, Yhl^Pr/, Xos, Xos, Yhl
Xos, Xos, Xos, Xos, Qxu, Uh, Uu, Yhr, Yhr, Yhr, Yhr^Xp, Xos^Efs, Yhr, Yhr, Uh, Uu^Uf, Uu^Vud, Uu, Yhr, Cud, Xu, Rrc, Rrc, Uu, Rrc, Uu, Rrc, Rrc, Uu, Uu, Xos, Uh, Uu, Ur, Cud, 3 Kud, Cud, Uu, Uu, Xos^Efs, Uu, Uu, Uu^Br|, Qxu, Xos, Xu, Xos, Xos, Xos^Efs, Xos^Efs, Wog, Wog^Xo, Wog^Xo, Xos, Xos^Efs, Xos, Xos, Xos, Xos^Efs, Xos^Efs, Uh, Xos^Efs, Xos^Efs, Xos, Xos, Uh, Xos, Xos, Xos, Yhl, Yhl, Xos
Xos, Xos, Xos, Xos, Qxu, Uh, Uh, Yhr, Yhr, Yhr, Yhr, Yhr, Yhr, Yhr^Xp, Yhr, Uu^Uf, Yhr, Yhr, Uu, Xu, Uh, Uu, Uu, Rrc, Uh, Rrc, Xos, Uh, Xos, Xos, Xos^Efs, Uu, Ur, Ur, Cud, Cud, Uu, Uu, Uu, Uh, Uu, Uu, Uu^Pr/, Uu^Pr/, Xos, Xos, Xos, Xos, Cud, Wwg, Wog, Wog, Xos, Xos^Efs, Uh, Uh, Uu, Xos, Uu, Uh, Wwf, Uh, Uh, Xos, Xos, Xos, Xos, Xos, Xos, Xos, Xos, Yhl
Xos, Xos, Xos, Xos, Xos, Qxu, Yhr, Yhr, Yhr, Xos, Xos, Yhr, Yhr, Yhr, Yhr, Yhr, Uh, Uu^Uf, Xos, Xu, Xu, Uh, Xu, Xu, Xu, Xos, Xos, Xos, Xos, Xos^Efs, Cud, Ur, Uu, Uu, Uu, Rrc, Uu, Uu, Uh, Uh, Xos, Uu^Pr/, Uu^Br|, Uu, Xos, Xos, Xos, Cud, Wwg, Wwg, Wog, Wwg, Cud, Xos^Efs, Uu^Ufi, Uu^Uf, Uh, Wwf, Wwf, Uu^Uf, Wwf, Uh, Wwf, Xos, Xos, Xos, Xos, Xos, Xos, Xos, Xos, Xos
Xos, Xos, Xos, Xos, Xos, Xos, Yhr, Yhr, Yhr, Xos, Xos, Yhr, Yhr, Yhr, Yhr, Uu, Xos, Xos, Xos, Xos, Xos, Xu, Xu, Xu, Xos, Xos, Xos, Xu, Uu, Ur, Uh, Cud, Xos, Uu, Uu^Vu, Rrc, Uu, Xos, Xos^Efs, Xos, Xuc, Uh, Uu^Br|, Uu^Br\, Xos, Xos, Xos, Wwrg, Wwg, Wog, Wwrg, Wwg, Cud, Uu^Vud, Wwf, Uu, Cud, Wwf, Cud, Uu, Uu, Wwf, Wwf, Xos, Xos, Xos, Xos^Efs, Xos, Xos, Xos, Xos, Xos
Xos, Xos, Xos, Xos, Xos, Xos, Yhr^Xp, Yhr, Yhr, Yhr^Xp, Yhr^Xp, Yhr, Yhr, Yhr, Yhr^Xp, Yhr^Xp, Xos, Xos, Xos, Xos, Xos, Xos, Xos, Xos, Xos^Efs, Xos^Xzm/, Uh, Yhr, Uu, Uh, Xos, Xos, Xos, Xos, Uu, Rrc, Rrc, Uu, Uu, Xos^Efs, Xuc, Xuc, Xu, Xu, Xos, Xos, Xos, Wwg, Uu^Ii, Wwg, Wwg, Wwg, Cud, Urb, Urb, Cud, 5 Kud, Cud, Uu^Vu, Urb, Wwg, Xos, Xos, Wwf^Pr/, Wwf, Cud, Cud, Xos^Efs, Xos, Xos, Xos, Xos
Xos, Xos, Xos, Xos, Yhr, Yhr^Pr\, Xos, Xos, Yhr^Xp, Yhr, Yhr, Yhr, Yhr^Pr/, Xol, Xol, Xos, Xos, Xos, Yhr, Xos, Xos, Xos, Xos, Xos^Efs, Yhr^Xp, Uu^Uf, Yhr, Yhr, Xos, Xos, Xos^Efs, Xos^Efs, Yhr, Xos, Uu^Pr\, Uu^Efs, Uu, Rrc, Uu, Uu, Uu, Xuc, Xu, Xu, Xos, Xos, Wog, Wwg, Wwg, Wwg, Xos, Xos, Xos, Wwf, Wwg, Cud, Cud, Cud, Uh, Wwf^Es, Wwf, Uu^Ufi, Uh^Ii, Xos, Cud, Uu^Ii, Cud, Xos, Xos, Xos, Xos, Xos
Xos, Xos, Yhr, Yhr, Xos, Xos, Yhr, Yhr^Pr\, Xos, Xos, Xos, Yhr^Pr/, Yhr, Yhr, Yhr, Xos, Xos, Xos, Xos, Yhr, Yhr^Pr|, Xos, Xos, Yhr^Xp, Yhr, Yhr, Yhr, Xos, Xos, Xos, Xos, Wwf, Yhr^Xp, Yhr, Xos, Xos, Xos, Uu, Uu, Rrc, Uu, Xuc, Xos, Xos, Xos, Wwrg, Wog, Wog, Wwrg, Wog, Xos, Xos, Xos, Xos, Uh, Uu, Urb, Cud, Cud, Wwf, Uu^Vud, Uu^Uf, Uh, Xos, Xos, Cud, Xos, Xos, Xu, Xos, Xos, Xos
Xos, Xos, Xos, Xos, Yhr, Yhr, Xos, Xos, Xos, Xos, Xos, Uh, Rb^Uf, Yhr, Yhr, Uu^Uf, Yhr, Xos^Xzm\, Xos, Xos, Yhr^Xp, Xos, Yhr^Xp, Yhr, Yhr, Yhr, Xos, Xos, Xos, Xos, Uu^Uf, Wwf, Wwg, Yhr^Xp, Xu, Xu, Xos, Xos, Wwrg, Uu, Rrc, Uu, Xos, Xos, Cud, Wwg, Wwg, Wwrg, Xos, Xos, Xos, Xos, Xos, Xos, Uu, Uu^Ii, Urb, Uu, Uu, Urb, Urb, Uu, Xos, Xos, Xu, Xos, Wog, Xu, Xu, Xu, Xu, Xos
Xos, Xos, Xos, Xos, Xos, Xos, Qxu, Xos, Xos, Xos, Xos, Xos, Yhr^Emf, Yhr, Yhr, Uh, Uu^Vud, Yhr, Uu^Uf, Xos^Xzm\, Yhr, Yhr, Yhr, Yhr, Yhr, Xos, Xos, Xos, Xos, Uh, Uh, Wwg, Wwf, Uu^Uf, Xu, Xu, Xu, Xos, Wwg, Uu, Rrc, Uu, Wwf, Wwf, Uu, Cud, Cud, Wwg, Xos, Xos, Xos, Xos, Xos^Efs, Xos^Efs, Cud, Urb, Uu^Uf, Xos, Xos, Uu, Cud, Cud, Xos, Xos, Wog, Wog^Xo, Wog^Xo, Wog, Xu, Xu, Xu, Xu
Xos, Xos, Xos, Xos, Xos, Xos, Xos, Qxu, Qxu, Xos, Xos, Xos, Uu^Uf, Uu^Emf, Yhr^Xp, Yhr, Yhr, Yhr^Xp, Yhr^Uf, Uh, Yhr, Yhr, Xuc, Yhr^Xp, Yhr^Xp, Uu^Uf, Uu^Vu, Xos^Efs, Uh, Uh, Wwf, Uu^Uf, Xos, Xu, Xu, Xu, Wwg, Wwg, Xu, Uu, Uu, Rrc, Wwf, Wwg, Uu^Vu, Uu, Wwf, Cud, Xos, Xos, Xos, Xos, Uu, Wwf, Urb, Cud, Xos^Efs, Xos, Xos, Xos, Urb, Uu, Wwrg, Wwg, Wog, Wog, Xu, Xu, Xu, Xu, Xu, Xu
Xos, Xos, Xos, Xos, Xos, Xos, Xos, Xos, Xos, Qxu, Qxu^Xo, Xos, Uh, Xos, Xos, Yhr, Yhr, Yhr, Yhr, Yhr, Uh, Yhr, Yhr, Yhr, Yhr, Uh, Uh, Wwf, Wwg, Uu^Uf, Yhr^Xp, Xos, Xos, Xu, Xu, Xu, Xos, Wwg, Xu, Xu, Wwf, Uu, Wwg, Uu, Uu, Wwf, Wwf, Urb, Cud, Xos^Efs, Uu, Uu, Wwf, Uu, Uu^Vu, Uu, Uu, Xos^Efs, Xos, Wwg, Urb, Uu^Vud, Wwg, Wwg, Wog, Xuc, Xu, Xu, Xu, Xu, Xu, Xu
Xos, Xos, Xos, Xos, Xos, Xos, Xos, Xos, Xos, Xos, Xos, Qxu, Qxu, Uh, Uh, Yhr, Yhr^Xp, Yhr^Xp, Yhr, Uu^Vu, Xos, Xos, Xuc, Xuc, Xuc, Uh, Wwg, Wwf, Wwrg, Yhr, Uu^Uf, Xos, Xos, Xos, Xu, Xos, Xos, Xos, Xu, Xu, Xu, Wwf, Xu, Wwf, Uu, Uu, Uu, Cud, Wwf, Wwf, Uu, Urb, Wwf, Wwg, Uu, Uu, Wwf, Wwg, Urb, Wwg, Uu, Uu, Wwg, Wog, Wog, Xuc, Xuc, Xu, Xu, Xu, Xu, Xu
Xos, Xos, Xos, Xos, Xos, Xos, Xos, Xos, Xos, Xos, Xos, Xos, Xos, Qxu, Qxu, Yhr, Yhr, Yhr, Yhr^Pr/, Xos, Xos, Xuc, Xuc, Xuc, Xuc, Xuc, Xuc, Wwg, Wwf, Uu^Uf, Uh, Wwf, Xos, Xu, Xu, Xos, Xuc, Xuc, Xuc, Xu, Xuc, Xu, Uu^Uf, Wwf, Uu, Uu, Uu, Wwrg, Wwg, Wwf, Wwrg, Wwrg, Xos, Xos, Xos, Xos, Xos, Wwg, Uu, Uu, Wwf, Uu, Xu, Wwrg, Wog, Wog, Xos, Xu, Xu, Xu, Xu, Xu
Xos, Xos, Xos, Xos, Xos, Xos, Xos, Xos, Xos, Xos, Xos, Xos, Xos, Xos, Xos, Qxu, Qxu, Xos, Xos, Yhr, Xuc, Xuc, Xuc, Xuc, Xuc, Xuc, Xuc, Xuc, Xuc, Xuc, Xu, Xu, Xu, Xu, Xuc, Xuc, Xuc, Xuc, Xuc, Xuc, Xuc, Xuc, Xuc, Uu, Uu, Uh, Uu, Uu, Uu, Wwg, Wwg, Xos, Xu, Xos, Xos, Xos, Xos, Xos, Xu, Wwg, Xu, Xu, Xu, Wog, Wog^Xo, Wog^Xo, Wog, Xu, Xu, Xu, Xu, Xu
Xos, Xos, Xos, Xos, Xos, Xos, Xos, Xos, Xos, Xos, Xos, Xos, Xos, Xos, Xos, Xos, Xos, Qxu^Xo, Qxu, Xos, Xos, Xuc, Xuc, Xuc, Xuc, Xuc, Xuc, Xuc, Xuc, Xuc, Xuc, Xuc, Xuc, Xu, Xuc, Xuc, Xuc, Xuc, Xuc, Xuc, Xuc, Xuc, Xuc, Uu, Uh, Uh, Xuc, Uh, Xu, Xu, Xu, Xu, Xu, Xu, Xuc, Xos, Xos, Xos, Xu, Xu, Xu, Xu, Xu, Xu, Wog, Wog, Wog, Wog, Xu, Xu, Xu, Xu
Xos, Xos, Xos, Xos, Xos, Xos, Xos, Xos, Xos, Xos, Xos, Xos, Xos, Xos, Xos, Xos, Xos, Xos, Xos, Xos, Xos, Xos, Xuc, Xuc, Xuc, Xuc, Xuc, Xuc, Xuc, Xuc, Xuc, Xuc, Xuc, Xuc, Xuc, Xuc, Xuc, Xuc, Xuc, Xuc, Xuc, Xuc, Xuc, Xuc, Xuc, Xuc, Xuc, Xuc, Xuc, Xuc, Xuc, Xuc, Xuc, Xuc, Xuc, Xuc, Xuc, Xuc, Xuc, Xuc, Xuc, Xuc, Xos, Xos, Xos, Xos, Xos, Xos, Xos, Xu, Xu, Xu
Xos, Xos, Xos, Xos, Xos, Xos, Xos, Xos, Xos, Xos, Xos, Xos, Xos, Xos, Xos, Xos, Xos, Xos, Xos, Xos, Xuc, Xuc, Xuc, Xuc, Xuc, Xuc, Xuc, Xuc, Xuc, Xuc, Xuc, Xuc, Xuc, Xuc, Xuc, Xuc, Xuc, Xuc, Xuc, Xuc, Xuc, Xuc, Xuc, Xuc, Xuc, Xuc, Xuc, Xuc, Xuc, Xuc, Xuc, Xuc, Xuc, Xuc, Xuc, Xuc, Xuc, Xuc, Xuc, Xuc, Xuc, Xuc, Xuc, Xos, Xos, Xos, Xos, Xos, Xu, Xu, Xu, Xu
Xos, Xos, Xos, Xos, Xos, Xos, Xos, Xos, Xos, Xos, Xos, Xos, Xos, Xos, Xos, Xos, Xos, Xos, Xuc, Xuc, Xuc, Xuc, Xuc, Xuc, Xuc, Xuc, Xuc, Xuc, Xuc, Xuc, Xuc, Xuc, Xuc, Xuc, Xuc, Xuc, Xuc, Xuc, Xuc, Xuc, Xuc, Xuc, Xuc, Xuc, Xuc, Xuc, Xuc, Xuc, Xuc, Xuc, Xuc, Xuc, Xuc, Xuc, Xuc, Xuc, Xuc, Xuc, Xuc, Xuc, Xuc, Xuc, Xuc, Xuc, Xuc, Xu, Xu, Xu, Xu, Xu, Xu, Xu
