Xu, Xu, Xu, Xu, Xu, Xu, Xu, Xu, Xu, Xu, Xu, Xu, Xu, Xu, Xu, Xu, Xu, Xu, Xu, Xu, Xu, Xu, Xu, Xu, Xu, Xu, Xu, Xu, Xu, Xu, Xu, Xu, Xu, Xu, Xu, Xu, Xu, Xu, Xu, Xu, Xu, Xu, Xu, Xu, Xu, Xu, Xu, Xu, Xu, Xu, Xu, Xu, Xu, Xu, Xu, Xu, Xu, Xu, Xu, Xu
Xu, Xu, Xu, Xu, Xu, Xu, Xu, Xu, Xu, Xu, Xu, Xu, Xu, Xu, Xu, Xu, Xu, Xu, Xu, Xu, Xu, Xu, Xu, Xu, Xu, Xu, Xu, Xu, Xu, Xu, Xu, Xu, Xu, Xu, Xu, Xu, Xu, Xu, Xu, Xu, Xu, Xu, Xu, Xu, Xu, Xu, Xu, Xu, Xu, Xu, Xu, Xu, Xu, Xu, Xu, Xu, Xu, Xu, Xu, Xu
Xu, Xu, Xu, Xu, Xu, Xu, Xu, Xu, Xu, Xu, Xu, Xu, Xu, Xu, Xu, Xu, Xu, Xu, Xu, Xu, Xu, Xu, Xu, Xu, Xu, Xu, Qxu, Qxu, Qxu, Qxu, Qxu, Xu, Xu, Xu, Xu, Xu, Xu, Xu, Xu, Xu, Xu, Xu, Xu, Xu, Xu, Xu, Xu, Xu, Xu, Xu, Xu, Xu, Xu, Xu, Xu, Xu, Xu, Xu, Xu, Xu
Xu, Xu, Xu, Xu, Xu, Xu, Xu, Xu, Xu, Xu, Xu, Xu, Xu, Xu, Xu, Xu, Xu, Xu, Xu, Xu, Xu, Xu, Xu, Xu, Xu, Xu, Qxu, Qxu, Qxu, Qxu, Qxu, Xu, Xu, Xu, Xu, Xu, Xu, Xu, Xu, Xu, Xu, Xu, Xu, Xu, Xu, Xu, Xu, Xu, Xu, Xu, Xu, Xu, Xu, Xu, Xu, Xu, Xu, Xu, Xu, Xu
Xu, Xu, Xu, Xu, Xu, Xu, Xu, Xu, Xu, Xu, Xu, Xu, Xu, Xu, Xu, Xu, Xu, Xu, Xu, Xu, Xu, Xu, Xu, Xu, Xu, Qxu, Xu, Qxu, Yhl^Xp, Yhl, Xu, Xu, Xos, Xu, Xu, Xu, Xu, Xu, Xu, Xu, Xu, Xu, Xu, Xu, Xu, Xu, Xu, Xu, Xu, Xu, Xu, Xu, Xu, Xu, Xu, Xu, Xu, Xu, Xu, Xu
Xu, Xu, Xu, Xu, Xu, Xu, Xu, Xu, Xu, Xu, Xu, Xu, Xu, Xos, Xos, Xu, Xu, Xu, Xu, Xu, Xu, Xu, Xos^Efs, Xuc, Yhl, Xuc, Xuc, Xu, Yhl, Yhl, Yhl, Xu, Yhl^Xp, Xos, Xos^Xzm\, Xu, Xu, Xu, Xu, Xu, Xu, Xu, Xu, Xu, Xu, Xu, Xu, Xu, Xu, Xu, Xu, Xu, Xu, Xu, Xu, Xu, Xu, Xu, Xu, Xu
Xu, Xu, Xu, Xu, Xu, Xu, Xu, Xu, Xu, Xu, Xu, Xu, Xos, Ur^Br\, Ur^Br\, Xom, Xom, Xu, Xos, Xu, Yhl, Yhl^Xp, Yhl, Yhl, Yhl^Xp, Yhl, Yhl, Yhl, Xuc, Xu, Xu, Yhl, Yhl, Yhl, Yhl^Xp, Xos, Xos^Xzm\, Xu, Xu, Xu, Xu, Xu, Xu, Xu, Xu, Xu, Xu, Xu, Xu, Xu, Xu, Xu, Xu, Xu, Xu, Xu, Xu, Xu, Xu, Xu
Xu, Xu, Xu, Xu, Xu, Xu, Xu, Xu, Xu, Xu, Xu, Xu, Xu, Xos, Xos, Ur^Br\, Ur^Pr/, Xom^Xzm/, Yhl, Yhl, Yhl, Yhl, Xos, Xos, Xu, Uu^Uf, Uu^Uf, Yhl^Emf, Uu^Uf, Xuc, Xos, Yhl, Yhl^Xp, Yhl, Yhl, Yhl, Xu, Xos, Xu, Xu, Xu, Xu, Xu, Xu, Xu, Xu, Xu, Xu, Xu, Xu, Xu, Xu, Xu, Xu, Xu, Xu, Xu, Xu, Xu, Xu
Xu, Xu, Xu, Xu, Xu, Xu, Xu, Xu, Xu, Xu, Xom^Efs, Xom, Xu, Xu, Xu, Xos, Yhl, Ur^Br\, Ur^Br\, Yhl^Xp, Xuc, Xos, Xu, Xu, Xu, Xuc, Uh, Yhl^Xp, Xom, Xom, Xu, Xos, Xos, Yhl^Xp, Xu, Yhl, Yhl^Pr/, Xuc, Xos, Xu, Xu, Xu, Xu, Xu, Xu, Xu, Xu, Xu, Xu, Xu, Xu, Xu, Xu, Xu, Xu, Xu, Xu, Xu, Xu, Xu
Xu, Xu, Xu, Xu, Xu, Xu, Xu, Xu, Xos, Xos, Yhl^Emf, Uu^Uf, Uh^Em, Uu^Emf, Yhl, Yhl, Xu, Xos, Xos, Ur^Pr/, Ur^Br\, Xuc, Xu, Qxu, Qxu, Xu, Yhl^Pr|, Xom, Xom, Xu, Xu, Xu, Xuc, Xu, Qxu, Xuc^Efs, Yhl^Xp, Yhl, Yhl^Xp, Xuc, Xu, Xu, Xu, Xu, Xu, Xu, Xu, Xu, Xu, Xu, Xu, Xu, Xu, Xu, Xu, Xu, Xu, Xu, Xu, Xu
Xu, Xu, Xu, Xu, Xu, Xu, Xos, Xu, Xu, Yhl^Em, Yhl^Xp, Yhl^Xp, Yhl, Yhl, Yhl^Pr/, Xuc, Xu, Xu, Xuc, Xuc, Yhl^Xp, Ur^Br|, Yhl^Xp, Qxu^&A, Qxu, Xuc, Yhl^Xp, Xom, Xos, Xu, Qxu, Xuc, Qxu, Qxu^&A, Qxu, Qxu, Yhl^Xp, Yhl, Qxu, Qxu, Xuc, Xu, Xu, Xu, Xu, Xu, Xu, Xu, Xu, Xu, Qxu, Xu, Xu, Xu, Xu, Xu, Xu, Xu, Xu, Xu
Xu, Xu, Xu, Xu, Xu, Xos, Yhl, Xu, Xu, Xu, Uh, Yhl, Yhl^Xp, Xuc, Xuc, Yhl^Xp, Qxu^Bp/, Xuc, Xu, Qxu, Ur^Bp/, Ur^Br/, Qxu, Qxu, Uh, Yhl^Xp, Xu, Xu, Xos, Xu, Xu, Qxu, Xu, Qxu, Xu, Xu, Yhl, Yhl^Xp, Qxu^&A, Qxu, Qxu, Xu, Xu, Xu, Xu, Xu, Xu, Xu, Xu, Xu, Qxu, Qxu, Xu, Xu, Xu, Xu, Xu, Xu, Xu, Xu
Xu, Xu, Xu, Xu, Xu, Xu, Xu, Yhl^Xp, Yhl, Uu, Yhl, Yhl^Xp, Xu, Xu, Xu, Xu, Qxu, Qxu, Qxu, Qxu, Qxu^&A, Qxu, Qxu, Uh, Uu, Xu, Xos^Xzm/, Xos, Uh, Xu, Xu, Qxu, Qxu, Xuc, Qxu, Xu, Yhl, Qxu, Qxu, Qxu, Xu, Xu, Xu, Xu, Xu, Xu, Qxu, Qxu, Xu, Xu, Qxu, Qxu, Xu, Xu, Xu, Xu, Xu, Xu, Xu, Xu
Xu, Xu, Xu, Xu, Xu, Xu, Xu, Xu, Yhl^Em, Yhl, Xu, Xu, Xos, Xu, Xu, Xu, Xu, Qxu, Xu, Qxu, Qxu, Qxu, Kud, Cud, Urb^Edb, Uu^Em, Uu^Em, Uu^Uf, Uh^Ii, Uh, Qxu, Qxu, Qxu, Qxu, Yhl^Xp, Yhl, Xos, Xu, Qxu, Qxu, Xu, Xu, Xu, Xu, Xu, Qxu, Xu, Qxu, Qxu, Qxu, Xuc, Xu, Qxu, Qxu, Qxu, Qxu, Qxu, Xu, Xu, Xu
Xu, Xu, Xu, Qxu, Qxu, Qxu, Yhl^Emf, Yhl^Uf, Uh, Qxu, Xu, Xos, Qxu, Xu, Qxu, Xu, Qxu, Qxu, Xu, Xos, Uh^Ii, Cud, Urb, Urb^Edb, Urb^Edb, Urb, Urb, Uu^Uf, Uu^Uf, Uu, Qxu, Qxu^&A, Xu, Yhl^Xp, Xos, Xos, Xu, Xu, Xu, Xu, Xu, Xu, Xu, Xu, Xu, Xu, Uh, Qxu, Xuc, Xuc, Xu, Xu, Uh, Qxu, Uh, Xuc, Qxu, Qxu, Xu, Xu
Xu, Xu, Xu, Xu, Qxu, Qxu, Yhl^Xp, Yhl^Uf, Yhl^Uf, Xu, Xu, Xu, Xu, Qxu, Qxu, Xu, Qxu, Xu, Xos^Efs, Xos, Uh, Urb, Urb^Em, Urb, Xuc, Urb, Urb, Urb^Em, Urb, Uu, Uu^Vud, Qxu, Xu, Xu, Xu, Xos, Xos, Xos, Xu, Xu, Xu, Xu, Xu, Uh, Xu, Uh, Qxu, Qxu, Qxu, Qxu, Xuc, Uh, Uu^Uf, Uu^Uf, Qxu, Uh, Qxu, Xu, Xu, Xu
Xu, Xu, Xu, Xos, Xos, Qxu, Qxu, Yhl^Xp, Yhl^Em, Xu, Xu, Xu, Xu, Xu, Qxu, Qxu, Qxu^&A, Qxu, Urb, Urb, Urb, Urb, Rb^Uf, Qxu, Qxu, Uu^Ii, Uu^Uf, Urb^Em, Urb^Edb, Urb, Urb^Edb, Uu^Uf, Uu, Qxu, Qxu^&A, Qxu, Xu, Xos, Xu, Xu, Xu, Xu, Uu, Uh, Uu^Uf, Uu^Uf, Uu^Vu, Qxu, Cud, Qxu, Qxu, Qxu, Uu^Uf, Uu^Uf, Uu, Qxu, Uh, Xu, Xu, Xu
Xu, Xu, Xu, Xu, Xu, Xu, Xu, Yhl^Uf, Yhl^Emf, Yhl^Xp, Xos, Xu, Xuc, Xuc, Xu, Xu, Qxu, Qxu, Urb^Edb, Urb^Edb, Xuc, Uu^Em, Uu^Dr, Uu^Es, Qxu^&B, Qxu, Uu^Es, Uu, Xuc, Urb^Edb, Urb^Edb, Urb^Edb, Urb, Qxu, Qxu, Qxu, Xu, Xu, Xu, Xu, Xos, Xos, Uu, Uh, Uu^Uf, Uu^Uf, Uu^Edt, Uu^Edt, Cud, Cud, Uu, Uu^Vud, Urb^Edt, Uu^Ii, Uu^Edt, Uh, Uh, Qxu, Qxu, Xu
Xu, Xu, Xu, Xu, Xos, Xu, Yhl^Xp, Yhl^Emf, Xos, Yhl^Em, Yhl^Pr/, Xos^Xzm\, Xu, Uu, Qxu, Qxu, Qxu, Uu^Vud, Urb^Edb, Urb^Edb, Uu, Qxu, Qxu^&B, Qxu, Xu, Qxu, Qxu^&B, Uh, Qxu, Uh, Uh, Urb, Urb, Cud, Uu, Uu, Uu, Qxu, Xu, Xu, Xu, Xu, Uu^Edt, Uu^Ii, Urb, Urb, Urb^Edt, Urb^Edt, Uu, 5 Kud, Cud, Urb, Uu^Edt, Uu^Edt, Uu^Uf, Uu^Uf, Qxu, Qxu, Xu, Xu
Xu, Xu, Xos^Xzm/, Xos^Xzm/, Yhl^Pr\, Yhl, Xu, Xos, Xu, Xos, Xu, Yhl^Xp, Yhl^Xp, Uu, Uu^Ii, Xu, Rb, Rb^Uf, Urb, Urb^Ii, Uu^&B, Qxu, Qxu, Xu, 2 Xu, Xu, Qxu, Qxu, Uu^&B, Uu, Uu^Uf, Urb, Urb, Kud, Uh, Qxu^&A, Uh, Xu, Cud, Xu, Xos, Xos, Urb^Edt, Urb^Edt, Urb^Edt, Urb, Urb, Uu^Vud, Qxu, Cud, Qxu, Uu, Uh, Uh, Uh, Qxu, Qxu, Xu, Xu, Xu
Xu, Xu, Xu, Yhl, Yhl^Xp, Xos, Xu, Xu, Xu, Xu, Xuc, Xu, Qxu, Uu, Uh, Uu, Urb^Edb, Urb, Urb^Ii, Urb^Ii, Qxu, Qxu, Qxu^&B, Xu, Xu, Xu, Qxu^&B, Qxu, Uh, Uh, Uu^Em, Urb^Em, Urb^Edt, Cud, Uu^Ii, Uh, Uu^Vud, Uu, Urb, Uh, Xu, Xu, Urb, Urb, Uh, Uu, Uu^Uf, Urb, Qxu, Qxu, Qxu, Qxu, Qxu, Uh, Xu, Xu, Qxu, Qxu, Xu, Xu
Xu, Xu, Yhl^Xp, Yhl^Xp, Xu, Xu, Xu, Xu, Xu, Xuc, Qxu, Qxu, Qxu, Uu, Uu^Vud, Qxu, Urb^Edb, Urb^Edb, Uh, Uh, Xuc, Qxu, Re^Dr, Qxu, Qxu^&B, Qxu, Qxu, Qxu, Xuc, Uh, Urb, Urb^Edt, Urb, Urb, Urb^Ii, Urb, Urb, Urb, Urb, Urb, Xos, Xos, Uu, Uu^Uf, Uh, Uh, Uu, Uu, Uu^Uf, Qxu, Qxu, Qxu, Qxu, Qxu, Xu, Xu, Xu, Qxu, Xu, Xu
Xu, Xu, Xu, Yhl, Xu, Xu, Xu, Xos, Xos, Xuc, Qxu, Qxu^&A, Qxu, Uu, Qxu, Qxu, Urb, Urb, Uu^Vud, Uu, Re^Edb, Uu^Edb, Uu^&B, Qxu, Urb^Es, Urb^Es, Qxu^&B, Qxu, Uh, Urb, Urb, Urb, Uh, Urb, Urb, Urb, Uu, Urb, Uu^Uf, Urb, Xu, Xu, Uh, Qxu, Qxu, Qxu, Uu^Vu, Urb, Uu^Uf, Uu^Uf, Qxu, Xu, Qxu, Xu, Qxu, Qxu, Qxu, Qxu, Xu, Xu
Xos, Xu, Yhl^Xp, Yhl^Xp, Xu, Xu, Xu, Xos, Xos, Xu, Xu, Xu, Qxu, Qxu, Uu^Uf, Uu^Uf, Urb, Urb, Uu^Uf, Rb^Uf, Rb, Uu^Edb, Uh, Qxu, Xuc, Urb, Uu^Ii, Uu, Cud, Urb, Urb, Uu^Vud, Uh, Uu^Uf, Urb^Edt, Urb, Cud, Uu, Xu, Uu, Xos, Xos, Qxu, Qxu, Qxu, Uh, Urb^Edt, Urb, Uu^Uf, Xu, Xu, Xu, Xu, Qxu, Qxu, Qxu, Xu, Xu, Xu, Xu
Xos, Xos, Xos, Wog, Wog, Xu, Xu, Xu, Xos, Xos, Xuc, Xuc, Uh^Ii, Qxu^&A, Uu^Uf, Uu^Ufi, Urb^Edt, Urb, Urb^Em, Re^Uf, Uu^Vud, Uh, Uh, Uu, Urb^Edb, Urb^Edb, Uu, Cud, Kud, Urb^Edt, Urb^Edt, Uh, Uu, Cud, Urb^Edt, Urb, Xos, Xu, Xu, Xu, Xu, Xu, Qxu, Qxu, Uh, Uh, Urb^Edt, Urb^Edt, Uu, Uh, Xuc, Xuc, Xuc, Qxu, Qxu, Xu, Xu, Xu, Xu, Xu
Uu, Xos, Wwg, Wog, Wwg, Xu, Xos, Xos, Xos, Xos, Xuc, Uh, Uu^Ii, Qxu, Urb, Urb^Edt, Cud, Urb^Edt, Urb, Urb, Urb, Uu, Urb, Uu, Urb^Edb, Urb^Edb, Urb, Cud, Urb^Edt, Urb^Edt, Urb, Uh^Ii, Uu, Xos, Urb, Urb, Xos, Xu, Xu, Xu, Xuc, Xu, Uu, Uu^Uf, Uu, Cud, 4 Kud, Cud, Cud, Uh, Uh, Uh, Xuc, Xu, Xu, Xu, Xu, Xu, Xu, Xu
Ur^Br\, Uu, Uu, Wwg, Xos, Xos, Xos, Xos, Cud, Xu, Uh, Cud, Cud, Urb, Qxu, Uu, Uh, Kud, Cud, Urb, Urb, Urb, Urb, Urb, Urb^Ii, Urb^Ii, Urb, Urb^Edt, Urb, Urb, Uh, Uu, Xos^Efs, Xos^Efs, Urb, Urb, Xu, Xu, Xu, Xuc, Cud, Cud, Urb, Uu, Urb, Cud, Cud, Cud, Uu, Uu, Uu, Xu, Xu, Xu, Xu, Xu, Xu, Xu, Xu, Xu
Uu, Ur^Br\, Ur^Br\, Uu, Uu, Xos, Xos, Xos, Uu, Uu, Ur^Br/, Ur^Br/, Uu, Cud, Qxu, Uu^Ii, Uh, Uh, Uh, Uu, Uu, Urb, Qxu^&A, Urb, Uh, Uu^Ufi, Uu^Uf, Urb, Uu, Uu^Uf, Xos^Efs, Xos, Urb, Urb, Urb, Urb, Xos, Xu, Xuc, Xuc, Uu^Edt, Urb^Edt, Urb, Urb, Uu, Uu, Uu, Uu, Uu, Uu^Vud, Qxu, Xu, Xu, Xu, Xu, Xu, Xu, Xu, Xu, Xu
Xos, Uu, Cud, Ur^Br\, Ur^Br\, Uu, Uu, Uu^Pr\, Ur^Pr\, Ur^Br/, Uu, Cud, Xu, Xos, Qxu, Qxu^&A, Qxu, Uu, Xu, Qxu, Qxu, Uh, Uh, Uu, Uu, Uu^Uf, Uh, Uh, Xos, Xos^Efs, Urb, Urb, Urb, Urb, Xos, Xu, Xu, Xos, Uu, Uu^Vu, Uu, Uu, Cud, Uu, Uh, Uu^Vu, Qxu, Uu, Uu^Ii, Uh, Qxu, Qxu, Qxu, Qxu, Qxu, Xu, Xu, Xu, Xu, Xu
Xos, Xos, Xos, Uu, Uu, Ur^Br\, Ur^Br/, Ur^Br/, Uu, Uu^Pr\, Xos, Xu, Xu, Xu, Xu, Qxu, Xu, Xu, Xu, Xu, Qxu^&A, Uh, Xu, Uu, Uu, Uu^Uf, Xos^Efs, Xos^Efs, Urb, Urb, Urb, Urb, Xos, Xu, Xu, Xos, Uh, Uh, Urb, Urb, Uu^Uf, Uh, Xu, Xu, Uh, Uh, Xu, Qxu, Qxu, Qxu, Xu, Qxu, Qxu, Qxu, Xu, Xu, Xu, Xu, Xu, Xu
Xos, Xos, Uu, Uu, Ur^Br/, Ur^Br/, Cud, Uu, Xos, Xos, Xos, Xos, Xos, Xos, Xu, Xu, Xu, Xu, Xu, Qxu, Xu, Xu, Xu, Xu, Xu, Xos, Urb^Xo, Urb, Urb, Urb, Xos, Xu, Xu, Xos, Urb, Urb, Uh, Uu, Urb, Uu, Uh, Xu, Xos, Xu, Xu, Xu, Xu, Qxu, Qxu, Xu, Xu, Xu, Qxu, Qxu, Xu, Xu, Xu, Xu, Xu, Xu
Uu, Uu, Ur^Br/, Ur^Br/, Uu, Uu, Xos, Xos, Xos, Xos, Xu, Xu, Xu, Xu, Xu, Xu, Xu, Xu, Xu, Xu, Xu, Xu, Xu, Xos, Xos, Xu, Xu, Urb^Xo, Xos, Xu, Xu, Xos, Urb, Uh, Uu^Vud, Urb, Ur^Edt, Uu, Xu, Xu, Xos, Xos, Xos, Xos, Xos, Xu, Qxu, Xu, Xu, Xu, Qxu, Xu, Qxu, Xu, Xu, Xu, Xu, Xu, Xu, Xu
Ur^Br/, Ur^Br/, Cud, Uu, Xos, Wwrg, Wwg, Xos, Yhl^Xp, Xu, Xu, Xu, Xu, Xu, Xu, Xu, Xu, Xu, Xu, Xu, Xu, Xos, Wwg, Xos, Uu^Uf, Xos, Xos, Xos, Xu, Xos, Uu^Uf, Uh, Urb^Edt, Xu, Ur, Ur^Edt, Uu^Edt, Cud, Xos, Xu, Xos, Xos, Xos, Xos, Qxu, Qxu, Qxu, Xu, Xu, Qxu, Qxu, Xu, Xu, Xu, Xu, Xu, Xu, Xu, Wwb, Wwb
Uu, Uu, Xos, Xos, Xos, Wwg, Wog, Wog, Yhl, Yhl^Xp, Xu, Xu, Xu, Xu, Xu, Xu, Xu, Xu, Xos, Xu, Xos, Xos, Wog, Uu^Uf, Uu^Ii, Urb, Uu, Uh, Xu, Xu, Uu, Uu^Uf, Uu^Edt, Urb^Edt, Ur, Ur^Edt, Uu^Uf, Xos, Xos, Xos, Xos^Efs, Xos, Qxu, Qxu, Cud, Xu, Qxu, Xu, Qxu, Xu, Qxu, Xu, Xu, Xu, Wwb, Wwb, Wwb, Wwb^Pr\, Xu, Xu
Xos, Xos, Xos, Xos, Wwg, Wog, Wog, Yhl^Xp, Yhl, Yhl, Yhl^Xp, Xu, Xu, Xu, Xu, Xu, Xu, Xu, Xu, Xos, Xu, Wog^Xo, Wwg, Wwrg, Uh, Uu^Uf, Urb^Edb, Uu^Uf, Xos, Xos, Uu, Uu, Cud, Cud, Uu, Uu, Uu, Xos, Xos, Xos^Efs, Uh, Qxu, Qxu, Qxu, Qxu, Cud, Qxu, Qxu, Xu, Qxu, Xu, Xu, Yhr, Yhr, Wwb, Wwb, Xu, Xu, Xu, Xu
Xos, Xos, Xu, Xu, Wwg, Wog, Yhl, Yhl^Xp, Yhl^Xp, Xu, Xu, Yhl^Pr/, Yhl, Xu, Xu, Xu, Xu, Xu, Xu, Xu, Wog^Xo, Wog^Xo, Wwg, Uh, Wwrg, Uu^Edb, Urb^Edb, Urb^Edb, Uu, Uu^Vu, Uu, Uu, Xu, Xu, Uu, Urb, Urb^Pr/, Uu^Pr/, Uu, Uh, Qxu, Qxu, Qxu, Qxu, Qxu, Xu, Qxu, Xu, Qxu, Qxu, Qxu, Qxu, Yhr, Yhr^Xp, Xu, Xu, Xos, Xu, Xu, Xu
Xu, Xu, Xu, Xu, Xu, Xu, Yhl, Xu, Xu, Yhl^Pr/, Yhl, Xu, Xu, Yhl, Xu, Xu, Xu, Xu, Xu, Xu, Xu, Xu, Xos, Wwg, Wwg, Uu^Uf, Uu^Uf, Uu, Uh, Uu, Xu, Uu, Xu, Xu, Xos, Uu^Pr/, Uu, Urb, Urb, Uh, Uu, Qxu, Qxu, Qxu, Qxu, Qxu, Qxu, Xu, Xu, Xu, Yhr, Yhr, Yhr, Yhr^Xp, Xos, Xos, Xos, Xos, Xos, Xu
Xu, Xu, Xu, Xu, Xu, Yhl, Yhl^Xp, Xu, Xu, Xu, Xu, Yhl, Xu, Xu, Xu, Xu, Xu, Xu, Xu, Xu, Xu, Xos, Wog^Xo, Wog, Wwg, Wwrg, Wwrg, Wwrg, Wwg, Xos, Xos, Xu, Xos, Xos, Xos^Efs, Xos^Efs, Uh, Uu^Uf, Uu, Urb, Ur, Uh, Uh, Qxu, Qxu, Qxu, Qxu, Cud, Xu, Xu, Yhr, Yhr^Xp, Yhr, Yhr, Xos, Yhl, Xos, Xos, Xos, Xos
Xu, Xu, Xu, Xu, Xu, Xu, Xu, Yhl^Pr/, Yhl, Xu, Xu, Xu, Xu, Xu, Xu, Xu, Xu, Xu, Xu, Xu, Xu, Xu, Wog^Xo, Wog, Wog, Wog, Xos, Wog, Wog^Xo, Wog^Xo, Xos, Xos, Xos, Xos, Qxu, Qxu, Qxu, Qxu, Qxu, Cud, Uu, Urb, Urb, Cud, Uu, Qxu, Qxu, Xuc, Xuc, Xu, Xos, Yhr, Yhr^Pr/, Yhr^Pr/, Yhl, Yhl^Xp, Xos, Yhl^Xp, Xos, Xos
Xu, Xu, Xu, Xu, Xu, Xu, Xu, Xu, Xu, Yhl, Xu, Xu, Xu, Xu, Xu, Xu, Xu, Xu, Xu, Xu, Xu, Wog, Wog, Wog^Xo, Xos, Xos, Xu, Wog^Xo, Xos, Wog^Xo, Xos, Xos, Xos, Xos, Xu, Qxu, Uh, Uu^Uf, Qxu, Qxu, Qxu, Uh, Uu^Vu, Urb, Ur, Uu^Vu, Uu, Uu^Ii, Xuc, Xu, Xu, Xos, Xos, Yhl, Yhl, Yhl, Yhl, Yhl, Xos, Xos
Xu, Xu, Xu, Xu, Xu, Xu, Xu, Xu, Xu, Xu, Xu, Xu, Xu, Xu, Xu, Xu, Xu, Xu, Xu, Xu, Xu, Xu, Xu, Xu, Xos, Xos, Xu, Xu, Xos, Xos, Xos, Xos, Xos, Xu, Xu, Qxu, Cud, Uh, Qxu, Qxu, Qxu, Qxu, Qxu, Uu, Uh, Urb, Urb, Uh, Uh, Xu, Xuc, Xu, Xu, Xos, Xos, Yhl^Xp, Yhl^Xp, Yhl, Yhl, Xos
Xu, Xu, Xu, Xu, Xu, Xu, Xu, Xu, Xu, Xu, Xu, Xu, Xu, Xu, Xu, Xu, Xu, Xu, Xu, Xu, Xu, Xu, Xu, Xu, Xu, Xu, Xu, Xu, Xos, Xos, Xos, Xos, Xos, Xu, Qxu, Qxu, Qxu, Qxu, Qxu, Qxu, Qxu, Qxu, Xu, Qxu, Xos, Uh, Uu, Urb, Urb, Uu, Xos, Xos, Xu, Xu, Xu, Xos, Xos, Yhl, Yhl, Yhl
Xu, Xu, Xu, Xu, Xu, Xu, Xu, Xu, Xu, Xu, Xu, Xu, Xu, Xu, Xu, Xu, Xu, Xu, Xu, Xu, Xu, Xu, Xu, Xu, Xu, Xu, Xu, Xu, Xos, Xos, Xos, Xos, Xos, Yhr^Xp, Qxu, Qxu, Qxu, Qxu, Xu, Cud, Qxu, Qxu, Xu, Xu, Xos, Xos, Cud, Uu, Urb, Uu, Xos^Efs, Xos, Xos, Xu, Xu, Xu, Xu, Xos, Xos, Yhl
Xu, Xu, Xu, Xu, Xu, Xu, Xu, Xu, Xu, Xu, Xu, Xu, Xu, Xu, Xu, Xu, Xu, Xu, Xu, Xu, Xu, Xu, Xu, Xu, Xu, Xu, Xu, Xu, Xos, Xos, Xu, Xos, Xos, Yhr^Xp, Xu, Qxu, Qxu, Qxu, Cud, Cud, Qxu, Qxu, Xu, Xu, Xos, Xos, Uh, Uu, Urb, Uu, Cud, Xos^Efs, Xos, Xu, Xu, Xu, Xu, Xu, Xu, Xos
Xu, Xu, Xu, Xu, Xu, Xu, Xu, Xu, Xu, Xu, Xu, Xu, Xu, Xu, Xu, Xu, Xu, Xu, Xu, Xu, Xu, Xu, Xu, Xu, Xu, Xu, Xu, Xu, Xu, Xu, Xu, Xos, Xos, Xos, Xu, Xu, Qxu, Qxu, Xu, Xu, Xu, Xu, Xos, Xos, Xos^Efs, Xos^Efs, Uu^Uf, Uu^Vud, Urb, Uu^Uf, Xos, Xos, Xos, Xu, Xu, Xu, Xu, Xu, Xu, Xu
Xu, Xu, Xu, Xu, Xu, Xu, Xu, Xu, Xu, Xu, Xu, Xu, Xu, Xu, Xu, Xu, Xu, Xu, Xu, Xu, Xu, Xu, Xu, Xu, Xu, Xu, Xu, Xu, Xu, Xu, Xu, Xu, Xu, Xos, Xu, Yhr^Xp, Xu, Xu, Xuc, Xuc, Xu, Xos, Xu, Xu, Xos, Uh, Uu^Uf, Urb, Ur, Uu, Xos^Efs, Xos, Xos, Xu, Xu, Xu, Xu, Xu, Xu, Xu
Xu, Xu, Xu, Xu, Xu, Xu, Xu, Xu, Xu, Xu, Xu, Xu, Xu, Xu, Xu, Xu, Xu, Xu, Xu, Xu, Xu, Xu, Xu, Xu, Xu, Xu, Xu, Xu, Xu, Xu, Xu, Xu, Xu, Xu, Yhr, Yhr^Pr\, Xu, Xuc, Uh, Cud, Uh, Uh, Xu, Xuc, Xos^Efs, Uu^Uf, Ur^Es, Urb, Ur, Uh, Uh, Xos^Efs, Xos, Xos, Xu, Xu, Xu, Xu, Xu, Xu
Xu, Xu, Xu, Xu, Xu, Xu, Xu, Xu, Xu, Xu, Xu, Xu, Xu, Xu, Xu, Xu, Xu, Xu, Xu, Xu, Xu, Xu, Xu, Xu, Xu, Xu, Xu, Xu, Xu, Xu, Xu, Xu, Xu, Xu, Xu, Xu, Wwrg, Xu, Uh, Uh, Ur, Uh, Xu, Uh, Uh, Uu^Ii, Ur, Ur^Es, Cud, Uu, Uu, Urb, Xos, Xos, Xu, Xu, Xu, Xu, Xu, Xu
Xu, Xu, Xu, Xu, Xu, Xu, Xu, Xu, Xu, Xu, Xu, Xu, Xu, Xu, Xu, Xu, Xu, Xu, Xu, Xu, Xu, Xu, Xu, Xu, Xu, Xu, Xu, Xu, Xu, Xu, Xu, Xu, Xos, Xos, Xu, Wog, Wwg, Uh, Uu^Vu, Ur, Ur^Es, Uu^Vu, Ur, Ur, Xos, Uu, Uu, Cud, 1 Kud, Cud, Urb, Urb, Xos, Xos, Xu, Xu, Xu, Xu, Xu, Xu
Xu, Xu, Xu, Xu, Xu, Xu, Xu, Xu, Xu, Xu, Xu, Xu, Xu, Xu, Xu, Xu, Xu, Xu, Xu, Xu, Xu, Xu, Xu, Xu, Xu, Xu, Xu, Xu, Xu, Xu, Xos, Xos, Xos^Efs, Xos, Xu, Wwg, Xu, Cud, Ur^Es, Ur, Uh, Ur, Uh, Uu, Xos, Uh, Uu, Cud, Cud, Cud, Uu^Vud, Uu, Xos^Efs, Xos, Xos, Xu, Xu, Xu, Xu, Xu
Xu, Xu, Xu, Xu, Xu, Xu, Xu, Xu, Xu, Xu, Xu, Xu, Xu, Xu, Xu, Xu, Xu, Xu, Xu, Xu, Xu, Xu, Xu, Xu, Xu, Xu, Xu, Xu, Xos, Xos, Xos, Xos^Efs, Uh, Uh, Xuc, Xuc, Ur^Es, Ur, Ur^Br/, Uh, Wwg, Xu, Xu, Xu, Xos, Xos, Xos, Uu, Uu, Urb, Urb, Uu, Urb, Xos^Efs, Xos^Xzm\, Xos, Xos, Xu, Xu, Xu
Xu, Xu, Xu, Xu, Xu, Xu, Xu, Xu, Xu, Xu, Xu, Xu, Xu, Xu, Xu, Xu, Xu, Xu, Xu, Xu, Xu, Xu, Xu, Xu, Xu, Xu, Xu, Xu, Xu, Xos, Xu, Uu, Uu, Uh, Uu^Eff, Ur, Ur^Br/, Ur^Br/, Cud, Uh, Xuc, Xu, Xu, Xu, Xos, Xos, Xos, Uu^Uf, Uu^Uf, Uu, Uu, Uu^Vu, Urb, Uu, Uu^Uf, Xos^Xzm\, Xos, Xos, Xu, Xu
Xu, Xu, Xu, Xu, Xu, Xu, Xu, Xu, Xu, Xu, Xu, Xu, Xu, Xu, Xu, Xu, Xu, Xu, Xu, Xu, Xu, Xu, Xu, Xu, Xu, Xu, Xu, Xu, Xu, Xu, Xu, Uh, Uu^Eff, Uu^Eff, Ur^Br/, Ur^Br/, Uu^Eff, Cud, Uh, Uh, Uu, Xuc, Xos, Xos, Xos, Xos, Xos, Xos, Xos, Uu, Uh, Urb, Urb, Uu^Ii, Uu, Xos^Efs, Xos^Efs, Xos, Xos, Xu
Xu, Xu, Xu, Xu, Xu, Xu, Xu, Xu, Xu, Xu, Xu, Xu, Xu, Xu, Xu, Xu, Xu, Xu, Xu, Xu, Xu, Xu, Xu, Xu, Xu, Xu, Xu, Xu, Xu, Xu, Uu^Eff, Uu^Eff, Ur^Br/, Ur^Br/, Uu, Uu^Eff, Xu^Eff, Uh, Xu, Xu, Xos, Xos, Xos, Xos, Xu, Xu, Xu, Xos, Xos, Xos, Uu, Uu, Uu, Urb, Urb, Uu, Uu, Xos, Xos, Xos
