Xu, Xu, Xu, Xu, Xu, Xu, Xu, Xu, Xu, Xu, Xu, Xu, Xu, Xu, Xu, Xu, Xu, Xu, Xu, Xu, Xu, Xu, Xu, Xu, Xu, Xu, Xu, Xu, Xu, Xu, Xu, Xu, Xu, Xu, Xu, Xu, Xu, Xu, Xu, Xu, Xu, Xu, Xu, Xu, Xu, Xu, Xu, Xu, Xu, Xu, Xu, Xu, Xu, Xu, Xu, Xu, Xu, Xu, Xu, Xu
Xu, Xu, Xu, Xu, Xu, Xu, Xu, Xu, Xu, Xu, Xu, Xu, Xu, Xu, Xu, Xu, Xu, Xu, Xu, Xu, Xu, Xu, Xu, Xu, Xu, Xu, Xu, Xu, Xu, Xu, Xu, Xu, Xu, Xu, Xu, Xu, Xu, Xu, Xu, Xu, Xu, Xu, Xu, Xu, Xu, Xu, Xu, Xu, Xu, Xu, Xu, Xu, Xu, Xu, Xu, Xu, Xu, Xu, Xu, Xu
Xu, Xu, Xu, Xu, Xu, Xu, Xu, Xu, Xu, Xu, Xu, Xu, Xu, Xu, Xu, Xu, Xu, Xu, Xu, Xu, Xu, Xu, Xu, Xu, Xu, Xu, Xu, Xu, Xu, Xu, Xu, Xu, Xu, Xu, Xu, Xu, Xu, Xu, Xu, Xu, Xu, Xu, Xu, Xu, Xu, Xu, Xu, Xu, Xu, Xu, Xu, Xu, Xu, Xu, Xu, Xu, Xu, Xu, Xu, Xu
Xu, Xu, Xu, Xu, Xu, Xu, Xu, Xu, Xu, Xu, Xu, Xu, Xu, Xu, Xu, Xu, Xu, Xu, Xu, Xu, Xu, Xu, Xu, Xu, Xu, Xu, Xu, Xu, Xu, Xu, Xu, Xu, Xu, Xu, Xu, Xu, Xu, Xu, Xu, Xu, Xu, Xu, Xu, Xu, Xu, Xu, Xu, Xu, Xu, Xu, Xu, Xu, Xu, Xu, Xu, Xu, Xu, Xu, Xu, Xu
Xu, Xu, Xu, Xu, Xu, Xu, Xu, Xu, Xu, Xu, Xu, Xu, Xu, Xu, Xu, Xu, Xu, Xu, Xu, Xu, Xu, Xu, Xu, Xu, Xu, Xu, Xu, Xu, Xu, Xu, Xu, Xu, Xu, Xu, Xu, Xu, Xu, Xu, Xu, Xu, Xu, Xu, Xu, Xu, Xu, Xu, Xu, Xu, Xu, Xu, Xu, Xu, Xu, Xu, Xu, Xu, Xu, Xu, Xu, Xu
Xu, Xu, Xu, Xu, Xu, Xu, Xu, Xu, Xu, Xu, Xu, Xu, Xu, Xu, Xu, Xu, Xu, Xu, Xu, Xu, Xu, Xu, Xu, Xu, Xu, Xu, Xu, Xu, Xu, Xu, Xu, Xu, Xu, Xu, Xu, Xu, Xu, Xu, Xu, Xu, Xu, Xu, Xu, Xu, Xu, Xu, Xu, Xu, Xu, Xu, Xu, Xu, Xu, Xu, Xu, Xu, Xu, Xu, Xu, Xu
Xu, Xu, Xu, Xu, Xu, Xu, Xu, Xu, Xu, Xu, Xu, Xu, Xu, Xu, Xu, Xu, Xu, Xu, Xu, Xu, Xu, Xu, Xu, Xu, Xu, Xu, Xu, Xu, Xu, Xu, Xu, Xu, Xu, Xu, Xu, Xu, Xu, Xu, Xu, Xu, Xu, Xu, Xu, Xu, Xu, Xu, Xu, Xu, Xu, Xu, Xu, Xu, Xu, Xu, Xu, Xu, Xu, Xu, Xu, Xu
Xu, Xu, Xu, Xu, Xu, Xu, Xu, Xu, Xu, Xu, Xu, Xu, Xu, Xu, Xu, Xu, Xu, Xu, Xu, Xu, Xu, Xu, Xu, Xu, Xu, Xu, Xu, Xu, Xu, Xu, Xu, Xu, Xu, Xu, Xu, Xu, Xu, Xu, Xu, Xu, Xu, Xu, Xu, Xu, Xu, Xu, Xu, Xu, Xu, Xu, Xu, Xu, Xu, Xu, Xu, Xu, Xu, Xu, Xu, Xu
Xu, Xu, Xu, Xu, Xu, Xu, Xu, Xu, Xu, Xu, Xu, Xu, Xu, Xu, Xu, Xu, Xu, Xu, Xu, Xu, Xu, Xu, Xu, Xu, Xu, Xu, Xu, Xu, Xu, Xu, Xu, Xu, Xu, Xu, Xu, Xu, Xu, Xu, Xu, Xu, Xu, Xu, Xu, Xu, Xu, Xu, Xu, Xu, Xu, Xu, Xu, Xu, Xu, Xu, Xu, Xu, Xu, Xu, Xu, Xu
Xu, Xu, Xu, Xu, Xu, Xu, Xu, Xu, Xu, Xu, Xu, Xu, Xu, Xu, Xu, Xu, Xu, Xu, Xu, Xu, Xu, Xu, Xu, Qxu, Qxu, Xu, Xu, Xu, Xos, Xu, Xu, Xu, Xu, Xu, Xu, Xu, Xu, Xu, Xu, Xu, Xu, Xu, Xu, Xu, Xu, Xu, Xu, Xu, Xu, Xu, Xu, Xu, Xu, Xu, Xu, Xu, Xu, Xu, Xu, Xu
Xu, Xu, Xu, Xu, Xu, Xu, Xu, Xu, Xu, Xu, Xu, Xu, Xu, Xu, Xu, Xu, Xu, Xu, Xu, Xu, Xu, Xu, Xu, Qxu, Qxu, Xu, Xu, Xu, Xos, Xu, Qxu, Xu, Qxu, Xu, Xu, Xu, Xu, Xu, Xu, Xu, Xu, Xu, Xu, Xu, Xu, Xu, Xu, Xu, Xu, Xu, Qxu, Xu, Xu, Xu, Xu, Xu, Xu, Xu, Xu, Xu
Xu, Xu, Xu, Xu, Xu, Xu, Xu, Xu, Xu, Xu, Xu, Xu, Xu, Xu, Xu, Xu, Qxu, Xu, Xu, Qxu, Xu, Xu, Qxu, Qxu, Uh, Xu, Xu, Xos, Xol, Xos, Xu, Qxu, Xu, Qxu, Xu, Xu, Xu, Xu, Xu, Xu, Xu, Xu, Xu, Xu, Xu, Xu, Xu, Xu, Xu, Xu, Qxu, Qxu, Xu, Xu, Xu, Xu, Xu, Xu, Xu, Xu
Xu, Xu, Xu, Xu, Xu, Xu, Xu, Xu, Xu, Xu, Xu, Xu, Xu, Xu, Xu, Xu, Qxu, Qxu, Qxu, Qxu, Qxu, Qxu, Qxu, Uh, Uu, Xu, Xos^Xzm/, Xol, Uh, Xu, Xu, Qxu, Qxu, Xu, Xu, Xu, Xu, Xu, Xu, Xu, Xu, Xu, Xu, Xu, Xu, Xu, Qxu, Qxu, Xu, Xu, Qxu, Qxu, Xu, Xu, Xu, Xu, Xu, Xu, Xu, Xu
Xu, Xu, Xu, Xu, Xu, Xu, Xu, Xu, Xu, Xu, Xu, Xu, Xu, Xu, Xu, Xu, Xu, Qxu, Xu, Qxu, Qxu, Qxu, Kud, Cud, Urb, Uu^Em, Uu^Em, Uu^Uf, Uh^Ii, Uh, Qxu, Xu, Qxu, Xu, Xu, Xu, Xu, Xu, Xu, Xu, Xu, Xu, Xu, Xu, Xu, Qxu, Xu, Qxu, Qxu, Qxu, Xuc, Xu, Qxu, Qxu, Qxu, Qxu, Qxu, Xu, Xu, Xu
Xu, Xu, Xu, Xu, Xu, Xu, Xu, Xu, Xu, Xu, Xu, Xu, Qxu, Xu, Qxu, Xu, Qxu, Qxu, Xu, Xos, Uh^Ii, Cud, Urb, Urb, Urb, Urb, Urb, Uu^Uf, Uu^Uf, Uu, Qxu, Qxu, Xu, Xu, Xol, Xu, Xu, Xu, Xu, Xu, Xu, Xu, Xu, Xu, Xu, Xu, Uh, Qxu, Xuc, Xuc, Xu, Xu, Uh, Qxu, Uh, Xuc, Qxu, Qxu, Xu, Xu
Xu, Xu, Xu, Xu, Xu, Xu, Xu, Xu, Xu, Xu, Xu, Xu, Xu, Qxu, Qxu, Xu, Qxu, Xu, Xos^Efs, Xos, Uh, Urb, Urb^Em, Urb, Xuc, Urb, Urb, Urb^Em, Urb, Uu, Uu^Vud, Qxu, Xu, Xu, Xu, Xol, Xol, Xol, Xu, Xu, Xu, Xu, Xu, Uh, Xu, Uh, Qxu, Qxu, Qxu, Qxu, Xuc, Uh, Uu^Uf, Uu^Uf, Qxu, Uh, Qxu, Xu, Xu, Xu
Xu, Xu, Xu, Xu, Xu, Xu, Xu, Xu, Xu, Xu, Xu, Xu, Xu, Xu, Qxu, Qxu, Qxu, Qxu, Urb, Urb, Urb, Urb, Rb^Uf, Qxu, Qxu, Uu^Ii, Uu^Uf, Urb^Em, Urb, Urb, Urb, Uu^Uf, Uu, Qxu, Qxu, Qxu, Xu, Xol, Xu, Xu, Xu, Xu, Uu, Uh, Uu^Uf, Uu^Uf, Uu^Vu, Qxu, Cud, Qxu, Qxu, Qxu, Uu^Uf, Uu^Uf, Uu, Qxu, Uh, Xu, Xu, Xu
Xu, Xu, Xu, Xu, Xu, Xu, Xu, Xu, Xu, Xu, Xu, Xu, Xuc, Xuc, Xu, Xu, Qxu, Qxu, Urb, Urb, Xuc, Uu^Em, Uu^Dr, Uu^Es, Qxu, Qxu, Uu^Es, Uu, Xuc, Urb, Urb, Urb, Urb, Qxu, Qxu, Qxu, Xu, Xu, Xu, Xu, Xos, Xos, Uu, Uh, Uu^Uf, Uu^Uf, Uu, Uu, Cud, Cud, Uu, Uu^Vud, Urb, Uu^Ii, Uu, Uh, Uh, Qxu, Qxu, Xu
Xu, Xu, Xu, Xu, Xu, Xu, Yhr, Xu, Xu, Xu, Xu, Xu, Xu, Uu, Qxu, Qxu, Qxu, Uu^Vud, Urb, Urb, Uu, Qxu, Qxu, Qxu, Xu, Qxu, Qxu, Uh, Qxu, Uh, Uh, Urb, Urb, Cud, Uu, Uu, Uu, Qxu, Xu, Xu, Xu, Xu, Uu, Uu^Ii, Urb, Urb, Urb, Urb, Uu, 5 Kud, Cud, Urb, Uu, Uu, Uu^Uf, Uu^Uf, Qxu, Qxu, Xu, Xu
Xu, Xu, Xu, Xu, Yhr^Pr\, Yhr, Xu, Xu, Xu, Xu, Xu, Xu, Xu, Uu, Uu^Ii, Xu, Rb, Rb^Uf, Urb, Urb^Ii, Uu^Es, Qxu, Qxu, Xu, 2 Xu, Xu, Qxu, Qxu, Uu^Es, Uu, Uu^Uf, Urb, Urb, Kud, Uh, Qxu, Uh, Xu, Cud, Xu, Xos, Xos, Urb, Urb, Urb, Urb, Urb, Uu^Vud, Qxu, Cud, Qxu, Uu, Uh, Uh, Uh, Qxu, Qxu, Xu, Xu, Xu
Xu, Xu, Xu, Yhr, Yhr^Xp, Xu, Xu, Xu, Xu, Xu, Xuc, Xu, Qxu, Uu, Uh, Uu, Urb, Urb, Urb^Ii, Urb^Ii, Qxu, Qxu, Qxu, Xu, Xu, Xu, Qxu, Qxu, Uh, Uh, Uu^Em, Urb^Em, Urb, Cud, Uu^Ii, Uh, Uu^Vud, Uu, Urb, Uh, Xu, Xu, Urb, Urb, Uh, Uu, Uu^Uf, Urb, Qxu, Qxu, Qxu, Qxu, Qxu, Uh, Xu, Xu, Qxu, Qxu, Xu, Xu
Xu, Xu, Yhr^Xp, Yhr^Xp, Xu, Xu, Xu, Xu, Xu, Xuc, Qxu, Qxu, Qxu, Uu, Uu^Vud, Qxu, Urb, Urb, Uh, Uh, Xuc, Qxu, Re^Dr, Qxu, Qxu, Qxu, Qxu, Qxu, Xuc, Uh, Urb, Urb, Urb, Urb, Urb^Ii, Urb, Urb, Urb, Urb, Urb, Xos, Xos, Uu, Uu^Uf, Uh, Uh, Uu, Uu, Uu^Uf, Qxu, Qxu, Qxu, Qxu, Qxu, Xu, Xu, Xu, Qxu, Xu, Xu
Xu, Xu, Xu, Yhr, Xu, Xu, Xu, Xos, Xos, Xuc, Qxu, Qxu, Qxu, Uu, Qxu, Qxu, Urb, Urb, Uu^Vud, Uu, Re, Uu^Es, Uu, Qxu, Urb^Es, Urb^Es, Qxu, Qxu, Uh, Urb, Urb, Urb, Uh, Urb, Urb, Urb, Uu, Urb, Uu^Uf, Urb, Xu, Xu, Uh, Qxu, Qxu, Qxu, Uu^Vu, Urb, Uu^Uf, Uu^Uf, Qxu, Xu, Qxu, Xu, Qxu, Qxu, Qxu, Qxu, Xu, Xu
Xos, Xu, Yhr^Xp, Yhr^Xp, Xu, Xu, Xu, Xos, Xos, Xos, Xu, Xu, Qxu, Qxu, Uu^Uf, Uu^Uf, Urb, Urb, Uu^Uf, Rb^Uf, Rb, Uu, Uh, Qxu, Xuc, Urb, Uu^Ii, Uu, Cud, Urb, Urb, Uu^Vud, Uh, Uu^Uf, Urb, Urb, Cud, Uu, Xu, Uu, Xos, Xos, Qxu, Qxu, Qxu, Uh, Urb, Urb, Uu^Uf, Xu, Xu, Xu, Xu, Qxu, Qxu, Qxu, Xu, Xu, Xu, Xu
Xos, Xos, Xos, Wog, Wog, Xu, Xu, Xu, Xos, Xos, Xuc, Xuc, Uh^Ii, Qxu, Uu^Uf, Uu^Ufi, Urb, Urb, Urb^Em, Re^Uf, Uu^Vud, Uh, Uh, Uu, Urb, Urb, Uu, Cud, Kud, Urb, Urb, Uh, Uu, Cud, Urb, Urb, Xos, Xu, Xu, Xu, Xu, Xu, Qxu, Qxu, Uh, Uh, Urb, Urb, Uu, Uh, Xuc, Xuc, Xuc, Qxu, Qxu, Xu, Xu, Xu, Xu, Xu
Uu, Xos, Wwg, Wog, Wwg, Xu, Xos, Xos, Xos, Xos, Xuc, Uh, Uu^Ii, Qxu, Urb, Urb, Cud, Urb, Urb, Urb, Urb, Uu, Urb, Uu, Urb, Urb, Urb, Cud, Urb, Urb, Urb, Uh^Ii, Uu, Xos, Urb, Urb, Xos, Xu, Xu, Xu, Xuc, Xu, Uu, Uu^Uf, Uu, Cud, 4 Kud, Cud, Cud, Uh, Uh, Uh, Xuc, Xu, Xu, Xu, Xu, Xu, Xu, Xu
Ur^Br\, Uu, Uu, Wwg, Xos, Xos, Xos, Xos, Cud, Xu, Uh, Cud, Cud, Urb, Qxu, Uu, Uh, Kud, Cud, Urb, Urb, Urb, Urb, Urb, Urb^Ii, Urb^Ii, Urb, Urb, Urb, Urb, Uu, Uu, Xos^Efs, Xos^Efs, Urb, Urb, Xu, Xu, Xu, Xuc, Cud, Cud, Urb, Uu, Urb, Cud, Cud, Cud, Uu, Uu, Uu, Xu, Xu, Xu, Xu, Xu, Xu, Xu, Xu, Xu
Uu, Ur^Br\, Ur^Br\, Uu, Uu, Xos, Xos, Xos, Uu, Uu, Ur^Br/, Ur^Br/, Uu, Cud, Qxu, Uu^Ii, Uh, Uh, Uh, Uu, Uu, Urb, Qxu, Urb, Uh, Uu^Ufi, Uu^Uf, Urb, Uu, Uu, Xos^Efs, Xos, Urb, Urb, Urb, Urb, Xos, Xu, Xuc, Xuc, Uu, Urb, Urb, Urb, Uu, Uu, Uu, Uu, Uu, Uu^Vud, Qxu, Xu, Xu, Xu, Xu, Xu, Xu, Xu, Xu, Xu
Xos, Uu, Cud, Ur^Br\, Ur^Br\, Uu, Uu, Uu^Pr\, Ur^Pr\, Ur^Br/, Uu, Cud, Xu, Xos, Qxu, Qxu, Qxu, Uu, Xu, Qxu, Qxu, Uh, Uh, Uu, Uu, Uu^Uf, Uh, Uh, Xos, Xos^Efs, Urb, Urb, Urb, Urb, Xos, Xu, Xu, Xos, Uu, Uu^Vu, Uu, Uu, Cud, Uu, Uh, Uu^Vu, Qxu, Uu, Uu^Ii, Uh, Qxu, Qxu, Qxu, Qxu, Qxu, Xu, Xu, Xu, Xu, Xu
Xos, Xos, Xos, Uu, Uu, Ur^Br\, Ur^Br/, Ur^Br/, Uu, Uu^Pr\, Xos, Xu, Xu, Xos, Xu, Qxu, Xu, Xu, Xu, Xu, Qxu, Uh, Xu, Uu, Uu, Uu^Uf, Xos^Efs, Xos^Efs, Urb, Urb, Urb, Urb, Xos, Xu, Xu, Xos, Uh, Uh, Urb, Urb, Uu^Uf, Uh, Xu, Xu, Uh, Uh, Xu, Qxu, Qxu, Qxu, Xu, Qxu, Qxu, Qxu, Xu, Xu, Xu, Xu, Xu, Xu
Xos, Xos, Uu, Uu, Ur^Br/, Ur^Br/, Cud, Uu, Xos, Xos, Xos, Xos, Xos, Xos, Xu, Xu, Xu, Xu, Xu, Qxu, Xu, Xu, Xu, Xu, Xu, Xos, Urb^Xo, Urb, Urb, Urb, Xos, Xu, Xu, Xos, Urb, Urb, Uh, Uu, Urb, Uu, Uh, Xu, Xos, Xu, Xu, Xu, Xu, Qxu, Qxu, Xu, Xu, Xu, Qxu, Qxu, Xu, Xu, Xu, Xu, Xu, Xu
Uu, Uu, Ur^Br/, Ur^Br/, Uu, Uu, Xos, Xos, Xos, Xos, Xu, Xu, Xu, Xu, Xu, Xu, Xu, Xu, Xu, Xu, Xu, Xu, Xu, Xos, Xos, Xu, Xu, Urb^Xo, Xos, Xu, Xu, Xos, Urb, Uh, Uu^Vud, Urb, Ur, Uu, Xu, Xu, Xos, Xos, Xos, Xos, Xos, Xu, Qxu, Xu, Xu, Xu, Qxu, Xu, Qxu, Xu, Xu, Xu, Xu, Xu, Xu, Xu
Ur^Br/, Ur^Br/, Cud, Uu, Xos, Wwg, Wwg, Xos, Yhr^Xp, Xu, Xu, Xu, Xu, Xu, Xu, Xu, Xu, Xu, Xu, Xu, Xu, Xos, Wwg, Xos, Uu^Uf, Xos, Xos, Xos, Xu, Xos, Uu^Uf, Uh, Urb, Xu, Ur, Ur, Uu, Cud, Xos, Xu, Xos, Xos, Xos, Xos, Qxu, Qxu, Qxu, Xu, Xu, Qxu, Qxu, Xu, Xu, Xu, Xu, Xu, Xu, Xu, Wwb, Wwb
Uu, Uu, Xos, Xos, Xos, Wwg, Wog, Wog, Yhr, Yhr^Xp, Xu, Xu, Xu, Xu, Xu, Xu, Xu, Xu, Xos, Xu, Xos, Xos, Wog, Uu^Uf, Uu^Ii, Urb, Uu, Uh, Xu, Xu, Uu, Uu^Uf, Uu, Urb, Ur, Ur, Uu^Uf, Xos, Xos, Xos, Xos^Efs, Xos, Qxu, Qxu, Cud, Xu, Qxu, Xu, Qxu, Xu, Qxu, Xu, Xu, Xu, Wwb, Wwb, Wwb, Wwb^Pr\, Xu, Xu
Xos, Xos, Xos, Xos, Wwg, Wog, Wog, Yhr^Xp, Yhr, Yhr, Yhr^Xp, Xu, Xu, Xu, Xu, Xu, Xu, Xu, Xu, Xos, Xu, Wog^Xo, Wwg, Wwg, Uh, Uu^Uf, Urb, Uu^Uf, Xos, Xos, Uu, Uu, Cud, Cud, Uu, Uu, Uu, Xos, Xos, Xos^Efs, Uh, Qxu, Qxu, Qxu, Qxu, Cud, Qxu, Qxu, Xu, Qxu, Xu, Xu, Yhr, Yhr, Wwb, Wwb, Xu, Xu, Xu, Xu
Xos, Xos, Xu, Xu, Wwg, Wog, Yhr, Yhr^Xp, Yhr^Xp, Xu, Xu, Yhr^Pr/, Yhr, Xu, Xu, Xu, Xu, Xu, Xu, Xu, Wog^Xo, Wog^Xo, Wwg, Uh, Wwg, Uu, Urb, Urb, Uu, Uu^Vu, Uu, Uu, Xu, Xu, Uu, Urb, Urb^Pr/, Uu^Pr/, Uu, Uh, Qxu, Qxu, Qxu, Qxu, Qxu, Xu, Qxu, Xu, Qxu, Qxu, Qxu, Qxu, Yhr, Yhr^Xp, Xu, Xu, Xos, Xu, Xu, Xu
Xu, Xu, Xu, Xu, Xu, Xu, Yhr, Xu, Xu, Yhr^Pr/, Yhr, Xu, Xu, Yhr, Xu, Xu, Xu, Xu, Xu, Xu, Xu, Xu, Xos, Wwg, Wwg, Uu^Uf, Uu^Uf, Uu, Uh, Uu, Xu, Uu, Xu, Xu, Xos, Uu^Pr/, Uu, Urb, Urb, Uh, Uu, Qxu, Qxu, Qxu, Qxu, Qxu, Qxu, Xu, Xu, Xu, Yhr, Yhr, Yhr, Yhr^Xp, Xos, Xos, Xos, Xos, Xos, Xu
Xu, Xu, Xu, Xu, Xu, Xu, Yhr^Xp, Xu, Xu, Xu, Xu, Yhr, Xu, Xu, Xu, Xu, Xu, Xu, Xu, Xu, Xu, Xos, Wog^Xo, Wog, Wwg, Wwg, Wwg, Wwg, Wwg, Xos, Xos, Xu, Xos, Xos, Xos^Efs, Xos^Efs, Uh, Uu^Uf, Uu, Urb, Ur, Uh, Uh, Qxu, Qxu, Qxu, Qxu, Cud, Xu, Xu, Yhr, Yhr^Xp, Yhr, Yhr, Xos, Yhl, Xos, Xos, Xos, Xos
Xu, Xu, Xu, Xu, Xu, Xu, Xu, Yhr^Pr/, Yhr, Xu, Xu, Xu, Xu, Xu, Xu, Xu, Xu, Xu, Xu, Xu, Xu, Xu, Wog^Xo, Wog, Wog, Wog, Xos, Wog, Wog^Xo, Wog^Xo, Xos, Xos, Xos, Xos, Qxu, Qxu, Qxu, Qxu, Qxu, Cud, Uu, Urb, Urb, Cud, Uu, Qxu, Qxu, Xuc, Xuc, Xu, Xos, Yhr, Yhr^Pr/, Yhr^Pr/, Yhl, Yhl^Xp, Xos, Yhl^Xp, Xos, Xos
Xu, Xu, Xu, Xu, Xu, Xu, Xu, Xu, Xu, Yhr, Xu, Xu, Xu, Xu, Xu, Xu, Xu, Xu, Xu, Xu, Xu, Wog, Wog, Wog^Xo, Xos, Xos, Xu, Wog^Xo, Xos, Wog^Xo, Xos, Xos, Xos, Xos, Xu, Qxu, Uh, Uu^Uf, Qxu, Qxu, Qxu, Uh, Uu^Vu, Urb, Ur, Uu^Vu, Uu, Uu^Ii, Xuc, Xu, Xu, Xos, Xos, Yhl, Yhl, Yhl, Yhl, Yhl, Xos, Xos
Xu, Xu, Xu, Xu, Xu, Xu, Xu, Xu, Xu, Xu, Xu, Xu, Xu, Xu, Xu, Xu, Xu, Xu, Xu, Xu, Xu, Xu, Xu, Xu, Xos, Xos, Xu, Xu, Xos, Xos, Xos, Xos, Xos, Xu, Xu, Qxu, Cud, Uh, Qxu, Qxu, Qxu, Qxu, Qxu, Uu, Uh, Urb, Urb, Uh, Uh, Xu, Xuc, Xu, Xu, Xos, Xos, Yhl^Xp, Yhl^Xp, Yhl, Yhl, Xos
Xu, Xu, Xu, Xu, Xu, Xu, Xu, Xu, Xu, Xu, Xu, Xu, Xu, Xu, Xu, Xu, Xu, Xu, Xu, Xu, Xu, Xu, Xu, Xu, Xu, Xu, Xu, Xu, Xos, Xos, Xos, Xos, Xos, Xu, Qxu, Qxu, Qxu, Qxu, Qxu, Qxu, Qxu, Qxu, Xu, Qxu, Xos, Uh, Uu, Urb, Urb, Uu, Xos, Xos, Xu, Xu, Xu, Xos, Xos, Yhl, Yhl, Yhl
Xu, Xu, Xu, Xu, Xu, Xu, Xu, Xu, Xu, Xu, Xu, Xu, Xu, Xu, Xu, Xu, Xu, Xu, Xu, Xu, Xu, Xu, Xu, Xu, Xu, Xu, Xu, Xu, Xos, Xos, Xos, Xos, Xos, Yhr^Xp, Qxu, Qxu, Qxu, Qxu, Xu, Cud, Qxu, Qxu, Xu, Xu, Xos, Xos, Cud, Uu, Urb, Uu, Xos^Efs, Xos, Xos, Xu, Xu, Xu, Xu, Xos, Xos, Yhl
Xu, Xu, Xu, Xu, Xu, Xu, Xu, Xu, Xu, Xu, Xu, Xu, Xu, Xu, Xu, Xu, Xu, Xu, Xu, Xu, Xu, Xu, Xu, Xu, Xu, Xu, Xu, Xu, Xos, Xos, Xu, Xos, Xos, Yhr^Xp, Xu, Qxu, Qxu, Qxu, Cud, Cud, Qxu, Qxu, Xu, Xu, Xos, Xos, Uh, Uu, Urb, Uu, Cud, Xos^Efs, Xos, Xu, Xu, Xu, Xu, Xu, Xu, Xos
Xu, Xu, Xu, Xu, Xu, Xu, Xu, Xu, Xu, Xu, Xu, Xu, Xu, Xu, Xu, Xu, Xu, Xu, Xu, Xu, Xu, Xu, Xu, Xu, Xu, Xu, Xu, Xu, Xu, Xu, Xu, Xos, Xos, Xos, Xu, Xu, Qxu, Qxu, Xu, Xu, Xu, Xu, Xos, Xos, Xos^Efs, Xos^Efs, Uu^Uf, Uu^Vud, Urb, Uu^Uf, Xos, Xos, Xos, Xu, Xu, Xu, Xu, Xu, Xu, Xu
Xu, Xu, Xu, Xu, Xu, Xu, Xu, Xu, Xu, Xu, Xu, Xu, Xu, Xu, Xu, Xu, Xu, Xu, Xu, Xu, Xu, Xu, Xu, Xu, Xu, Xu, Xu, Xu, Xu, Xu, Xu, Xu, Xu, Xos, Xu, Yhr^Xp, Xu, Xu, Xuc, Xuc, Xu, Xos, Xu, Xu, Xos, Uh, Uu^Uf, Urb, Ur, Uu, Xos^Efs, Xos, Xos, Xu, Xu, Xu, Xu, Xu, Xu, Xu
Xu, Xu, Xu, Xu, Xu, Xu, Xu, Xu, Xu, Xu, Xu, Xu, Xu, Xu, Xu, Xu, Xu, Xu, Xu, Xu, Xu, Xu, Xu, Xu, Xu, Xu, Xu, Xu, Xu, Xu, Xu, Xu, Xu, Xu, Yhr, Yhr^Pr\, Xu, Xuc, Uh, Cud, Uh, Uh, Xu, Xuc, Xos^Efs, Uu^Uf, Ur^Es, Urb, Ur, Uh, Uh, Xos^Efs, Xos, Xos, Xu, Xu, Xu, Xu, Xu, Xu
Xu, Xu, Xu, Xu, Xu, Xu, Xu, Xu, Xu, Xu, Xu, Xu, Xu, Xu, Xu, Xu, Xu, Xu, Xu, Xu, Xu, Xu, Xu, Xu, Xu, Xu, Xu, Xu, Xu, Xu, Xu, Xu, Xu, Xu, Xu, Xu, Wwg, Xu, Uh, Uh, Ur, Uh, Xu, Uh, Uh, Uu^Ii, Ur, Ur^Es, Cud, Uu, Uu, Urb, Xos, Xos, Xu, Xu, Xu, Xu, Xu, Xu
Xu, Xu, Xu, Xu, Xu, Xu, Xu, Xu, Xu, Xu, Xu, Xu, Xu, Xu, Xu, Xu, Xu, Xu, Xu, Xu, Xu, Xu, Xu, Xu, Xu, Xu, Xu, Xu, Xu, Xu, Xu, Xu, Xos, Xos, Xu, Wog, Wwg, Uh, Uu^Vu, Ur, Ur^Es, Uu^Vu, Ur, Ur, Xos, Uu, Uu, Cud, 1 Kud, Cud, Urb, Urb, Xos, Xos, Xu, Xu, Xu, Xu, Xu, Xu
Xu, Xu, Xu, Xu, Xu, Xu, Xu, Xu, Xu, Xu, Xu, Xu, Xu, Xu, Xu, Xu, Xu, Xu, Xu, Xu, Xu, Xu, Xu, Xu, Xu, Xu, Xu, Xu, Xu, Xu, Xos, Xos, Xos^Efs, Xos, Xu, Wwg, Xu, Cud, Ur^Es, Ur, Uh, Ur, Uh, Uu, Xos, Uh, Uu, Cud, Cud, Cud, Uu^Vud, Uu, Xos^Efs, Xos, Xos, Xu, Xu, Xu, Xu, Xu
Xu, Xu, Xu, Xu, Xu, Xu, Xu, Xu, Xu, Xu, Xu, Xu, Xu, Xu, Xu, Xu, Xu, Xu, Xu, Xu, Xu, Xu, Xu, Xu, Xu, Xu, Xu, Xu, Xos, Xos, Xos, Xos^Efs, Uh, Uh, Xuc, Xuc, Ur^Es, Ur, Ur^Br/, Uh, Wwg, Xu, Xu, Xu, Xos, Xos, Xos, Uu, Uu, Urb, Urb, Uu, Urb, Xos^Efs, Xos^Xzm\, Xos, Xos, Xu, Xu, Xu
Xu, Xu, Xu, Xu, Xu, Xu, Xu, Xu, Xu, Xu, Xu, Xu, Xu, Xu, Xu, Xu, Xu, Xu, Xu, Xu, Xu, Xu, Xu, Xu, Xu, Xu, Xu, Xu, Xu, Xos, Xu, Uu, Uu, Uh, Uu^Eff, Ur, Ur^Br/, Ur^Br/, Cud, Uh, Xuc, Xu, Xu, Xu, Xos, Xos, Xos, Uu^Uf, Uu^Uf, Uu, Uu, Uu^Vu, Urb, Uu, Uu^Uf, Xos^Xzm\, Xos, Xos, Xu, Xu
Xu, Xu, Xu, Xu, Xu, Xu, Xu, Xu, Xu, Xu, Xu, Xu, Xu, Xu, Xu, Xu, Xu, Xu, Xu, Xu, Xu, Xu, Xu, Xu, Xu, Xu, Xu, Xu, Xu, Xu, Xu, Uh, Uu^Eff, Uu^Eff, Ur^Br/, Ur^Br/, Uu^Eff, Cud, Uh, Uh, Uu, Xuc, Xos, Xos, Xos, Xos, Xos, Xos, Xos, Uu, Uh, Urb, Urb, Uu^Ii, Uu, Xol, Xol, Xos, Xos, Xu
Xu, Xu, Xu, Xu, Xu, Xu, Xu, Xu, Xu, Xu, Xu, Xu, Xu, Xu, Xu, Xu, Xu, Xu, Xu, Xu, Xu, Xu, Xu, Xu, Xu, Xu, Xu, Xu, Xu, Xu, Uu^Eff, Uu^Eff, Ur^Br/, Ur^Br/, Uu, Uu^Eff, Xu^Eff, Uh, Xu, Xu, Xos, Xos, Xos, Xos, Xu, Xu, Xu, Xos, Xos, Xos, Uu, Uu, Uu, Urb, Urb, Uu, Uu, Xos, Xos, Xos
