Xu, Xu, Xu, Xu, Xu, Xu, Xu, Xu, Xu, Xu, Xu, Xu, Xu, Xu, Xu, Xu, Xu, Xu, Xu, Xu, Xu, Xu, Xu, Xu, Xu, Xu, Xu, Xu, Xu, Xu, Xu, Xu, Xu, Xu, Xu, Xu, Xu, Xu, Xu, Xu, Xu, Xu, Xu, Xu, Xu, Xu, Xu, Xu, Xu, Xu, Xu, Xu, Xu, Xu, Xu, Xu, Xu, Xu, Xu, Xu
Xu, Xu, Xu, Xu, Xu, Xu, Xu, Xu, Xu, Xu, Xu, Xu, Xu, Xu, Xu, Xu, Xu, Xu, Xu, Xu, Xu, Xu, Xu, Xu, Xu, Xu, Xu, Xu, Xu, Xu, Xu, Xu, Xu, Xu, Xu, Xu, Xu, Xu, Xu, Xu, Xu, Xu, Xu, Xu, Xu, Xu, Xu, Xu, Xu, Xu, Xu, Xu, Xu, Xu, Xu, Xu, Xu, Xu, Xu, Xu
Xu, Xu, Xu, Xu, Xu, Xu, Xu, Xu, Xu, Xu, Xu, Xu, Xu, Xu, Xu, Xu, Xu, Xu, Xu, Xu, Xu, Xu, Xu, Xu, Xu, Xu, Qxu, Qxu, Qxu, Qxu, Qxu, Xu, Xu, Xu, Xu, Xu, Xu, Xu, Xu, Xu, Xu, Xu, Xu, Xu, Xu, Xu, Xu, Xu, Xu, Xu, Xu, Xu, Xu, Xu, Xu, Xu, Xu, Xu, Xu, Xu
Xu, Xu, Xu, Xu, Xu, Xu, Xu, Xu, Xu, Xu, Xu, Xu, Xu, Xu, Xu, Xu, Xu, Xu, Xu, Xu, Xu, Xu, Xu, Xu, Xu, Xu, Qxu, Qxu, Qxu, Qxu, Qxu, Xu, Xu, Xu, Xu, Xu, Xu, Xu, Xu, Xu, Xu, Xu, Xu, Xu, Xu, Xu, Xu, Xu, Xu, Xu, Xu, Xu, Xu, Xu, Xu, Xu, Xu, Xu, Xu, Xu
Xu, Xu, Xu, Xu, Xu, Xu, Xu, Xu, Xu, Xu, Xu, Xu, Xu, Xu, Xu, Xu, Xu, Xu, Xu, Xu, Xu, Xu, Xu, Xu, Xu, Qxu, Xu, Qxu, Yhl^Xp, Yhl, Xu, Xu, Xos, Xu, Xu, Xu, Xu, Xu, Xu, Xu, Xu, Xu, Xu, Xu, Xu, Xu, Xu, Xu, Xu, Xu, Xu, Xu, Xu, Xu, Xu, Xu, Xu, Xu, Xu, Xu
Xu, Xu, Xu, Xu, Xu, Xu, Xu, Xu, Xu, Xu, Xu, Xu, Xu, Xos, Xos, Xu, Xu, Xu, Xu, Xu, Xu, Xu, Xos^Efs, Xuc, Yhl, Xuc, Xuc, Xu, Yhl, Yhl, Yhl, Xu, Yhl^Xp, Xos, Xot^Xzm\, Xu, Xu, Xu, Xu, Xu, Xu, Xu, Xu, Xu, Xu, Xu, Xu, Xu, Qxu, Xu, Xu, Xu, Xu, Xu, Xu, Xu, Xu, Xu, Xu, Xu
Xu, Xu, Xu, Xu, Xu, Xu, Xu, Xu, Xu, Xu, Xu, Xu, Xos, Ur^Br\, Ur^Br\, Xom, Xom, Xu, Xos, Xu, Yhl, Yhl^Xp, Yhl, Yhl, Yhl^Xp, Yhl, Yhl, Yhl, Xuc, Xu, Xu, Yhl, Yhl, Yhl, Yhl^Xp, Xos, Xos^Xzm\, Xu, Xu, Xu, Xu, Xu, Xu, Xu, Xu, Xu, Qxu, Qxu^Xo, Xu, Xu, Xu, Xu, Xu, Xu, Xu, Xu, Xu, Xu, Xu, Xu
Xu, Xu, Xu, Xu, Xu, Xu, Xu, Xu, Xu, Xu, Xu, Xu, Xu, Xos, Xos, Ur^Br\, Ur^Pr/, Xom^Xzm/, Yhl, Yhl, Yhl, Yhl, Xos, Xos, Xu, Uu^Tf, Tb^Tf, Yhl^Emf, Tb^Tf, Xuc, Xos, Yhl, Yhl^Xp, Yhl, Yhl, Yhl, Xu, Xos, Xu, Xu, Xu, Xu, Xu, Xu, Xu, Xu, Qxu, Qxu, Xu, Xu, Xu, Xu, Xu, Xu, Xu, Xu, Xu, Xu, Xu, Xu
Xu, Xu, Xu, Xu, Xu, Xu, Xu, Xu, Xu, Xu, Xom^Efs, Xom, Xu, Xu, Xu, Xos, Yhl, Ur^Br\, Ur^Br\, Yhl^Xp, Xuc, Xos, Xu, Xu, Xu, Xuc, Uh, Yhl^Xp, Xom, Xom, Xu, Xos, Xos, Yhl^Xp, Xu, Yhl, Yhl^Pr/, Xuc, Xos, Xu, Xu, Xu, Xu, Xu, Xu, Qxu, Qxu, Xu, Xu, Xu, Xom, Xuc, Uu^Pr\, Ur^Br/, Xu, Xu, Xu, Xu, Xu, Xu
Xu, Xu, Xu, Xu, Xu, Xu, Xu, Xu, Xot, Xot, Yhl^Emf, Tb^Tf, Uh^Em, Uu^Emf, Yhl, Yhl, Xu, Xos, Xos, Ur^Pr/, Ur^Br\, Xuc, Xu, Qxu, Qxu, Xu, Yhl^Pr|, Xom, Xom, Xu, Xu, Xu, Xuc, Xu, Qxu, Xuc^Efs, Yhl^Xp, Yhl, Yhl^Xp, Xuc, Xu, Xu, Qxu, Xu, Qxu, Qxu, Qxu, Xu, Xu, Xom, Uu^Eb, Ur^Br/, Uh, Xuc, Xuc, Xuc, Xos, Xu, Xu, Xu
Xu, Xu, Xu, Xu, Xu, Xu, Xos, Xu, Xu, Yhl^Em, Yhl^Xp, Yhl^Xp, Yhl, Yhl, Yhl^Pr/, Xuc, Xu, Xu, Xuc, Xuc, Yhl^Xp, Ur^Br|, Yhl^Xp, Qxu^&A, Qxu, Xuc, Yhl^Xp, Xom, Xos, Xu, Qxu, Xuc, Qxu, Qxu^&A, Qxu, Qxu, Yhl^Xp, Yhl, Qxu, Qxu, Xuc, Xu, Xu, Qxu^Xo, Qxu, Qxu, Uh, Uh, Tb^Tf, Xu, Ur^Br/, Uu^Br|, Xu, Xu, Xu, Uu, Ur^Ii, Xos, Xos, Xu
Xu, Xu, Xu, Xu, Xu, Xos, Yhl, Xu, Xu, Xu, Uh, Yhl, Yhl^Xp, Xuc, Xuc, Yhl^Xp, Qxu^Bp/, Xuc, Xu, Qxu, Ur^Bp/, Ur^Br/, Qxu, Qxu, Uh, Yhl^Xp, Xu, Xu, Xos, Xu, Xu, Qxu, Xu, Qxu, Xu, Xu, Yhl, Yhl^Xp, Qxu^&A, Qxu, Qxu, Xu, Xu, Xu, Xu, Qxu, Qxu, Uu, Uu^Br/, Ur^Br\, Ur^Br/, Uu^Br|, Uu^Em, Cud, Uu^Em, Ur^Em, Uh, Xuc, Xuc, Xu
Xu, Xu, Xu, Xu, Xu, Xu, Xu, Yhl^Xp, Yhl, Uu, Yhl, Yhl^Xp, Xu, Xu, Xu, Xu, Qxu, Qxu, Qxu, Qxu, Qxu^&A, Qxu, Qxu, Uh, Uu, Xu, Xos^Xzm/, Xos, Uh, Xu, Xu, Qxu, Qxu, Xuc, Qxu, Xu, Yhl, Qxu, Qxu, Qxu, Xu, Xu, Xu, Xu, Xu, Qxu, Uh, Uu, Uu^Vyf, Ur^Br/, Tb^Tf, Uh, Xu, Xu, Xu, Tb^Tf, Xu, Tb^Tf, Xu, Xu
Xu, Xu, Xu, Xu, Xu, Xu, Xu, Xu, Yhl^Em, Yhl, Xu, Xu, Xos, Xu, Xu, Xu, Xu, Qxu, Xu, Qxu, Qxu, Qxu, Kud, Cud, Urb^Edb, Uu^Em, Uu^Em, Uu^Tf, Uh^Ii, Uh, Qxu, Qxu, Qxu, Qxu, Yhl^Xp, Yhl, Xos, Xu, Qxu, Qxu, Xu, Xu, Xu, Xu, Xu, Xu, Xu, Ur^Em, Uu, Uu, Xuc, Xu, Xuc, Xuc, Xu, Xu, Xu, Xu, Xu, Xu
Xu, Xu, Xu, Qxu, Qxu, Qxu, Yhl^Emf, Yhl^Tf, Uh, Qxu, Xu, Xos, Qxu, Xu, Qxu, Xu, Qxu, Qxu, Xu, Xos, Uh^Ii, Cud, Urb, Urb^Edb, Urb^Edb, Urb, Urb, Tb^Tf, Tb^Tf, Uu, Qxu, Qxu^&A, Xu, Yhl^Xp, Xos, Xos, Xu, Xu, Xu, Xu, Xu, Xu, Xu, Xu, Xu, Xu, Tb^Tf, Uh, Ur, Xuc, Xu, Xu, Uh, Xuc, Xuc, Xom, Uh, Xom, Xu, Xu
Xu, Xu, Xu, Xu, Qxu, Qxu, Yhl^Xp, Yhl^Tf, Yhl^Tf, Xu, Xu, Xu, Xu, Qxu, Qxu, Xu, Qxu, Xu, Xos^Efs, Xos, Uh, Urb, Urb^Em, Urb, Xuc, Urb, Urb, Urb^Em, Urb, Uu, Uu^Vud, Qxu, Xu, Xu, Xu, Xos, Xos, Xos, Xu, Xu, Xu, Xu, Xu, Uh, Xu, Uh, Uh, Uu^Tf, Ur, Xuc, Xuc, Uh, Tb^Tf, Uu^Tf, Wwf^Es, Uh, Wwrg, Xuc, Wog, Wog
Xu, Xu, Xu, Xos, Xos, Qxu, Qxu, Yhl^Xp, Yhl^Em, Xu, Xu, Xu, Xu, Xu, Qxu, Qxu, Qxu^&A, Qxu, Urb, Urb, Urb, Urb, Rb^Tf, Qxu, Qxu, Uu^Ii, Uu^Tf, Urb^Em, Urb^Edb, Urb, Urb^Edb, Uu^Tf, Uu, Qxu, Qxu^&A, Qxu, Xu, Xos, Xu, Xu, Xu, Xu, Uu, Uh, Tb^Tf, Tb^Tf, Uu^Vu, Uu, Uu^Edt, Uu, Uu, Uu, Uu^Tf, Tb^Tf, Xu, Wwf, Uh, Wwg, Wog, Xu
Xu, Xu, Xu, Xu, Xu, Xu, Xu, Yhl^Tf, Yhl^Emf, Yhl^Xp, Xos, Xu, Xuc, Xuc, Xu, Xu, Qxu, Qxu, Urb^Edb, Urb^Edb, Xuc, Uu^Em, Uu^Dr, Uu^Es, Qxu^&B, Qxu, Uu^Es, Uu, Xuc, Urb^Edb, Urb^Edb, Urb^Edb, Urb, Qxu, Qxu, Qxu, Xu, Xu, Xu, Xu, Xos, Xos, Uu, Uh, Uu^Tf, Tb^Tf, Uu^Edt, Uu^Edt, Cud, Cud, Urb, Uu^Vud, Uu^Edt, Uu^Ii, Uu^Edt, Uh, Uh, Wwg^Es, Wwrg, Xu
Xu, Xu, Xu, Xu, Xos, Xu, Yhl^Xp, Yhl^Emf, Xos, Yhl^Em, Yhl^Pr/, Xos^Xzm\, Xu, Uu, Qxu, Qxu, Qxu, Uu^Vud, Urb^Edb, Urb^Edb, Uu, Qxu, Qxu^&B, Qxu, Xu, Qxu, Qxu^&B, Uh, Qxu, Uh, Uh, Urb, Urb, Cud, Uu, Uu, Uu, Qxu, Xu, Xu, Xu, Xu, Uu^Edt, Uu^Ii, Urb, Urb, Urb^Edt, Urb^Edt, Cud, 5 Kud, Cud, Urb, Uu^Edt, Uu^Edt, Tb^Tf, Uu^Tf, Wwg, Wwg, Xu, Xu
Xu, Xu, Xos^Xzm/, Xos^Xzm/, Yhl^Pr\, Yhl, Xu, Xos, Xu, Xos, Xu, Yhl^Xp, Yhl^Xp, Uu, Uu^Ii, Xu, Rb, Rb^Tf, Urb, Urb^Ii, Uu^&B, Qxu, Qxu, Xu, 2 Xu, Xu, Qxu, Qxu, Uu^&B, Uu, Uu^Tf, Urb, Urb, Kud, Uh, Qxu^&A, Uh, Xu, Cud, Xu, Xos, Xos, Urb^Edt, Urb^Edt, Urb^Edt, Urb, Urb, Urb, Wwf, Cud, Uu, Urb, Urb, Uh, Uh, Wwf^Es, Wwg, Xu, Xu, Xu
Xu, Xu, Xu, Yhl, Yhl^Xp, Xos, Xu, Xu, Xu, Xu, Xuc, Xu, Qxu, Uu, Uh, Uu, Urb^Edb, Urb, Urb^Ii, Urb^Ii, Qxu, Qxu, Qxu^&B, Xu, Xu, Xu, Qxu^&B, Qxu, Uh, Uh, Uu^Em, Urb^Em, Urb^Edt, Cud, Uu^Ii, Uh, Uu^Vud, Uu, Urb, Uh, Xu, Xu, Urb, Urb, Uh, Uu^Vud, Urb, Uh, Wwrg, Wwg, Wog, Wwrg, Wwg^Bw|, Uh, Xu, Xu, Wwf^Es, Wwrg, Xuc, Xu
Xu, Xu, Yhl^Xp, Yhl^Xp, Xu, Xu, Xu, Xu, Xu, Xuc, Qxu, Qxu, Qxu, Uu, Uu^Vud, Qxu, Urb^Edb, Urb^Edb, Uh, Uh, Xuc, Qxu, Re^Dr, Qxu, Qxu^&B, Qxu, Qxu, Qxu, Xuc, Uh, Urb, Urb^Edt, Urb, Urb, Urb^Ii, Urb, Urb, Urb, Urb, Urb, Xos, Xos, Uu, Uu^Tf, Wwg^Qhu, Uh, Wwf^Edt, Wwf^Edt, Uu^Tf, Wwg, Wog, Wog, Uu, Wwg, Xu, Xu, Ur^Br/, Uh, Uu^Br/, Uu^Br/
Xu, Xu, Xu, Yhl, Xu, Xu, Xu, Xos, Xos, Xuc, Qxu, Qxu^&A, Qxu, Uu, Qxu, Qxu, Urb, Urb, Uu^Vud, Uu, Re^Edb, Uu^Edb, Uu^&B, Qxu, Urb^Es, Urb^Es, Qxu^&B, Qxu, Uh, Urb, Urb, Urb, Uh, Urb, Urb, Urb, Uu, Urb, Uu^Tf, Urb, Xu, Xu, Uh, Wwg^Qhu, Wog^Qhu, Wwrg, Uu^Vu, Urb^Edt, Tb^Tf, Tb^Tf, Wog, Xu, Uh, Ur, Uu, Uu^Vu, Uu^Em, Ur^Br\, Xuc, Xuc
Xos, Xu, Yhl^Xp, Yhl^Xp, Xu, Xu, Xu, Xos, Xos, Xu, Xu, Xu, Qxu, Qxu, Uu^Tf, Uu^Tf, Urb, Urb, Uu^Tf, Rb^Tf, Rb, Uu^Edb, Uh, Qxu, Xuc, Urb, Uu^Ii, Uu, Cud, Urb, Urb, Uu^Vud, Uh, Uu^Tf, Urb^Edt, Urb, Cud, Uu, Xu, Uu, Xos, Xos, Wwg^Qhu, Wog^Qhu, Xuc, Uh, Urb^Edt, Urb, Uu^Tf, Xu, Xu, Xu, Xu, Tb^Tf, Ur^Em, Ur, Xu, Tb^Tf, Xu, Xu
Xos, Xos, Xos, Wog, Wog, Xu, Xu, Xu, Xos, Xos, Xuc, Xuc, Uh^Ii, Qxu^&A, Uu^Tf, Uu^Tfi, Urb^Edt, Urb, Urb^Em, Re^Tf, Uu^Vud, Uh, Uh, Uu, Urb^Edb, Urb^Edb, Uu, Cud, safe_location Kud, Urb^Edt, Urb^Edt, Uh, Uu, Cud, Urb^Edt, Urb, Xos, Xu, Xu, Xu, Xu, Xu, Wwf^Qhu, Wwg^Qhu, Uh, Uh, Urb^Edt, Urb^Edt, Wwf, Uh, Xuc, Xu, Xu, Uu^Tf, Uu, Xu, Xu, Xu, Xu, Xu
Uu, Xos, Wwg, Wog, Wwg, Xu, Xos, Xos, Xos, Xos, Xuc, Uh, Uu^Ii, Qxu, Urb, Urb^Edt, Cud, Urb^Edt, Urb, Urb, Urb, Uu, Urb, Uu, Urb^Edb, Urb^Edb, Urb, Cud, Urb^Edt, Urb^Edt, Urb, Uh^Ii, Uu, Xos, Urb, Urb, Xos, Xu, Xu, Xu, Xuc, Xu, Uu, Uu^Tf, Uu, Cud, 4 Kud, Cud, Uu^Ebn, Uu^Vud, Uh, Xuc, Cud, Ur^Em, Uu^Ii, Xu, Xu, Xu, Qxu, Qxu
Ur^Br\, Uh, Uu, Wwg, Xos, Xos, Xos, Xos, Cud, Xu, Uh, Cud, Cud, Urb, Qxu, Uu, Uh, Kud, Cud, Urb, Urb, Urb, Urb, Urb, Urb^Ii, Urb^Ii, Urb, Urb^Edt, Urb, Urb, Uh, Uu, Xos^Efs, Xos^Efs, Urb, Urb, Xu, Xu, Xu, Xuc, Cud, Cud, Urb, Uu, Urb, Cud, Cud, Cud, Ur, Ur^Em, Tb^Emf, Re^Emf, Re^Emf, Tb^Tf, Uu, Xu, Qxu, Qxu^Xo, Xu, Xu
Uu, Ur^Br\, Ur^Br\, Tb^Tf, Tb^Tf, Xos, Xos, Xos, Uu, Uu, Ur^Br/, Ur^Br/, Uu, Cud, Qxu, Uu^Ii, Uh, Uh, Uh, Uu, Uu, Urb, Qxu^&A, Urb, Uh, Uu^Tfi, Uu^Tf, Urb, Uu, Uu^Tf, Xos^Efs, Xos, Urb, Urb, Urb, Urb, Xos, Xu, Xuc, Xuc, Uu^Edt, Urb^Edt, Urb, Urb, Uu, Uu, Uh, Ur^Em, Uu, Tb^Tf, Re^Emf, Re^Fetd, Re^Emf, Tb^Emf, Uh, Qxu, Xu, Xu, Xu, Xu
Xos, Uu^Ii, Cud, Ur^Br\, Ur^Br\, Uh, Uu, Uu^Pr\, Ur^Pr\, Ur^Br/, Uu, Cud, Xu, Xos, Qxu, Qxu^&A, Qxu, Uu, Xu, Qxu, Qxu, Uh, Uh, Uu, Uu, Uu^Tf, Uh, Uh, Xos, Xos^Efs, Urb, Urb, Urb, Urb, Xos, Xu, Xu, Xos, Uu^Ebn, Uu^Vu, Uu, Uu, Cud, Uu, Uh, Uu^Vu, Wwf, Tb^Tf, Uu^Ii, Uh, Cud, Tb^Emf, Tb^Tf, Uu, Qxu, Qxu, Xu, Xu, Xu, Xu
Xos, Xos, Xos, Tb^Tf, Uu, Ur^Br\, Ur^Br/, Ur^Br/, Tb^Tf, Uu^Pr\, Xos, Xu, Xu, Xu, Xu, Qxu, Xu, Xu, Xu, Xu, Qxu^&A, Uh, Xu, Uu, Uu, Uu^Tf, Xos^Efs, Xos^Efs, Urb, Urb, Urb, Urb, Xos, Xu, Xu, Xos, Uh, Uh, Urb, Urb, Uu^Tf, Uh, Xu, Xu, Uh, Uh, Xu, Wwg, Wwrg, Uu, Xu, Uh, Uh, Qxu, Qxu, Qxu, Xu, Xu, Xu, Xu
Xos, Xos, Tb^Tf, Uh, Ur^Br/, Ur^Br/, Cud, Uu, Xos, Xos, Xos, Xos, Xos, Xos, Xu, Xu, Xu, Xu, Xu, Qxu, Xu, Xu, Xu, Xu, Xu, Xos, Urb^Xo, Urb, Urb, Urb, Xos, Xu, Xu, Xos, Urb, Urb, Uh, Uu, Urb, Uu, Uh, Xu, Xos, Xu, Xu, Xu, Xu, Wog, Wog, Xu, Xu, Xu, Qxu, Qxu, Xu, Xu, Xu, Xu, Xu, Xu
Uh, Uu, Ur^Br/, Ur^Br/, Uh, Uu, Xos, Xos, Xos, Xos, Xu, Xu, Xu, Xu, Xu, Xu, Xu, Xu, Xu, Xu, Xu, Xu, Xu, Xos, Xos, Xu, Xu, Urb^Xo, Xos, Xu, Xu, Xos, Urb, Uh, Uu^Vud, Urb, Ur^Edt, Uu, Xu, Xu, Xos, Xos, Xos, Xu, Xu, Xu, Xu, Xu, Xu, Xu, Xu, Xu, Qxu, Qxu, Xu, Xu, Xu, Xu, Xu, Xu
Ur^Br/, Ur^Br/, Cud, Uh, Xos, Wwrg, Wwg, Xos, Yhl^Xp, Xu, Xu, Xu, Xu, Xu, Xu, Xu, Xu, Xu, Xu, Xu, Xu^Qhu, Xos^Qhu, Wwg^Qhu, Xos, Uu^Tf, Xos, Xos, Xos, Xu, Xos, Uu^Tf, Uh, Urb^Edt, Xu, Ur, Ur^Edt, Uu^Edt, Cud, Xos, Xu, Xos, Xos, Xos, Xos, Xu, Xu, Qxu, Xu, Xu, Xu, Qxu, Qxu^Xo, Xu, Xu, Xu, Xu, Xu, Xu, Xu, Xu
Tb^Tf, Uu, Xos, Xos, Xos, Wwg, Wog, Wog, Yhl, Yhl^Xp, Xu, Xu, Xu, Xu, Xu, Xu, Xu, Xu, Xos, Xu^Qhu, Xos, Xos, Wog^Qhu, Uu^Tf, Uu^Ii, Urb, Uu, Uh, Xu, Xu, Uu, Uu^Tf, Uu^Edt, Urb^Edt, Ur, Ur^Edt, Uu^Tf, Xos, Xos, Xos, Xos^Efs, Xos, Qxu, Xu, Cud, Xu, Qxu, Xu, Qxu^Xo, Qxu, Qxu, Xu, Xu, Xu, Xu, Xu, Xu, Xu, Xu, Xu
Xos, Xos, Xos, Xos, Wwg, Wog, Wog, Yhl^Xp, Yhl, Yhl, Yhl^Xp, Xu, Xu, Xu, Xu, Xu, Xu, Xu, Xu, Xos^Qhu, Xu, Wog^Xo, Wwg, Wwrg^Qhu, Uh, Uu^Tf, Urb^Edb, Tb^Tf, Xos, Xos, Uu, Uu, Cud, Cud, Uu, Uu, Uu, Xos, Xos, Xos^Efs, Uh, Qxu, Qxu, Qxu, Qxu, Cud, Qxu, Qxu, Xu, Xu, Qxu, Xu, Xu, Xu, Xu, Xu, Xu, Xu, Xu, Xu
Xos, Xos, Xu, Xu, Wwg, Wog, Yhl, Yhl^Xp, Yhl^Xp, Xu, Xu, Yhl^Pr/, Yhl, Xu, Xu, Xu, Xu, Xu, Xu, Xu^Qhu, Wog^Xo, Wog^Xo, Wwg, Uh^Qhu, Wwrg^Qhu, Uu^Edb, Urb^Edb, Urb^Edb, Uu, Uu^Vu, Uu, Uu, Xu, Xu, Uu^Eb, Urb, Urb^Pr/, Uu^Pr/, Uu^Ebn, Uh, Qxu, Qxu, Qxu, Qxu, Qxu, Xu, Qxu, Qxu, Qxu^Xo, Qxu, Xu, Xu, Xu, Xu, Xu, Xu, Xu, Xu, Xu, Xu
Xu, Xu, Xu, Xu, Xu, Xu, Yhl, Xu, Xu, Yhl^Pr/, Yhl, Xu, Xu, Yhl, Xu, Xu, Xu, Xu, Xu, Xu^Qhu, Xu, Xu, Xos, Wwg, Wwg^Qhu, Uu^Tf, Uu^Tf, Uu, Uh^Qhu, Uu, Xu, Uu, Xu, Xu, Xos, Uu^Pr/, Uu, Urb, Urb, Uh, Uu, Qxu, Qxu, Qxu, Qxu, Qxu, Qxu, Xu, Xu, Xu, Xu, Xu, Xu, Xu, Xu, Xu, Xu, Xos, Xos, Xu
Xu, Xu, Xu, Xu, Xu, Yhl, Yhl^Xp, Xu, Xu, Xu, Xu, Yhl, Xu, Xu, Xu, Xu, Xu, Xu, Xu, Xu^Qhu, Xu, Xos, Wog^Xo, Wog, Wwg, Wwrg^Qhu, Wwrg^Qhu, Wwrg^Qhu, Wwg, Xos^Qhu, Xos^Qhu, Xu, Xos, Xos, Xos^Efs, Xos^Efs, Uh, Uu^Tf, Uu, Urb, Ur, Uh, Uh, Qxu, Qxu, Qxu, Qxu, Cud, Xu, Xu, Xu, Xu, Xu, Xu, Xu, Xu, Xu, Xu, Xos, Xos
Xu, Xu, Xu, Xu, Xu, Xu, Xu, Yhl^Pr/, Yhl, Xu, Xu, Xu, Xu, Xu, Xu, Xu, Xu, Xu, Xu, Xu^Qhu, Xu, Xu, Wog^Xo, Wog^_ml, Wog, Wog, Xos, Wog, Wog^Xo, Wog^Xo, Xos^Qhu, Xos, Xos, Xos, Qxu, Qxu, Qxu, Qxu, Qxu, Cud, Uu, Urb, Urb, Cud, Uu, Qxu, Qxu, Xuc, Xuc, Xu, Xu, Xu, Xu, Xu, Xu, Xu, Xu, Xu, Xu, Xos
Xu, Xu, Xu, Xu, Xu, Xu, Xu, Xu, Xu, Yhl, Xu, Xu, Xu, Xu, Xu, Xu, Xu, Xu, Xu, Xu^Qhu, Xu^Qhu, Wog, Wog, Wog^Xo, Xos, Xos, Xu, Wog^Xo, Xos, Wog^Xo, Xos^Qhu, Xos, Xos, Xos, Xu, Qxu, Uh, Tb^Tf, Qxu, Qxu, Qxu, Uh, Uu^Vu, Urb, Ur, Uu^Vu, Uu, Uu^Ii, Xuc, Xu, Xu, Xos, Xos, Xu, Xu, Xu, Xu, Xu, Xu, Xos
Xu, Xu, Xu, Xu, Xu, Xu, Xu, Xu, Xu, Xu, Xu, Xu, Xu, Xu, Xu, Xu, Xu, Xu, Xu, Xu, Xu, Xu^Qhu, Xu^Qhu, Xu, Xos^Qhu, Xos, Xu^Qhu, Xu, Xos^Qhu, Xos^Qhu, Xos, Xos, Xos, Xu, Xu, Qxu, Cud, Uh, Qxu, Qxu, Qxu, Qxu, Qxu, Uu, Uh, Urb, Urb, Uh, Uh, Xu, Xuc, Xu, Xu, Xos, Xos^Qhu, Xu^Qhu, Xu^Qhu, Xu, Xu, Xu
Xu, Xu, Xu, Xu, Xu, Xu, Xu, Xu, Xu, Xu, Xu, Xu, Xu, Xu, Xu, Xu, Xu, Xu, Xu, Xu, Xu, Xu, Xu, Xu^Qhu, Xu, Xu^Qhu, Xu, Xu^Qhu, Xos, Xos, Xos, Xos, Xos, Xu, Qxu, Qxu, Qxu, Qxu, Qxu, Qxu, Qxu, Qxu, Xu, Qxu, Xos, Uh, Uu, Urb, Urb, Uu, Xos, Xos, Xu^Qhu, Xu^Qhu, Xu, Xos, Xu, Xu^Qhu, Xu^Qhu, Xu
Xu, Xu, Xu, Xu, Xu, Xu, Xu, Xu, Xu, Xu, Xu, Xu, Xu, Xu, Xu, Xu, Xu, Xu, Xu, Xu, Xu, Xu, Xu, Xu, Xu, Xu, Xu, Xu, Xos, Xos, Xos, Xos, Xos, Yhr^Xp, Qxu, Qxu, Qxu, Qxu, Xu, Cud, Qxu, Qxu, Xu, Xu, Xos, Xos, Cud, Uu, Urb, Uu, Xos^Efs, Xos, Xos^Qhu, Xu, Wog, Xu, Xu, Xos, Xos^Qhu, Xu
Xu, Xu, Xu, Xu, Xu, Xu, Xu, Xu, Xu, Xu, Xu, Xu, Xu, Xu, Xu, Xu, Xu, Xu, Xu, Xu, Xu, Xu, Xu, Xu, Xu, Xu, Xu, Xu, Xos, Xos, Xu, Xos, Xos, Yhr^Xp, Xu, Qxu, Qxu, Qxu, Cud, Cud, Qxu, Qxu, Xu, Xu, Xos, Xos, Uh, Uu, Urb, Uu, Cud, Xos^Efs, Xos^Qhu, Wog, Wog, Xu, Xu, Xu, Xos^Qhu, Xos
Xu, Xu, Xu, Xu, Xu, Xu, Xu, Xu, Xu, Xu, Xu, Xu, Xu, Xu, Xu, Xu, Xu, Xu, Xu, Xu, Xu, Xu, Xu, Xu, Xu, Xu, Xu, Xu, Xu, Xu, Xu, Xos, Xos, Xos, Xu, Xu, Qxu, Qxu, Xu, Xu, Xu, Xu, Xos, Xos, Xos^Efs, Xos^Efs, Uu^Tf, Uu^Vud, Urb, Uu^Tf, Xos, Xos, Xos^Qhu, Wog, Wog^Xo, Xu, Xos, Xos, Xos^Qhu, Xos
Xu, Xu, Xu, Xu, Xu, Xu, Xu, Xu, Xu, Xu, Xu, Xu, Xu, Xu, Xu, Xu, Xu, Xu, Xu, Xu, Xu, Xu, Xu, Xu, Xu, Xu, Xu, Xu, Xu, Xu, Xu, Xu, Xu, Xos, Xu, Yhr^Xp, Xu, Xu, Xuc, Xuc, Xu, Xos, Xu, Xu, Xos, Uh, Tb^Tf, Urb, Ur, Uu, Uu, Xos, Ur, Xu^Qhu, Wwg, Wog^_ml, Yhr^Xp, Xos, Xos^Qhu, Xos
Xu, Xu, Xu, Xu, Xu, Xu, Xu, Xu, Xu, Xu, Xu, Xu, Xu, Xu, Xu, Xu, Xu, Xu, Xu, Xu, Xu, Xu, Xu, Xu, Xu, Xu, Xu, Xu, Xu, Xu, Xu, Xu, Xu, Xu, Yhr, Yhr^Pr\, Xu, Xuc, Uh, Cud, Uh, Uh, Xu, Xuc, Xos^Efs, Tb^Tf, Ur^Es, Urb, Ur, Uh, Uh, Tb^Tf, Uu, Wwf^Qhu, Wwg, Wwrg, Yhr, Yhr^Yva, Xos^Qhu, Xos
Xu, Xu, Xu, Xu, Xu, Xu, Xu, Xu, Xu, Xu, Xu, Xu, Xu, Xu, Xu, Xu, Xu, Xu, Xu, Xu, Xu, Xu, Xu, Xu, Xu, Xu, Xu, Xu, Xu, Xu, Xu, Xu, Xu, Xu, Xu, Xu, Wwrg, Xu, Uh, Uh, Ur, Uh, Xu, Uh, Uh, Uu^Ii, Ur, Ur^Es, Cud, Uu, Uu, Urb, Ur, Uh^Qhu, Wwrg, Wwg, Uh, Yhr^Xp, Xos^Qhu, Xos
Xu, Xu, Xu, Xu, Xu, Xu, Xu, Xu, Xu, Xu, Xu, Xu, Xu, Xu, Xu, Xu, Xu, Xu, Xu, Xu, Xu, Xu, Xu, Xu, Xu, Xu, Xu, Xu, Xu, Xu, Xu, Xu, Xos, Xos, Xu, Wog, Wwg, Uh, Uu^Vu, Ur, Ur^Es, Uu^Vu, Ur, Ur, Xos, Uu, Uu, Cud, 1 Kud, Cud, Urb, Ur, Xos, Xos^Qhu, Xu^Qhu, Wog, Wog^Xo, Xu, Xu^Qhu, Xos
Xu, Xu, Xu, Xu, Xu, Xu, Xu, Xu, Xu, Xu, Xu, Xu, Xu, Xu, Xu, Xu, Xu, Xu, Xu, Xu, Xu, Xu, Xu, Xu, Xu, Xu, Xu, Xu, Xu, Xu, Xos, Xos, Xos^Efs, Xos, Xu, Wwg, Xu, Cud, Ur^Es, Ur, Uh, Ur, Uh, Uu, Xos, Uh, Uu, Cud, Cud, Cud, Uu^Vud, Uu, Xos^Efs, Xos, Xos, Xu^Qhu, Xu^Qhu, Wog, Xu^Qhu, Xu
Xu, Xu, Xu, Xu, Xu, Xu, Xu, Xu, Xu, Xu, Xu, Xu, Xu, Xu, Xu, Xu, Xu, Xu, Xu, Xu, Xu, Xu, Xu, Xu, Xu, Xu, Xu, Xu, Xos, Xos, Xos, Xos^Efs, Uh, Uh, Xuc, Xuc, Ur^Es, Ur, Ur^Br/, Uh, Wwg^Qhu, Xu, Xu, Xu, Xos, Xos, Xos, Uu, Uu, Urb, Urb, Uu, Urb, Xos^Efs, Xos^Xzm\, Xos, Xos, Xu^Qhu, Xu^Qhu, Xu
Xu, Xu, Xu, Xu, Xu, Xu, Xu, Xu, Xu, Xu, Xu, Xu, Xu, Xu, Xu, Xu, Xu, Xu, Xu, Xu, Xu, Xu, Xu, Xu, Xu, Xu, Xu, Xu, Xu, Xos, Xu, Uu, Uu, Uh, Uu^Eff, Ur, Ur^Br/, Ur^Br/, Cud, Uh, Xuc, Xu, Xu, Xu, Xos, Xos, Xos, Uu^Tf, Tb^Tf, Uu, Uu, Uu^Vu, Urb, Uu, Uu^Tf, Xos^Xzm\, Xos, Xos, Xu, Xu
Xu, Xu, Xu, Xu, Xu, Xu, Xu, Xu, Xu, Xu, Xu, Xu, Xu, Xu, Xu, Xu, Xu, Xu, Xu, Xu, Xu, Xu, Xu, Xu, Xu, Xu, Xu, Xu, Xu, Xu, Xu, Uh, Uu^Eff, Uu^Eff, Ur^Br/, Ur^Br/, Uu^Eff, Cud, Uh, Uh, Uu, Xuc, Xos, Xos, Xos, Xos, Xos, Xos, Xos, Uu, Uh, Urb, Urb, Uu^Ii, Uu, Xos^Efs, Xos^Efs, Xos, Xos, Xu
Xu, Xu, Xu, Xu, Xu, Xu, Xu, Xu, Xu, Xu, Xu, Xu, Xu, Xu, Xu, Xu, Xu, Xu, Xu, Xu, Xu, Xu, Xu, Xu, Xu, Xu, Xu, Xu, Xu, Xu, Uu^Eff, Uu^Eff, Ur^Br/, Ur^Br/, Uu, Uu^Eff, Xu^Eff, Uh, Xu, Xu, Xos, Xos, Xos, Xos, Xu, Xu, Xu, Xos, Xos, Xos, Uu, Uu, Uu, Urb, Urb, Uu, Uu, Xos, Xos, Xos
