border_size=1
usage=map

Re^Fdw      , Re^Fdw      , Gd^Fdw      , Gd^Fdw      , Gd^Fdw      , Re^Fdw      , Re^Fdw      , Re^Fdw      , Re^Fdw      , Gd^Fdw      , Hhd^Fdw     , Gd^Fdw      , Hhd         , Hhd         , Hhd^Fdw     , Hhd^Fdw     , Hhd^Fdw     , Hhd         , Hhd         , Gd^Fdw      , Gd^Fdw      , Gd^Fdw      , Gll^Fdw     , Gll^Fdw     , Gll^Fdw     , Gll^Fdw     , Hhd         , Hhd         , Hhd^Fdw     , Hhd         , Hhd^Fdw     , Hhd^Fdw     
Gd^Fdw      , Gd^Fdw      , Gd^Fdw      , Gd^Fdw      , Gll^Fdw     , Re^Fdw      , Gd^Fdw      , Re^Fdw      , Gll^Fdw     , Hhd^Fdw     , Gd^Fdw      , Hhd         , Hhd         , Hhd         , Hhd^Fdw     , Hhd^Fdw     , Hhd         , Hhd         , Gd^Fdw      , Gd^Fdw      , Gd^Fdw      , Gll^Fdw     , Gll^Fdw     , Re^Fdw      , Re^Fdw      , Gll^Fdw     , Hhd         , Hhd         , Hhd         , Hhd         , Hhd         , Hhd^Fdw     
Gd^Fdw      , Gd^Fdw      , Gd^Fdw      , Gll^Fdw     , Gll^Fdw     , Gd^Fdw      , Gll^Fdw     , Gd^Fdw      , Gll^Fdw     , Re^Fdw      , Gd^Fdw      , Re^Fdw      , Hhd         , Hhd         , Hhd         , Hhd         , Gd          , Hhd         , Gd          , Gd^Fdw      , Gd          , Gll^Fdw     , Gd          , Gd^Fdw      , Gd          , Gd^Fdw      , Hhd         , Hhd         , Hhd^Fdw     , Hhd^Fdw     , Hhd         , Hhd^Fdw     
Re^Fdw      , Re^Fdw      , Re^Fdw      , Gll^Fdw     , Gd^Fdw      , Gd^Fdw      , Re^Fdw      , Gll^Fdw     , Re^Fdw      , Re^Fdw      , Re^Fdw      , Gd^Fdw      , Hhd         , Gd^Fdw      , Hhd         , Hhd         , Re          , Gd          , Gd          , Gd          , Gd^Es       , Gd^Fdw      , Gd^Fdw      , Gd          , Re          , Hhd^Fdw     , Hhd         , Hhd         , Gd          , Hhd^Fdw     , Hhd         , Hhd^Fdw     
Re^Fdw      , Re^Fdw      , Gll^Fdw     , Gd^Fdw      , Gd^Fdw      , Gd^Fdw      , Gd^Fdw      , Gd^Fdw      , Gll^Fdw     , Re^Fdw      , Gd^Fdw      , Gd^Fdw      , Gd          , Gd          , Gd^Es       , Re          , Re          , Gd          , Gd          , Gd          , Gd^Fdw      , Gd^Fdw      , Gd^Fdw      , Gd          , Re^Fdw      , Hhd^Fdw     , Hhd^Fdw     , Gd^Fdw      , Gd          , Hhd^Fdw     , Hhd         , Hhd^Fdw     
Gd^Fdw      , Gll^Fdw     , Gll^Fdw     , Gd^Fdw      , Gd^Fdw      , Re^Fdw      , Gd^Fdw      , Gd^Fdw      , Re^Fdw      , Re^Fdw      , Gd^Fdw      , Gd^Fdw      , Gd          , Gd          , Gd          , Gd          , Gd          , Gd          , Gd          , Gd          , Gd          , Gd^Fdw      , Gd^Fdw      , Re^Fdw      , Re          , Gd^Fdw      , Gd^Fdw      , Gd^Fdw      , Gd^Fdw      , Gd          , Hhd         , Hhd^Fdw     
Gll^Fdw     , Gll^Fdw     , Gd^Fdw      , Gd^Fdw      , Gll^Fdw     , Gd^Fdw      , Re^Fdw      , Re^Fdw      , Gd^Fdw      , Gd^Fdw      , Gd^Fdw      , Gd          , Gd          , Gd          , Gd          , Gd          , Gd          , Gd          , Gd^Fdw      , Gd^Fdw      , Gd          , Gs          , Gd^Fdw      , Gd          , Re^Es       , Re^Fdw      , Re^Fdw      , Gd          , Gd          , Gd          , Hhd^Fdw     , Hhd^Fdw     
Gd^Fdw      , Gll^Fdw     , Gd^Fdw      , Gd^Fdw      , Gd^Fdw      , Gd^Fdw      , Re^Fdw      , Re^Fdw      , Gd^Fdw      , Gd^Fdw      , Gd^Fdw      , Gs          , Gd          , Gd          , Re          , Re          , Gd          , Gd          , Gd          , Gs          , Gs          , Gd          , Gd          , Re          , Re^Fdw      , Re^Fdw      , Gd^Fdw      , Gd          , Gd^Fdw      , Hhd^Fdw     , Gd^Fdw      , Gd^Fdw      
Gll^Fdw     , Gll^Fdw     , Gd^Fdw      , Re^Fdw      , Re^Fdw      , Re^Fdw      , Gd^Fdw      , Gd^Fdw      , Gd          , Gd^Fdw      , Gd^Fdw      , Gd          , Gd          , Gd          , Re          , Gd          , Gd          , Gd          , Gd          , Gs          , Gs          , Gd          , Re          , Re          , Re          , Gd          , Gd^Fdw      , Gd          , Gd          , Hhd^Fdw     , Re^Fdw      , Gd^Fdw      
Gd^Fdw      , Gd^Fdw      , Gll^Fdw     , Gll^Fdw     , Re^Fdw      , Gd^Fdw      , Gd          , Gd          , Gd          , Gd^Fdw      , Gd^Fdw      , Gs          , Gd          , Gd          , Gd          , Gd          , Gd          , 1 Gd        , Gd          , Gd          , Gd          , Gd          , Gd          , Re          , Gd          , Gd^Es       , Gd^Fdw      , Gd          , Gd          , Re^Fdw      , Gd^Fdw      , Gd^Fdw      
Gd^Fdw      , Gd^Fdw      , Gll^Fdw     , Gd^Fdw      , Gd          , Gd          , Gd          , Gd          , Gs^Fdw      , Gd^Fdw      , Gs          , Gs          , Gd          , Gd          , Gs          , Gd          , Gd          , Gs          , Re          , Gd          , Gd          , Gd          , Gd^Fdw      , Re          , Gs          , Gd          , Gd          , Gd          , Gd^Fdw      , Re^Fdw      , Gd^Fdw      , Gd^Fdw      
Re^Fdw      , Gll^Fdw     , Re^Fdw      , Gd^Fdw      , Gd^Fdw      , Gd^Fdw      , Gd          , Gs          , Gd^Fdw      , Gd^Fdw      , Gd          , Gs          , Gd^Es       , Gd          , Gd^Fdw      , Gd          , Gd          , Gd          , Gd          , Gd          , Gd          , Gd          , Gd^Fdw      , Gs          , Gd^Fdw      , Gd^Fdw      , Gd^Fdw      , Gd          , Gd^Fdw      , Gd^Fdw      , Re^Fdw      , Gll^Fdw     
Gll^Fdw     , Gll^Fdw     , Gd^Fdw      , Gd^Fdw      , Gd^Fdw      , Gd^Fdw      , Gd^Fdw      , Gd          , Gd          , Gd          , Gd          , Gd          , Gd          , Gd          , Gd^Fdw      , Gd          , Re          , Gd          , Gd          , Gd          , Gd          , Gs          , Gd^Fdw      , Gd^Fdw      , Gd^Fdw      , Gs          , Gd^Fdw      , Gd^Fdw      , Gd^Fdw      , Re^Fdw      , Gll^Fdw     , Gll^Fdw     
Gll^Fdw     , Gd^Fdw      , Gll^Fdw     , Gll^Fdw     , Gll^Fdw     , Gd^Fdw      , Gd^Fdw      , Gd^Fdw      , Re^Fdw      , Gd          , Gd          , Gs          , Gd^Fdw      , Gd^Fdw      , Gd^Fdw      , Gs          , Gd          , Gd          , Gd          , Gd          , Gd          , Gs^Es       , Gd^Fdw      , Gd^Fdw      , Gd^Fdw      , Gd^Fdw      , Gd^Fdw      , Gd^Fdw      , Gd^Fdw      , Re          , Gd^Fdw      , Gd^Fdw      
Gd^Fdw      , Gd^Fdw      , Gll^Fdw     , Gll         , Hhd^Fdw     , Gd^Fdw      , Gd^Fdw      , Gd^Fdw      , Hhd         , Hhd         , Re^Fdw      , Gd          , Gd^Fdw      , Gd^Fdw      , Gd^Fdw      , Gd^Fdw      , Gd          , Gd          , Gd^Fdw      , Gd^Fdw      , Gd^Fdw      , Gd^Fdw      , Gd^Fdw      , Gd^Fdw      , Gd^Fdw      , Gd^Fdw      , Gd^Fdw      , Gll^Fdw     , Re^Fdw      , Gd^Fdw      , Gll^Fdw     , Gd^Fdw      
Gd^Fdw      , Gll^Fdw     , Gll         , Hhd         , Hhd^Fdw     , Hhd         , Hhd^Fdw     , Hhd         , Hhd         , Re^Fdw      , Re          , Re^Fdw      , Gd^Fdw      , Gd^Fdw      , Re          , Re          , Gd^Fdw      , Gd^Fdw      , Gll         , Gd          , Gd^Fdw      , Gd^Fdw      , Gll         , Gll^Fdw     , Gll^Fdw     , Gd^Fdw      , Gd^Fdw      , Re          , Gll         , Gd^Fdw      , Gll^Fdw     , Gd^Fdw      
Hhd^Fdw     , Gll^Fdw     , Hhd         , Hhd         , Hhd         , Hhd         , Hhd         , Hhd         , Hhd         , Re^Fdw      , Re^Fdw      , Re^Fdw      , Gd^Fdw      , Gd^Fdw      , Gd^Fdw      , Gd^Fdw      , Gll^Fdw     , Gd^Fdw      , Gll         , Gd          , Gd^Fdw      , Gd^Fdw      , Gll         , Gll         , Gll^Fdw     , Gd^Fdw      , Gd^Fdw      , Re^Fdw      , Gll         , Gll         , Gll^Fdw     , Gd^Fdw      
Hhd         , Hhd         , Hhd^Fdw     , Hhd         , Gd^Fdw      , Gd^Fdw      , Gd^Fdw      , Hhd         , Hhd^Fdw     , Hhd^Fdw     , Hhd         , Hhd         , Re^Fdw      , Gd          , Gd^Fdw      , Gd^Fdw      , Gll^Fdw     , Gd^Fdw      , Gd^Fdw      , Gd^Fdw      , Gd^Fdw      , Gll         , Gll^Fdw     , Gll^Fdw     , Gll^Fdw     , Gd^Fdw      , Gd^Fdw      , Gd^Fdw      , Re^Fdw      , Gll         , Gll^Fdw     , Gd^Fdw      
Hhd         , Hhd         , Hhd         , Hhd         , Gd^Fdw      , Gd^Fdw      , Gd^Fdw      , Hhd         , Hhd         , Hhd^Fdw     , Hhd         , Re^Fdw      , Re^Fdw      , Re^Fdw      , Gll^Fdw     , Gd^Fdw      , Gll^Fdw     , Gll         , Gd^Fdw      , Gd^Fdw      , Gll^Fdw     , Gll^Fdw     , Gll^Fdw     , Gll^Fdw     , Re^Fdw      , Gd^Fdw      , Re^Fdw      , Hhd^Fdw     , Gd^Fdw      , Gll^Fdw     , Gd^Fdw      , Gd^Fdw      
Hhd         , Hhd         , Hhd         , Hhd         , Gd^Fdw      , Gd^Fdw      , Gll^Fdw     , Gd^Fdw      , Hhd         , Hhd         , Hhd^Fdw     , Re^Fdw      , Re^Fdw      , Re^Fdw      , Gll^Fdw     , Re^Fdw      , Re^Fdw      , Gd^Fdw      , Gll^Fdw     , Gll^Fdw     , Gd^Fdw      , Re^Fdw      , Re^Fdw      , Gd^Fdw      , Re^Fdw      , Re^Fdw      , Hhd^Fdw     , Hhd^Fdw     , Gd^Fdw      , Gd^Fdw      , Hhd^Fdw     , Hhd^Fdw     
Re^Fdw      , Gd^Fdw      , Gd^Fdw      , Gd^Fdw      , Gd^Fdw      , Gll^Fdw     , Re^Fdw      , Re^Fdw      , Hhd         , Re^Fdw      , Hhd         , Re^Fdw      , Re^Fdw      , Gll^Fdw     , Gll^Fdw     , Re^Fdw      , Gd^Fdw      , Gd^Fdw      , Gll^Fdw     , Gd^Fdw      , Re^Fdw      , Re^Fdw      , Re^Fdw      , Re^Fdw      , Hhd         , Hhd         , Hhd         , Hhd^Fdw     , Hhd^Fdw     , Gd^Fdw      , Hhd         , Hhd^Fdw     
Gd^Fdw      , Re^Fdw      , Re^Fdw      , Gd^Fdw      , Gll^Fdw     , Gll^Fdw     , Re^Fdw      , Hhd         , Hhd^Fdw     , Hhd^Fdw     , Hhd^Fdw     , Hhd         , Re^Fdw      , Re^Fdw      , Gd^Fdw      , Gd^Fdw      , Gd^Fdw      , Gll^Fdw     , Re^Fdw      , Re^Fdw      , Re^Fdw      , Hhd         , Re^Fdw      , Re^Fdw      , Hhd         , Hhd         , Hhd         , Hhd^Fdw     , Hhd^Fdw     , Hhd^Fdw     , Hhd         , Re^Fdw      
Gd^Fdw      , Re^Fdw      , Re^Fdw      , Gd^Fdw      , Gll^Fdw     , Re^Fdw      , Hhd^Fdw     , Hhd^Fdw     , Hhd         , Hhd         , Hhd         , Hhd         , Hhd         , Gd^Fdw      , Gd^Fdw      , Gd^Fdw      , Gd^Fdw      , Re^Fdw      , Re^Fdw      , Re^Fdw      , Re^Fdw      , Hhd         , Hhd         , Hhd         , Re^Fdw      , Hhd^Fdw     , Hhd^Fdw     , Hhd         , Hhd         , Hhd^Fdw     , Hhd         , Hhd^Fdw     
Gd^Fdw      , Re^Fdw      , Gll^Fdw     , Gd^Fdw      , Gll^Fdw     , Re^Fdw      , Gd^Fdw      , Hhd^Fdw     , Hhd         , Hhd         , Hhd         , Hhd^Fdw     , Hhd         , Hhd         , Gd^Fdw      , Gd^Fdw      , Hhd^Fdw     , Hhd^Fdw     , Hhd^Fdw     , Re^Fdw      , Hhd         , Hhd         , Hhd         , Hhd         , Hhd^Fdw     , Hhd^Fdw     , Hhd         , Hhd         , Hhd         , Hhd         , Hhd         , Hhd^Fdw     
Re^Fdw      , Re^Fdw      , Gd^Fdw      , Gll^Fdw     , Gd^Fdw      , Gd^Fdw      , Re^Fdw      , Re^Fdw      , Hhd^Fdw     , Hhd^Fdw     , Hhd         , Hhd^Fdw     , Hhd^Fdw     , Hhd         , Re^Fdw      , Hhd^Fdw     , Gd^Fdw      , Hhd^Fdw     , Hhd^Fdw     , Hhd^Fdw     , Hhd^Fdw     , Hhd         , Hhd^Fdw     , Hhd         , Hhd         , Hhd^Fdw     , Hhd         , Hhd         , Hhd         , Hhd         , Hhd         , Hhd^Fdw     
Gd^Fdw      , Gd^Fdw      , Gd^Fdw      , Gll^Fdw     , Gll^Fdw     , Re^Fdw      , Hhd^Fdw     , Hhd^Fdw     , Hhd^Fdw     , Gd^Fdw      , Hhd^Fdw     , Hhd         , Hhd         , Hhd         , Hhd         , Hhd^Fdw     , Hhd^Fdw     , Hhd^Fdw     , Hhd^Fdw     , Hhd^Fdw     , Gd^Fdw      , Hhd^Fdw     , Gd^Fdw      , Hhd^Fdw     , Hhd         , Hhd         , Hhd^Fdw     , Hhd^Fdw     , Hhd^Fdw     , Hhd^Fdw     , Hhd^Fdw     , Hhd^Fdw     
