border_size=1
usage=map

Re^Fdw, Re^Fdw, Gd^Fdw, Gd^Fdw, Gd^Fdw, Re^Fdw, Rb^Fdw, Rb^Fdw, Re^Fdw, Gd^Fdw, Hhd^Fdw, Gd^Fdw, Hhd, Hhd, Hhd^Fdw, Hhd^Fdw, Hhd^Fdw, Hhd, Hhd, Gd^Fdw, Gd^Fdw, Gd^Fdw, Gll^Fdw, Gll^Fdw, Gll^Fdw, Gll^Fdw, Hhd, Hhd, Hhd^Fdw, Hhd, Hhd^Fdw, Hhd^Fdw
Gd^Fdw, Gd^Fdw, Gd^Fdw, Gd^Fdw, Chr, Re^Fdw, Gd^Fdw, Rb^Fdw, Gll^Fdw, Hhd^Fdw, Gd^Fdw, Hhd, Hhd, Hhd, Hhd^Fdw, Hhd^Fdw, Hhd, Hhd, Gd^Fdw, Gd^Fdw, Gd^Fdw, Gll^Fdw, Gll^Ve, Re^Fdw, Re^Fdw, Gll^Fdw, Hhd, Hhd, Hhd, Hhd, Hhd, Hhd^Fdw
Gd^Fdw, Gd^Fdw, Gd^Fdw, Gll^Fdw, Gll^Fdw, Gd^Fdw, Hhd, Hhd, Gll^Fdw, Re^Fdw, Gd^Fdw, Re^Fdw, Hhd, Hhd, Hhd, Hhd, Gd, Hhd, Gd^Dr, Gd^Fdw, Gd, Gll^Fdw, Gd, Gd^Fdw, Gd, Gd^Fdw, Hhd, Hhd, Hhd^Fdw, Hhd^Fdw, Hhd, Hhd^Fdw
Re^Fdw, Rb^Fdw, Re^Fdw, Gll^Fdw, Gd^Fdw, Gd^Fdw, Hhd, Gll^Fdw, Re^Fdw, Re^Fdw, Re^Fdw, Gd^Fdw, Hhd, Gd^Fdw, Hhd, Hhd, Re, Gd, Gd, Gd, Gd^Es, Gd^Fdw, Gd^Fdw, Gd, Re, Hhd^Fdw, Hhd, Hhd, Gd, Hhd^Fdw, Hhd, Hhd^Fdw
Re^Fdw, Re^Fdw, Gll^Fdw, Gd^Fdw, Re^Fdw, Gd, Gd^Dr, Gd, Gll^Fdw, Re^Fdw, Gd^Fdw, Gd^Fdw, Gd, Gd, Gd^Es, Re, Re, Gd, Gd, Gd, Gd^Fdw, Gd^Fdw, Gd^Fdw, Gd, Re^Fdw, Hhd^Fdw, Hhd^Fdw, Gd^Fdw, Gd, Hhd^Fdw, Hhd, Hhd^Fdw
Gd^Fdw, Gll^Fdw, Gll^Fdw, Re, Re^Ve, Gd, Gd, Gd^Fdw, Hhd^Fdw, Re^Fdw, Gd^Fdw, Gd^Fdw, Gd, Gd, Gd, Gd, Gd, Gd, Gd, Gd, Gd, Gd^Fdw, Gd^Fdw, Re^Fdw, Rb, Gd^Fdw, Gd^Fdw, Gd^Fdw, Gd^Fetd, Gd, Hhd, Hhd^Fdw
Gll^Fdw, Gll^Fdw, Gd, Gd, Gll^Fdw, Gd, Re^Fdw, Hhd^Fdw, Hhd^Fdw, Gd, Gd^Fdw, Gd, Gd, Gd, Gd, Gd, Gd, Gd, Gd^Fdw, Gd^Fdw, Chr, Gs, Gd^Fdw, Gd, Rb^Es, Rb^Fdw, Re^Fdw, Gd, Gd, Gd, Hhd^Fdw, Hhd^Fdw
Gd^Fdw, Gll^Fdw, Gd, Gd, Gd^Fdw, Gd^Fdw, Hhd, Hhd^Fdw, Hhd, Gd, Gd, Gs, Gd, Gd^Dr, Re, Re, Gd, Gd, Gd, Gs, Gs, Gd, Gd, Re, Rb^Fdw, Re^Fdw, Gll^Fdw, Gd, Gd^Fdw, Hhd^Fdw, Gd^Fdw, Gd^Fdw
Gll^Fdw, Gll^Fdw, Gd^Fdw, Re^Fdw, Rb^Fdw, Re^Fdw, Gd^Fdw, Gd^Fdw, Hhd^Fdw, Hhd, Gd, Gd, Gd, Gd, Re, Gd, Gd, Gd, Gd, Gs, Gs, Gd, Rb, Re, Re, Gd^Dr, Gll^Fdw, Gd, Gd, Hhd^Fdw, Re^Fdw, Gd^Fdw
Gd^Fdw, Gd^Fdw, Gll^Fdw, Gll^Fdw, Re^Fdw, Hhd, Gd, Gd, Hhd, Gd^Fdw, Gd^Fdw, Gs, Gd, Gd, Gd, Gd, Gd, 1 Gd, Gd, Gd, Gd, Gd, Gd, Re, Gd, Gll^Es, Gd^Fdw, Gd, Gll, Re^Fdw, Gll^Fdw, Gll^Fdw
Gd^Fdw, Gd^Fdw, Gll^Fdw, Gd^Fdw, Hhd, Hhd^Fdw, Gd, Hhd, Gs^Fdw, Gd^Fdw, Gs, Gs, Gd, Gd, Gs, Gd, Gd, Gs, Re, Gd, Gd, Gd, Gd^Fdw, Re, Gll, Gll, Gd, Gd, Gd^Fdw, Re^Fdw, Gll^Fetd, Gll^Fdw
Re^Fdw, Gll^Fetd, Re^Fdw, Hhd, Gd^Fdw, Hhd, Gd, Gs, Gd^Fdw, Gd^Fdw, Gd, Gs, Gd^Es, Gd, Gd^Fdw, Gd, Gd, Gd, Gd, Gd, Gd, Gd, Gd^Fdw, Rb, Re^Fdw, Gll^Fdw, Gll^Fdw, Re, Re^Fdw, Gd^Fdw, Re^Fdw, Gll^Fdw
Gll^Fdw, Re^Fdw, Re^Fdw, Gd^Fdw, Gd^Fdw, Gd^Fdw, Gd^Fdw, Gd, Gd, Gd, Gd^Dr, Gd, Gd, Gd, Gd^Fdw, Gd, Re, Gd, Gd, Gd, Gll, Gll, Re^Fdw, Re^Fdw, Re^Fdw, Re, Rb^Fdw, Rb^Fdw, Gd^Fdw, Re^Fdw, Gll^Fdw, Gll^Fdw
Gll^Fdw, Re^Fdw, Gll^Fdw, Gll^Fdw, Gll^Fdw, Gd^Fdw, Gd^Fdw, Gd^Fdw, Re^Fdw, Gd, Gd, Gs, Gd^Fdw, Gd^Fdw, Gd^Fdw, Chr, Gd, Gd, Gll, Gd, Gll^Dr, Gll^Es, Re^Fdw, Re^Fdw, Gd^Fdw, Gd^Fdw, Gd^Fdw, Gd^Fdw, Gd^Fdw, Re, Gd^Fdw, Gd^Fdw
Gd^Fdw, Re^Fdw, Gll^Fdw, Gll, Hhd^Fdw, Gd^Fdw, Gd^Fdw, Gd^Fdw, Hhd, Hhd, Rb^Fdw, Gd, Gd^Fdw, Gd^Fdw, Gd^Fdw, Gd^Fdw, Gd, Gd, Gll, Gll^Fdw, Gd^Fdw, Gll^Fdw, Gd^Fdw, Gd^Fdw, Gd^Fdw, Gd^Fdw, Gd^Fdw, Rb^Fdw, Rb^Fdw, Gd^Fdw, Gll^Fdw, Gd^Fdw
Gd^Fdw, Gll^Fdw, Gll, Hhd, Hhd^Fdw, Hhd^Vhhr, Hhd^Fdw, Hhd, Hhd, Rb^Fdw, Rb, Re^Fdw, Gd^Fdw, Gd^Fdw, Re, Re, Gd^Fdw, Gd, Gd, Gll, Re^Fdw, Gd^Fdw, Gll, Gll^Fdw, Gll^Fdw, Gd^Fdw, Gd^Fetd, Rb, Rb, Gd^Ve, Re^Fdw, Gd^Fdw
Hhd^Fdw, Gll^Fdw, Md^Xm, Md^Xm, Hhd, Hhd, Hhd, Md, Md^Xm, Re^Fdw, Rb^Fdw, Re^Fdw, Gd^Fdw, Gd^Fdw, Gd^Fdw, Gd^Fdw, Gll^Fdw, Gd, Gll, Re, Re^Fdw, Gd^Fdw, Gll, Gll, Gll^Fdw, Gd^Fdw, Gd^Fdw, Re^Fdw, Gll, Re, Gll^Fdw, Re^Fdw
Hhd, Hhd, Md^Xm, Md, Gd^Fdw, Gd^Fdw, Gd^Fdw, Md, Md, Hhd^Fdw, Hhd, Hhd, Re^Fdw, Gd, Gd^Fdw, Gd^Fdw, Gll^Fdw, Gd^Fdw, Gll, Re, Re^Fdw, Gll, Gll^Fdw, Gll^Fdw, Gll^Fdw, Gd^Fdw, Gd^Fdw, Gd^Fdw, Re^Fdw, Gll, Re^Fdw, Re^Fdw
Hhd, Md, Hhd, Hhd, Gd^Fdw, Gd^Fdw, Gd^Fdw, Hhd, Hhd, Md, Hhd, Re^Fdw, Rb^Fdw, Re^Fdw, Gll^Fdw, Gd^Fdw, Gll^Fdw, Gll, Gd, Gd, Gll^Fdw, Gll^Fdw, Gll^Fdw, Gll^Fdw, Re^Fdw, Gd^Fdw, Re^Fdw, Hhd^Fdw, Gd^Fdw, Gll^Fdw, Gd^Fdw, Gd^Fdw
Hhd, Md^Xm, Hhd, Hhd, Gd^Fdw, Gd^Fdw, Chr, Gd^Fdw, Hhd, Hhd, Hhd^Fdw, Rb^Fdw, Re^Fdw, Re^Fdw, Gll^Fdw, Re^Fdw, Re^Fdw, Gd^Fdw, Gll^Fdw, Gll^Fdw, Gd^Fdw, Re^Fdw, Rb^Fdw, Gd^Fdw, Re^Fdw, Re^Fdw, Hhd^Fdw, Hhd^Fdw, Gd^Fdw, Gd^Fdw, Hhd^Fdw, Hhd^Fdw
Re^Fdw, Gd^Fdw, Gd^Fdw, Gd^Fdw, Gd^Fdw, Chr, Khr, Re^Vhhr, Hhd, Md, Hhd, Rb^Fdw, Rb^Fdw, Gll^Fdw, Gll^Fdw, Re^Fdw, Gd^Fdw, Gd^Fdw, Gll^Ve, Gd^Fdw, Rb^Fdw, Rb^Fdw, Rb^Fdw, Re^Fdw, Hhd, Hhd, Hhd, Hhd^Fdw, Hhd^Fdw, Gd^Fdw, Hhd, Hhd^Fdw
Gd^Fdw, Re^Fdw, Rb^Fdw, Gd^Fdw, Gll^Fetd, Chr, Re^Fdw, Hhd, Hhd^Fdw, Md, Md^Xm, Hhd, Re^Fdw, Re^Fdw, Gd^Fdw, Gd^Fdw, Gd^Fdw, Gll^Fdw, Re^Fdw, Re^Fdw, Rb^Fdw, Chr, Re^Fdw, Rb^Fdw, Hhd, Hhd, Md, Md, Hhd^Fdw, Hhd^Fdw, Hhd, Re^Fdw
Gd^Fdw, Re^Fdw, Rb^Fdw, Gd^Fdw, Gll^Fdw, Re^Fdw, Hhd^Fdw, Hhd^Fdw, Hhd, Md, Md, Hhd, Hhd, Gd^Fdw, Gd^Fdw, Gd^Fdw, Gd^Fdw, Re^Fdw, Re^Fdw, Rb^Fdw, Re^Fdw, Hhd, Hhd, Hhd, Re^Fdw, Md, Md^Xm, Md, Hhd, Hhd^Vhhr, Hhd, Hhd^Fdw
Gd^Fdw, Rb^Fdw, Gll^Fetd, Gd^Fdw, Gll^Fdw, Re^Fdw, Gd^Fdw, Hhd^Fdw, Md, Md, Hhd, Md, Hhd, Hhd, Gd^Fdw, Gd^Fdw, Hhd^Fdw, Hhd^Fdw, Hhd^Fdw, Re^Fdw, Hhd, Hhd, Hhd, Hhd, Hhd^Fdw, Md, Hhd, Hhd, Hhd, Hhd, Md, Hhd^Fdw
Re^Fdw, Re^Fdw, Gd^Fdw, Gll^Fdw, Gd^Fdw, Gd^Fdw, Re^Fdw, Md, Hhd^Fdw, Hhd^Fdw, Hhd, Md, Hhd^Fdw, Hhd, Re^Fdw, Hhd^Fdw, Gd^Fdw, Hhd^Fdw, Hhd^Fdw, Hhd^Fdw, Hhd^Fdw, Hhd, Hhd^Fdw, Hhd, Hhd, Md, Hhd, Hhd, Hhd, Md^Xm, Md, Hhd^Fdw
Gd^Fdw, Gd^Fdw, Gd^Fdw, Gll^Fdw, Gll^Fdw, Re^Fdw, Hhd^Fdw, Hhd^Fdw, Hhd^Fdw, Gd^Fdw, Hhd^Fdw, Hhd, Hhd, Hhd, Hhd, Hhd^Fdw, Hhd^Fdw, Hhd^Fdw, Hhd^Fdw, Hhd^Fdw, Gd^Fdw, Hhd^Fdw, Gd^Fdw, Hhd^Fdw, Hhd, Hhd, Hhd^Fdw, Md, Md^Xm, Md^Xm, Md, Hhd^Fdw
